,index,forward,backward,delta,pred
0,8744,1548,1027,521,239.867
1,6628,5199,9864,-4665,-7150.504
2,6687,9819,13150,-3331,-974.659
3,209,288,1086,-798,654.036
4,6029,157,128,29,-38.551
5,14512,6091,8389,-2298,-713.026
6,13951,77,76,1,-6098.371
7,10817,10090,726,9364,2286.877
8,1104,18600,26448,-7848,-850.547
9,14771,9973,3401,6572,293.881
10,1048,3023,3938,-915,-1456.192
11,7990,771,1421,-650,-1139.77
12,8595,1150,5473,-4323,-1816.097
13,7589,16,21,-5,1.995
14,13009,1650,1432,218,813.2
15,11684,293,168,125,119.847
16,8236,214,220,-6,-74.931
17,8580,7965,9868,-1903,757.24
18,355,3368,2719,649,-861.031
19,9442,362,825,-463,-2293.503
20,14129,1851,1231,620,2487.395
21,2859,2423,180,2243,59.432
22,5170,1739,412,1327,1416.697
23,8716,2516,2926,-410,105.795
24,2432,1129,293,836,311.477
25,7043,104,112,-8,-3.452
26,8403,1140,1663,-523,133.422
27,14176,1323,53085,-51762,-20999.765
28,11503,7024,20816,-13792,-82.763
29,2054,5854,1662,4192,1921.514
30,4381,33,37,-4,-15.963
31,9367,3751,4376,-625,-980.017
32,2136,475,1383,-908,-349.46
33,545,1628,2787,-1159,-1230.051
34,10581,246,245,1,15.993
35,3800,8684,1715,6969,350.115
36,6076,18,188,-170,-33.845
37,1222,150,75,75,199.122
38,8527,1937,4224,-2287,652.301
39,8346,11384,6028,5356,-627.332
40,10767,2566,187,2379,1500.562
41,8946,7575,16227,-8652,-3467.032
42,12545,7741,19476,-11735,-5104.599
43,6561,13708,8103,5605,2506.977
44,5741,72,118,-46,-93.541
45,13240,15481,37469,-21988,-16043.666
46,5802,39731,32356,7375,-5884.319
47,7817,2883,4880,-1997,-368.041
48,10788,257,163,94,-1386.038
49,14734,106561,34475,72086,25777.203
50,803,254,1503,-1249,-670.29
51,8584,3005,214,2791,1320.284
52,9218,11404,13893,-2489,-2064.385
53,14205,4964,1815,3149,-686.03
54,13794,7543,5237,2306,4125.127
55,4076,56,586,-530,-312.498
56,6901,261,439,-178,-21.193
57,15402,769,81,688,242.634
58,4847,6243,1723,4520,450.624
59,3365,352,364,-12,48.538
60,5327,6012,5174,838,165.453
61,1386,37863,23197,14666,1619.488
62,8314,1164,242,922,59.773
63,4774,371,68,303,243.474
64,6153,472,194,278,-3742.44
65,14049,15686,1337,14349,3901.095
66,12640,100,216,-116,-175.878
67,13371,8769,24025,-15256,-5204.281
68,2189,245,991,-746,217.364
69,46,55,34,21,170.051
70,10539,56,105,-49,-51.406
71,13702,3887,547,3340,-63.219
72,12240,52,67,-15,777.835
73,6909,140,467,-327,2.182
74,9066,224,302,-78,967.534
75,6666,3257,9755,-6498,-8000.912
76,5242,1577,2562,-985,-2112.141
77,2206,1718,7911,-6193,401.079
78,5226,730,1046,-316,396.221
79,14502,6883,8316,-1433,-87.906
80,8388,3729,3550,179,-2470.324
81,1607,772,234,538,873.426
82,9837,287,332,-45,183.496
83,13526,3332,209,3123,1291.226
84,12608,652,318,334,297.888
85,7562,26,23,3,1.306
86,8711,566,2223,-1657,2987.281
87,9998,6001,7204,-1203,-721.238
88,854,2048,802,1246,-1549.083
89,11656,15,13,2,34.211
90,8478,419,1254,-835,-3141.208
91,162,218,2551,-2333,-556.649
92,6812,29,188,-159,-116.168
93,11073,11494,5433,6061,-3071.374
94,14272,27696,63768,-36072,-12255.17
95,12290,2510,819,1691,395.599
96,9975,14,70,-56,120.09
97,14028,302,342,-40,429.409
98,2550,5674,3330,2344,32.856
99,260,391,117,274,437.141
100,13506,6582,2581,4001,-1320.013
101,228,660,293,367,848.736
102,2008,7151,9834,-2683,-4561.633
103,5864,39786,21413,18373,3865.411
104,14249,66139,46744,19395,12497.623
105,10442,224,63,161,267.163
106,3232,310,560,-250,305.294
107,13786,13792,10201,3591,14945.477
108,731,19393,22389,-2996,4326.229
109,8841,4558,13422,-8864,83.971
110,1771,164,105,59,175.496
111,4502,162,282,-120,343.03
112,8953,6401,20764,-14363,-5894.485
113,10110,1468,1653,-185,-576.981
114,13034,25,52,-27,191.26
115,4767,415,319,96,-494.479
116,1629,8429,735,7694,-753.94
117,13713,36501,16969,19532,20055.882
118,15148,40,42,-2,221.814
119,4015,1107,236,871,302.942
120,11864,3307,8052,-4745,616.894
121,11075,15520,10401,5119,1898.544
122,2905,2547,6920,-4373,-133.568
123,8972,1884,2514,-630,248.257
124,300,13092,10417,2675,392.994
125,7056,41,186,-145,-109.183
126,10671,38,22,16,14.262
127,11500,46396,52647,-6251,-1073.384
128,6638,15567,25548,-9981,-1208.778
129,6389,244,1100,-856,-48.854
130,8026,488,86,402,114.79
131,14495,684,2867,-2183,-390.565
132,6651,24073,20085,3988,195.407
133,9242,1597,7580,-5983,-7027.105
134,7413,23,75,-52,-8.392
135,5503,392,412,-20,-328.569
136,2351,292,541,-249,-115.916
137,5950,140,49,91,-266.065
138,13245,27190,32476,-5286,3691.828
139,1485,16141,4938,11203,-10.323
140,14051,10031,1186,8845,3104.6
141,3493,1237,820,417,122.601
142,5392,8096,9870,-1774,-757.961
143,8998,5482,1024,4458,1142.141
144,6621,8203,15353,-7150,-3289.509
145,14452,404,74,330,-102.018
146,5457,11473,16351,-4878,2813.444
147,1717,112,106,6,135.222
148,1365,2860,17432,-14572,-10558.028
149,8881,6650,15581,-8931,-1205.331
150,8989,15132,25202,-10070,-4622.469
151,11008,149,3293,-3144,-3621.053
152,5426,4362,800,3562,6501.734
153,14371,2245,4650,-2405,-1304.957
154,4552,8006,2439,5567,2493.664
155,12542,24272,20596,3676,1862.625
156,5546,181,1114,-933,137.306
157,1561,18656,8068,10588,-5836.261
158,9503,1471,1092,379,-471.939
159,14005,284,2369,-2085,1232.049
160,12758,449,1745,-1296,-336.457
161,8422,329,309,20,137.351
162,2996,1978,266,1712,638.287
163,1400,29783,12139,17644,2809.75
164,2079,207,424,-217,656.511
165,983,191,691,-500,-598.512
166,10706,106,45,61,4235.649
167,10795,7560,1305,6255,505.762
168,12948,162,572,-410,310.097
169,12900,1546,143,1403,308.614
170,4262,139,21,118,29.064
171,12530,1267,3290,-2023,-3998.074
172,7010,30,27,3,3.568
173,1645,403,827,-424,-518.38
174,3662,20,109,-89,420.926
175,1632,269,377,-108,-1616.421
176,4390,301,71,230,-43.366
177,7966,2242,873,1369,741.996
178,4562,970,5040,-4070,-946.115
179,2294,1208,984,224,667.943
180,8053,115,102,13,-21.089
181,10898,1786,970,816,123.184
182,1348,6703,22729,-16026,-3697.088
183,3241,91,275,-184,-331.49
184,6266,8954,5845,3109,706.833
185,1228,54,2037,-1983,-262.478
186,2252,8413,9328,-915,1976.497
187,13873,22021,9276,12745,2166.306
188,3429,1227,875,352,-1323.784
189,13587,378,206,172,2544.008
190,3926,258,541,-283,577.149
191,12999,325,449,-124,115.567
192,10766,453,5106,-4653,44.538
193,2708,121,72,49,-26.959
194,12625,1392,164,1228,744.268
195,5579,775,159,616,374.483
196,10414,468,86,382,578.076
197,4451,66,79,-13,4.222
198,6609,449,15640,-15191,-10588.823
199,13525,1334,352,982,1873.151
200,418,5528,5180,348,-855.685
201,984,2198,1472,726,617.439
202,6145,116,67,49,-1248.901
203,4819,2109,403,1706,523.263
204,10589,33,263,-230,-303.894
205,3047,12,11,1,0.042
206,2028,5490,15058,-9568,-7921.152
207,2089,4523,5964,-1441,874.104
208,11840,8517,19282,-10765,50.922
209,11258,434,1169,-735,-361.609
210,4344,195,93,102,-9.285
211,7547,38,23,15,2.364
212,10408,202,163,39,432.823
213,13024,509,1806,-1297,14.185
214,10266,500,153,347,527.635
215,11015,291,440,-149,-490.98
216,3087,41,139,-98,39.574
217,4845,6052,1808,4244,333.732
218,9874,305,144,161,-141.055
219,7068,100,68,32,8.581
220,13072,591,508,83,80.398
221,12756,1293,904,389,-226.39
222,7843,3109,1153,1956,1990.623
223,5207,121,282,-161,24.048
224,2875,156,7070,-6914,-3308.771
225,4850,2918,1328,1590,423.628
226,6107,1597,788,809,759.649
227,373,2277,5221,-2944,-5690.768
228,13210,25773,40402,-14629,-1677.106
229,12100,42,24,18,16.177
230,9557,6684,6520,164,-637.627
231,12174,132,66,66,-34.12
232,11872,7787,15650,-7863,-5650.498
233,11804,11965,9854,2111,-2955.542
234,2182,2764,698,2066,-835.029
235,2680,825,324,501,26.651
236,2810,181,322,-141,-1008.785
237,11936,138,75,63,9.873
238,1507,421,172,249,461.0
239,7164,14,9,5,20.924
240,15338,129,892,-763,-137.165
241,12199,55,27,28,17.927
242,14150,3643,20314,-16671,-6502.143
243,14454,412,1796,-1384,82.979
244,7997,288,88,200,81.877
245,14046,2220,17063,-14843,-8409.021
246,14799,8373,18596,-10223,-1825.595
247,5903,230,978,-748,-95.962
248,14280,1279,2407,-1128,-5078.769
249,3441,688,414,274,347.63
250,5058,5377,292,5085,2718.15
251,6730,17,25,-8,-8.763
252,5089,12602,16892,-4290,-31.562
253,906,2750,673,2077,1047.025
254,2472,2211,2570,-359,-851.719
255,1277,48,48,0,-36.416
256,6060,253,106,147,45.052
257,4908,6816,784,6032,2925.018
258,11239,131,9000,-8869,-2709.386
259,5466,3194,3033,161,883.812
260,4965,4507,5545,-1038,2167.424
261,14855,712,761,-49,-96.857
262,14121,21812,31955,-10143,-16190.99
263,6683,1911,2451,-540,45.473
264,11604,101,55,46,-5.51
265,14003,2247,807,1440,4561.447
266,9418,727,1138,-411,-1384.7
267,12851,7053,8877,-1824,-3495.082
268,10000,300,9768,-9468,-17209.887
269,2343,332,287,45,0.679
270,12523,772,161,611,-3080.082
271,12272,2308,410,1898,591.725
272,9035,1362,691,671,-64.26
273,4533,4810,431,4379,-1099.792
274,11826,11756,17597,-5841,-7663.298
275,2674,461,120,341,-114.044
276,597,246,3733,-3487,-2815.706
277,11051,229,2441,-2212,-870.457
278,11871,4776,7406,-2630,-2347.167
279,11488,241,72,169,49.537
280,1044,77,752,-675,1302.775
281,754,3381,6602,-3221,-1436.639
282,8253,258,746,-488,2225.999
283,11617,41,30,11,8.733
284,6954,107,289,-182,-247.184
285,7267,44,81,-37,-8.371
286,5959,1603,233,1370,718.268
287,1976,1078,154,924,181.149
288,5105,3630,3972,-342,1194.799
289,9499,174,756,-582,51.107
290,5841,2641,12458,-9817,-2264.006
291,12574,9758,8601,1157,906.607
292,13292,25553,12752,12801,7959.861
293,5719,123,32,91,163.351
294,13590,10322,16998,-6676,-3893.08
295,3068,28,55,-27,7.563
296,2660,41,130,-89,-373.676
297,12848,3264,6335,-3071,-3541.473
298,10863,67,1236,-1169,-64.795
299,4762,709,112,597,-739.062
300,8517,4163,7384,-3221,-665.717
301,3176,227,78,149,4.66
302,3083,25,24,1,16.628
303,3767,224,61,163,60.881
304,10268,323,239,84,182.127
305,10599,29,79,-50,71.83
306,2963,575,163,412,269.518
307,11674,571,141,430,29.988
308,11216,1372,967,405,103.692
309,6118,161,613,-452,1426.502
310,12315,32,316,-284,-6.124
311,2558,219,183,36,-495.236
312,3943,386,2730,-2344,609.732
313,9632,7021,8461,-1440,-443.451
314,171,1459,316,1143,252.605
315,6559,17116,14557,2559,-582.335
316,11327,378,104,274,187.587
317,141,1900,833,1067,393.987
318,9266,22289,18176,4113,-2948.871
319,10353,73,66,7,66.085
320,14367,825,865,-40,581.394
321,9249,1652,6851,-5199,-8372.378
322,14756,11671,22160,-10489,-4135.515
323,12889,1013,2308,-1295,153.402
324,14812,220,41,179,94.935
325,13417,34519,25454,9065,-4403.875
326,10093,17800,9433,8367,-843.026
327,8945,26387,10102,16285,5802.813
328,925,3057,407,2650,2857.363
329,6528,3613,1088,2525,-467.085
330,8337,185,5820,-5635,-5277.838
331,12786,947,924,23,97.635
332,11135,2992,10020,-7028,-4831.233
333,2973,6579,1356,5223,1096.946
334,4787,1255,1438,-183,-219.826
335,11609,65,440,-375,-118.111
336,956,280,89,191,2764.365
337,15177,264,64,200,78.891
338,5663,69,82,-13,61.784
339,4142,110,130,-20,5.343
340,11088,3621,7196,-3575,-1329.379
341,5596,552,86,466,552.846
342,5095,25153,6175,18978,615.18
343,6219,6053,3379,2674,-438.162
344,3496,179,222,-43,305.206
345,3139,21,13,8,9.76
346,8813,367,20172,-19805,-3241.445
347,4376,24,51,-27,-148.546
348,292,2053,14721,-12668,-4071.172
349,3716,366,75,291,96.942
350,948,481,262,219,2553.972
351,11641,19,17,2,31.965
352,3532,30,44,-14,36.832
353,4783,317,263,54,1108.093
354,10690,17,13,4,-8.63
355,6164,89,1846,-1757,662.446
356,3874,30,79,-49,2847.575
357,10858,335,1491,-1156,-457.564
358,10136,1620,2600,-980,2932.838
359,650,101,38,63,979.463
360,844,234,2167,-1933,-3667.925
361,7545,4,28,-24,78.186
362,6523,8191,6663,1528,-339.98
363,14435,1243,270,973,284.296
364,3966,2052,2651,-599,-292.743
365,3761,62,27,35,142.117
366,4501,17441,8100,9341,608.686
367,9818,624,77,547,289.256
368,5443,5640,12133,-6493,-1217.496
369,6541,11808,5252,6556,2046.874
370,1145,1788,1366,422,143.35
371,14206,18147,3451,14696,-1336.625
372,4986,1156,222,934,1893.395
373,1197,4262,19958,-15696,-4430.779
374,13831,63931,45904,18027,-9839.091
375,10953,778,293,485,1491.861
376,13242,24995,24251,744,-2863.026
377,6024,28,91,-63,97.138
378,14552,4950,2889,2061,519.839
379,14733,5314,29444,-24130,-8337.819
380,3639,43,48,-5,-13.216
381,6571,12735,10843,1892,-7723.345
382,1502,1048,535,513,-350.213
383,14250,1228,425,803,-5306.83
384,6408,2104,255,1849,187.508
385,7581,44,50,-6,1.891
386,13260,4478,22501,-18023,-15681.276
387,14719,8164,13573,-5409,-21581.269
388,3891,1418,338,1080,1299.449
389,1674,346,737,-391,227.488
390,11818,6290,14821,-8531,-3473.329
391,15572,1221,638,583,-244.572
392,607,503,4919,-4416,-3906.857
393,14276,4334,13171,-8837,-7212.797
394,813,3823,7616,-3793,-1366.44
395,12218,47,1024,-977,-190.113
396,7104,34,30,4,12.22
397,6300,315,249,66,130.558
398,10383,68,46,22,-7.253
399,6581,1432,2982,-1550,-742.918
400,9263,6173,7787,-1614,-5436.265
401,5496,2947,2453,494,82.579
402,5232,893,1503,-610,-939.114
403,2119,420,37,383,564.415
404,9831,184,179,5,109.695
405,858,2335,4761,-2426,-544.696
406,10168,701,4071,-3370,-1363.815
407,10750,326,126,200,3662.028
408,13293,14494,35909,-21415,-12157.615
409,8037,671,1303,-632,-51.889
410,5578,1693,185,1508,431.233
411,102,6038,3801,2237,995.907
412,738,5163,3077,2086,1116.859
413,13578,2137,8203,-6066,487.293
414,12987,543,91,452,83.428
415,1724,269,97,172,722.582
416,9345,43,34,9,663.396
417,4205,174,236,-62,61.303
418,9407,396,76,320,-1157.999
419,11194,2325,13393,-11068,-7808.687
420,2045,147,171,-24,-1021.642
421,12675,91,876,-785,-531.696
422,7993,2384,1210,1174,416.641
423,4865,1154,1856,-702,-1875.428
424,14428,73,66,7,384.628
425,962,3054,2693,361,-2679.318
426,1928,2127,410,1717,79.049
427,2783,236,191,45,48.003
428,15165,1364,671,693,252.92
429,5133,769,691,78,897.074
430,2801,77,228,-151,-1545.976
431,2694,917,174,743,117.255
432,13901,16606,16668,-62,-447.51
433,3204,527,569,-42,-110.265
434,587,362,443,-81,756.07
435,4825,410,155,255,152.314
436,6172,197,639,-442,-1158.885
437,1049,406,1109,-703,-1643.54
438,6465,1151,1011,140,-372.49
439,4535,1394,2901,-1507,-903.751
440,13800,16245,32589,-16344,-10791.15
441,13772,1778,4870,-3092,-2357.236
442,2275,12951,15720,-2769,-1879.836
443,10420,651,3474,-2823,-629.686
444,12231,1589,486,1103,29.509
445,5942,135,220,-85,43.051
446,6698,5841,2668,3173,2032.787
447,10403,919,150,769,1880.07
448,6761,17,19,-2,6.574
449,14387,1259,2086,-827,-2002.301
450,7528,6,99,-93,-117.04
451,3795,109,291,-182,-3.475
452,5113,285,218,67,1400.022
453,6229,2557,1713,844,-794.218
454,10814,3003,110,2893,902.698
455,987,3738,669,3069,1091.33
456,12273,74,71,3,259.858
457,14288,194,12593,-12399,-9997.964
458,9971,6618,2768,3850,1052.314
459,9382,386,5019,-4633,-3270.894
460,11428,1161,144,1017,159.155
461,5500,91,300,-209,605.036
462,10772,6361,2659,3702,-364.681
463,1612,1229,2651,-1422,-1621.065
464,548,3114,2745,369,-228.613
465,4468,122,39,83,45.085
466,15570,1200,1713,-513,1969.997
467,2019,415,169,246,-1865.905
468,6910,45,412,-367,-443.061
469,8973,27079,12763,14316,6763.426
470,5411,222,826,-604,6060.29
471,9959,1696,1208,488,22.016
472,766,294,6333,-6039,-5832.672
473,9385,59,2781,-2722,-4710.871
474,1305,14183,34009,-19826,-5569.018
475,11423,149,101,48,-134.707
476,5124,11575,7032,4543,506.124
477,13068,998,1242,-244,-463.809
478,6126,385,459,-74,530.939
479,12644,139,95,44,32.216
480,10115,1390,4066,-2676,-309.076
481,12586,4219,2888,1331,1981.653
482,14153,9411,3535,5876,-511.275
483,6593,1926,2567,-641,-553.688
484,15013,6739,13050,-6311,-2179.769
485,13084,167,490,-323,616.224
486,14829,439,747,-308,35.297
487,10933,375,1243,-868,-665.892
488,9870,127,934,-807,34.199
489,5268,5298,5606,-308,-67.741
490,14840,54,52,2,205.757
491,14372,3301,2177,1124,205.426
492,12807,2044,12357,-10313,-806.352
493,867,3981,4234,-253,-4087.431
494,892,355,146,209,709.358
495,2509,3982,8353,-4371,-1870.188
496,2065,10313,1933,8380,2391.262
497,648,207,673,-466,611.965
498,1064,2158,1828,330,317.841
499,5041,1398,15879,-14481,-886.692
500,11551,1141,2071,-930,23.177
501,4466,56,42,14,32.272
502,10997,1696,1353,343,486.891
503,4058,205,189,16,-206.729
504,13137,759,111,648,59.895
505,11297,195,122,73,492.431
506,9439,2434,2000,434,-729.774
507,12780,323,248,75,-54.584
508,13861,37323,62271,-24948,-17758.246
509,13270,9545,23018,-13473,-11898.533
510,4206,100,43,57,-16.057
511,3737,32,121,-89,-307.261
512,12956,40,22,18,275.112
513,8971,181,6069,-5888,-7509.15
514,11060,15987,9190,6797,-2300.174
515,15414,227,129,98,414.456
516,4225,43,74,-31,2.478
517,12787,630,690,-60,-40.927
518,3335,140,61,79,-10.348
519,6531,24169,30655,-6486,972.893
520,9653,2751,1888,863,-903.111
521,10989,235,232,3,-1043.974
522,14165,7134,7551,-417,-9626.572
523,4096,601,562,39,222.576
524,13893,48300,40908,7392,-12486.172
525,974,47,277,-230,413.803
526,1364,5126,35842,-30716,-4068.617
527,14703,3602,7100,-3498,138.655
528,12849,1227,193,1034,227.644
529,14842,28,24,4,544.345
530,10038,533,307,226,2156.225
531,9401,681,544,137,-372.516
532,539,6685,3387,3298,-676.229
533,6645,4210,10432,-6222,-10925.003
534,12134,35,30,5,6.297
535,11601,164,75,89,82.897
536,13674,31,35,-4,-52.796
537,6379,274,310,-36,-147.307
538,5071,13259,2904,10355,2447.463
539,3528,30,40,-10,-4.374
540,11128,105,2943,-2838,-1956.36
541,1041,3987,3299,688,650.336
542,13889,30223,37040,-6817,-10803.861
543,4459,72,62,10,7.074
544,11034,208,13359,-13151,-4414.653
545,6597,20743,18770,1973,-5076.862
546,1778,932,540,392,69.857
547,10020,7408,18179,-10771,-7774.155
548,4494,32,28,4,19.562
549,8868,5369,2926,2443,226.988
550,6935,44,46,-2,96.053
551,9312,340,708,-368,256.697
552,1446,13006,6686,6320,928.235
553,4546,557,1906,-1349,-1911.615
554,15351,427,97,330,69.431
555,3454,272,267,5,887.052
556,15552,191,121,70,185.515
557,6198,3981,6014,-2033,-7907.63
558,1289,122,92,30,753.924
559,4052,90,69,21,-49.673
560,5092,8753,8324,429,-1145.961
561,4460,40,27,13,9.931
562,3423,644,706,-62,221.046
563,15494,937,673,264,-77.36
564,7242,104,101,3,-42.151
565,9282,6353,11614,-5261,-2198.943
566,8280,4691,1932,2759,1501.477
567,4599,7998,3660,4338,-549.692
568,11042,140,270,-130,329.408
569,13340,1557,1117,440,-384.828
570,13865,2466,2572,-106,-2599.025
571,11057,1522,4307,-2785,-1499.359
572,3421,337,745,-408,-524.036
573,481,4176,5491,-1315,-6199.639
574,12187,17,16,1,-2.531
575,5792,27,21,6,-20.606
576,8400,5230,9148,-3918,-1013.853
577,173,505,410,95,-818.004
578,12805,102,57,45,-2811.39
579,10708,904,341,563,1128.467
580,14419,5769,719,5050,519.113
581,4922,1832,6359,-4527,332.584
582,12969,701,692,9,188.959
583,998,1535,2446,-911,-2733.116
584,11461,56,25,31,335.1
585,5269,2590,742,1848,-1181.365
586,13522,263,1745,-1482,-26.274
587,5481,519,7755,-7236,-5855.094
588,6466,4829,11529,-6700,-531.921
589,1043,4089,3547,542,1817.358
590,13066,484,441,43,274.429
591,9368,1196,2348,-1152,-1481.798
592,2418,1204,1662,-458,625.544
593,4392,36,24,12,9.135
594,2080,978,2741,-1763,-3891.606
595,10087,10608,14337,-3729,4733.105
596,8375,4016,2726,1290,-3211.845
597,9496,70,1578,-1508,-1612.989
598,7965,590,872,-282,112.947
599,15060,1224,554,670,24.004
600,10626,18,24,-6,9.189
601,11577,11646,27709,-16063,-8802.434
602,15061,3412,2473,939,526.906
603,2485,238,209,29,-587.62
604,7275,46,30,16,91.353
605,3460,927,1783,-856,437.954
606,3277,685,311,374,142.44
607,5063,13825,4394,9431,1620.04
608,5073,723,8829,-8106,-7145.514
609,9337,4423,4378,45,974.008
610,12536,9073,30802,-21729,-6775.062
611,6237,2949,4113,-1164,39.038
612,4867,747,557,190,-647.027
613,6676,8563,11215,-2652,492.022
614,9589,6086,10252,-4166,-564.37
615,8543,2224,748,1476,-1725.415
616,2164,1854,461,1393,756.04
617,7557,61,15,46,4.727
618,5076,19340,18676,664,3034.201
619,4972,951,181,770,504.148
620,9288,21070,16212,4858,5133.335
621,10047,7684,10565,-2881,-4566.02
622,10561,97,188,-91,-59.576
623,11343,40,32,8,24.583
624,11151,5015,3936,1079,426.014
625,3930,240,714,-474,-114.322
626,13049,277,84,193,244.896
627,6614,6470,8928,-2458,-3512.488
628,8085,441,46,395,1410.011
629,8243,1799,1394,405,1416.298
630,230,214,331,-117,1939.501
631,394,4768,8205,-3437,1855.408
632,14319,32,657,-625,-3935.795
633,3347,72,19,53,-636.774
634,3401,180,2139,-1959,-1700.135
635,5521,116,176,-60,820.497
636,15041,563,268,295,34.107
637,10896,1777,256,1521,252.154
638,12831,7675,4361,3314,1062.68
639,1463,20288,19935,353,82.631
640,2301,335,540,-205,-118.51
641,14741,37763,49473,-11710,-2709.042
642,7793,1080,99,981,306.619
643,2410,3442,7191,-3749,287.965
644,14180,9225,498,8727,1636.621
645,8370,2621,1059,1562,-1940.632
646,12383,110,80,30,-3.01
647,931,1112,1463,-351,-1222.404
648,2015,106,709,-603,398.706
649,14211,12967,27103,-14136,2355.608
650,3157,28,27,1,5.339
651,8318,5536,8157,-2621,-1795.548
652,3573,111,41,70,3.023
653,1557,24246,21779,2467,-1840.344
654,4933,420,149,271,240.558
655,785,19249,17404,1845,209.333
656,13105,195,272,-77,-71.461
657,9875,99,66,33,146.399
658,9340,1613,2384,-771,17.743
659,4534,7812,13340,-5528,1647.006
660,6622,11333,12613,-1280,1667.711
661,12510,13750,5759,7991,3089.598
662,3487,2348,2292,56,370.384
663,4088,105,194,-89,31.14
664,345,1262,3027,-1765,1337.423
665,5624,53,38,15,41.503
666,7510,15,65,-50,0.838
667,14716,120574,37504,83070,11211.873
668,12326,93,103,-10,21.552
669,14415,115,954,-839,-721.586
670,1322,9042,3462,5580,-117.878
671,979,593,3697,-3104,488.886
672,1093,2118,1851,267,510.01
673,12833,5083,6183,-1100,-402.902
674,7875,175,2179,-2004,-1164.75
675,13548,843,4867,-4024,2813.833
676,14430,538,2955,-2417,-1560.356
677,4576,12752,9269,3483,1173.423
678,11599,1487,4115,-2628,222.022
679,12652,65,81,-16,208.756
680,2127,320,405,-85,370.931
681,14036,7664,9055,-1391,19161.155
682,11883,7802,17467,-9665,-3896.468
683,12985,773,633,140,274.206
684,13965,14847,12363,2484,-1373.784
685,2647,286,444,-158,488.874
686,4504,6495,5661,834,-2328.898
687,4770,843,476,367,904.433
688,1591,1501,216,1285,-898.403
689,2561,1967,270,1697,18.644
690,11006,9174,9001,173,-2532.595
691,7865,3016,2420,596,1535.271
692,14361,3002,3695,-693,-489.311
693,3929,306,281,25,-55.732
694,3163,13,8,5,38.462
695,383,903,3767,-2864,-2361.72
696,5090,3201,13137,-9936,1048.249
697,512,545,1397,-852,94.976
698,4677,1876,3339,-1463,-2111.635
699,13732,8213,5125,3088,4072.846
700,2896,4194,5138,-944,-1491.442
701,764,2477,7069,-4592,1092.154
702,2220,4032,3593,439,98.259
703,12784,1672,1546,126,282.681
704,1162,194,2374,-2180,686.66
705,8084,987,1020,-33,392.311
706,13496,560,30325,-29765,-19158.584
707,6179,2708,491,2217,780.223
708,456,279,244,35,2966.432
709,6453,19943,26705,-6762,-2878.335
710,8920,11255,18825,-7570,-5747.103
711,5632,352,289,63,386.534
712,10153,228,3487,-3259,344.256
713,6601,254,2418,-2164,-4341.216
714,3292,30,258,-228,-101.124
715,8220,5326,1651,3675,718.933
716,13715,2676,3349,-673,3051.21
717,8244,3385,1960,1425,1742.065
718,5990,77,162,-85,-148.341
719,4587,2454,1035,1419,-2822.379
720,3600,180,89,91,8.073
721,7882,2005,3470,-1465,392.339
722,3616,155,150,5,63.124
723,12759,86,1360,-1274,-22.09
724,5333,563,2718,-2155,-3403.698
725,8296,202,152,50,724.584
726,13749,27004,6953,20051,22045.29
727,5323,4512,5241,-729,374.993
728,15123,269,171,98,-20.669
729,14490,315,101,214,935.082
730,9213,2464,1187,1277,-12.26
731,10551,77,154,-77,-41.924
732,15427,223,551,-328,-52.767
733,363,21093,13103,7990,746.226
734,2955,99,83,16,169.924
735,3693,49,102,-53,-18.532
736,3398,280,172,108,-22.369
737,4476,60,43,17,52.506
738,9225,12296,16148,-3852,-4940.9
739,10938,279,345,-66,2101.652
740,267,286,87,199,75.436
741,8182,496,511,-15,-822.395
742,92,61,61,0,16.069
743,6240,2459,3721,-1262,-2144.461
744,14562,4902,2694,2208,361.785
745,13310,22826,16074,6752,3655.403
746,2880,355,335,20,522.346
747,1459,766,4427,-3661,-6191.804
748,4725,6675,1843,4832,894.357
749,200,237,1325,-1088,-583.126
750,3334,349,91,258,3.535
751,4800,1559,3217,-1658,349.421
752,12565,35217,32637,2580,436.13
753,5006,19269,1245,18024,2881.28
754,3702,137,255,-118,-38.906
755,1137,5639,9916,-4277,-1930.146
756,15353,370,281,89,102.455
757,11437,128,51,77,78.691
758,9432,1566,3313,-1747,-1805.321
759,7577,86,151,-65,1.281
760,7357,25,34,-9,2.062
761,9935,5123,2901,2222,944.282
762,3027,244,51,193,26.578
763,520,395,1621,-1226,848.911
764,9183,4088,6454,-2366,-23.174
765,8237,5023,1955,3068,1609.33
766,13149,59,27,32,-457.101
767,3422,1595,1086,509,-1867.561
768,11093,6424,3330,3094,-500.655
769,4527,7038,8553,-1515,-865.894
770,9652,441,1650,-1209,-95.673
771,6416,10835,6480,4355,2988.14
772,2723,157,64,93,-7.498
773,13131,126,127,-1,111.845
774,1728,293,80,213,208.102
775,14189,2947,17136,-14189,-9432.063
776,12736,1494,1983,-489,102.255
777,2623,1063,1138,-75,341.804
778,6093,71,49,22,-2.949
779,3907,350,1421,-1071,271.084
780,7047,33,24,9,11.307
781,11885,1225,17268,-16043,-7842.311
782,788,19207,19703,-496,-3690.68
783,14446,214,977,-763,-639.575
784,14514,976,1152,-176,33.519
785,11276,570,782,-212,296.595
786,12308,133,61,72,-21.291
787,10002,197,8816,-8619,-8127.405
788,12304,22,18,4,6.616
789,12670,51,432,-381,-262.721
790,10666,110,169,-59,-5.922
791,5926,698,844,-146,-64.908
792,2808,2343,2043,300,2123.275
793,11563,40213,18278,21935,-1310.321
794,12268,2233,529,1704,754.31
795,4016,272,340,-68,8.215
796,3386,33,24,9,15.158
797,6384,404,297,107,151.146
798,5474,2203,4132,-1929,-1315.702
799,13182,47,418,-371,-64.09
800,15469,859,269,590,46.282
801,8434,361,3258,-2897,579.766
802,3917,96,798,-702,-27.901
803,15510,104,205,-101,149.272
804,14236,5264,5796,-532,-6378.013
805,6251,399,191,208,185.242
806,10037,14945,10615,4330,-3375.18
807,2303,84,361,-277,-43.969
808,9930,2939,3138,-199,-428.716
809,13857,9805,22478,-12673,-9036.109
810,9158,180,2944,-2764,-1353.567
811,3955,5720,619,5101,3020.55
812,15321,48,46,2,215.34
813,14786,9380,1919,7461,3644.994
814,10909,718,110,608,-888.633
815,14114,3467,4794,-1327,1240.542
816,15095,142,62,80,103.086
817,12727,1199,1503,-304,-213.22
818,10579,148,263,-115,-119.42
819,15030,14440,9272,5168,1502.697
820,14681,93,48,45,61.627
821,8424,338,298,40,140.224
822,10197,1700,3101,-1401,-481.716
823,2284,873,3087,-2214,-3359.794
824,10140,4332,4337,-5,1408.689
825,15392,808,497,311,-8.72
826,13504,238,451,-213,3040.692
827,4940,19929,7855,12074,21.91
828,4351,29,44,-15,-25.824
829,12726,1453,2627,-1174,-1019.258
830,3732,162,342,-180,114.915
831,5748,228,450,-222,96.115
832,6109,1329,7340,-6011,-1675.332
833,7906,109,1130,-1021,-139.413
834,1012,1414,1936,-522,-877.418
835,14279,8050,14125,-6075,-7911.57
836,7782,178,62,116,476.18
837,12122,32,22,10,-9.901
838,2228,5326,3122,2204,687.088
839,12855,2016,3689,-1673,-1349.024
840,5297,7060,5704,1356,-1135.068
841,7877,1006,268,738,812.018
842,10958,9360,615,8745,1063.314
843,8602,90,93,-3,-389.485
844,6517,1215,474,741,776.634
845,13414,110,141,-31,6009.732
846,11509,36464,50487,-14023,-4719.679
847,6516,8559,14854,-6295,-4929.814
848,11141,2374,10950,-8576,2121.562
849,6844,23,86,-63,-822.322
850,15412,611,953,-342,266.368
851,5763,267,97,170,20.401
852,2387,316,356,-40,51.293
853,3409,3431,2267,1164,727.775
854,3993,1823,1197,626,362.135
855,13737,20392,5972,14420,3998.202
856,13090,856,316,540,-19.373
857,2843,297,1347,-1050,-108.367
858,10720,813,396,417,1001.324
859,14587,211,3211,-3000,-227.824
860,3633,766,964,-198,179.42
861,5707,49,129,-80,-37.348
862,13478,60706,34843,25863,-82.294
863,8693,39,34,5,-152.208
864,7879,1041,1347,-306,-0.435
865,13060,1187,778,409,756.947
866,6608,7066,10574,-3508,-60.875
867,6181,1627,1054,573,-485.0
868,718,9319,10669,-1350,-1816.678
869,2165,766,838,-72,-300.16
870,2876,2313,2159,154,-694.529
871,11836,2745,6335,-3590,-2536.336
872,6918,106,214,-108,-111.412
873,5357,543,6317,-5774,-5276.11
874,5233,2289,1169,1120,-1491.766
875,2795,376,243,133,171.146
876,12629,1287,547,740,425.368
877,13806,12934,10124,2810,-7972.813
878,11697,15,11,4,4.052
879,4961,5845,6222,-377,-1171.951
880,14461,301,180,121,357.035
881,15483,410,239,171,116.818
882,3985,332,5292,-4960,-576.035
883,2118,65,408,-343,161.855
884,7921,799,534,265,132.613
885,13805,70477,70169,308,-6006.092
886,1519,1618,12176,-10558,-627.371
887,8558,1255,1391,-136,-2844.594
888,6491,22730,19996,2734,1662.109
889,11413,44,21,23,121.994
890,7909,754,3746,-2992,-552.329
891,8419,1005,2766,-1761,-303.004
892,4517,1288,14844,-13556,-2630.305
893,15094,8041,11844,-3803,-4489.767
894,12933,506,302,204,142.141
895,8111,323,395,-72,354.634
896,12564,1597,2278,-681,540.823
897,9074,325,166,159,-313.227
898,570,321,519,-198,-2004.377
899,9947,2649,2843,-194,-1581.592
900,10151,63,54,9,717.297
901,2736,101,42,59,-117.316
902,493,866,407,459,-4529.266
903,10127,969,1925,-956,1255.93
904,3449,50,440,-390,137.286
905,5829,22916,12837,10079,-3966.27
906,6904,345,184,161,63.968
907,14187,2517,5868,-3351,-508.285
908,14802,56,53,3,-56.408
909,4606,9397,9785,-388,-365.478
910,15185,1238,119,1119,91.47
911,13953,27143,25702,1441,-399.481
912,8907,592,3811,-3219,-2051.195
913,9006,228,520,-292,733.736
914,8040,1185,1402,-217,-115.925
915,4593,4728,6678,-1950,-3190.194
916,3481,197,1955,-1758,-778.99
917,12324,27,21,6,20.895
918,8786,274,1263,-989,-1189.946
919,8256,91,113,-22,212.093
920,2486,309,1103,-794,-886.92
921,9857,56,462,-406,-542.577
922,8791,4107,4114,-7,-247.732
923,3307,46,39,7,141.984
924,1471,13013,14007,-994,-6101.448
925,8959,6150,2634,3516,5512.092
926,2745,425,185,240,249.248
927,6475,6350,3371,2979,144.329
928,4525,6145,4132,2013,-4604.086
929,5767,463,485,-22,-22.389
930,11516,10027,14941,-4914,-3983.948
931,11537,10999,42223,-31224,-13330.63
932,9437,5528,6141,-613,-2286.499
933,13675,182,182,0,-114.648
934,14351,197,938,-741,-829.384
935,5592,169,87,82,508.151
936,603,5953,12889,-6936,-2769.098
937,10301,91,77,14,42.587
938,9470,6405,7759,-1354,-2257.446
939,10276,681,503,178,-52.881
940,2574,307,962,-655,1341.606
941,6959,160,316,-156,-21.588
942,1033,1663,2020,-357,-17.236
943,14808,949,1092,-143,89.684
944,5495,621,1547,-926,-3931.285
945,5597,28,14,14,23.682
946,14402,44,3302,-3258,-1250.468
947,3997,4824,1316,3508,755.146
948,3447,590,217,373,86.04
949,5730,242,89,153,39.092
950,9992,2683,5155,-2472,111.428
951,2538,5005,4692,313,-1221.615
952,12522,1964,8556,-6592,348.889
953,3261,249,58,191,-18.54
954,14104,5839,32181,-26342,-7783.241
955,13166,32,129,-97,-28.56
956,8313,803,620,183,-1700.089
957,12906,1160,386,774,338.924
958,7933,1330,2921,-1591,1021.27
959,10586,49,187,-138,2.542
960,13514,1820,13909,-12089,-5398.077
961,2544,233,628,-395,84.823
962,13287,25168,46269,-21101,-6003.422
963,3968,4243,3306,937,732.442
964,2084,18056,9396,8660,-1144.907
965,5899,24287,34263,-9976,-4077.772
966,1268,118,225,-107,-283.669
967,3230,318,448,-130,-47.71
968,4165,32,56,-24,-9.666
969,6116,1537,1175,362,-852.232
970,9578,4041,478,3563,295.51
971,13307,12466,15368,-2902,-4649.862
972,3226,44,181,-137,24.701
973,14066,2866,668,2198,698.068
974,13481,8893,4590,4303,-1223.149
975,11606,129,144,-15,33.38
976,11043,610,306,304,2022.275
977,5482,1711,4946,-3235,-819.474
978,14358,763,1484,-721,-1354.926
979,5793,89,46,43,47.785
980,8092,254,451,-197,299.657
981,10966,290,355,-65,221.189
982,1363,165,308,-143,-3199.52
983,6039,150,110,40,-43.865
984,8178,157,120,37,15.323
985,13076,194,1347,-1153,-489.759
986,6550,20306,22642,-2336,-433.956
987,7813,1623,3610,-1987,-86.535
988,6342,336,161,175,47.726
989,1565,5207,22182,-16975,359.394
990,3146,31,22,9,10.791
991,5307,5537,9712,-4175,-3394.904
992,2022,24884,36674,-11790,-905.349
993,4662,2466,3972,-1506,-2803.004
994,7540,17,13,4,8.198
995,9595,706,1552,-846,-110.802
996,11753,19,18,1,-10.655
997,5289,457,248,209,321.66
998,14429,4307,2113,2194,203.858
999,12316,6,28,-22,50.734
1000,5143,8161,2149,6012,-54.164
1001,4941,11299,6921,4378,728.017
1002,13943,22395,21323,1072,-5950.533
1003,11586,5073,6732,-1659,-105.574
1004,1649,548,174,374,1907.136
1005,3863,188,1292,-1104,1187.682
1006,2197,658,1166,-508,116.972
1007,3949,143,2625,-2482,-1207.512
1008,2958,1369,6587,-5218,-732.955
1009,13845,34370,47352,-12982,-21747.852
1010,13127,62,52,10,-178.099
1011,13941,10833,10796,37,431.588
1012,6195,1993,2344,-351,-1157.801
1013,15142,153,167,-14,337.562
1014,13979,19169,25045,-5876,465.093
1015,13895,37011,45556,-8545,-5118.864
1016,10189,647,319,328,803.821
1017,8712,674,732,-58,124.513
1018,6430,3968,5952,-1984,-3305.076
1019,907,461,1106,-645,-1512.969
1020,7198,21,20,1,30.436
1021,14379,578,1726,-1148,-204.393
1022,5813,21087,57337,-36250,-8321.503
1023,621,315,357,-42,-2002.226
1024,10965,131,2356,-2225,-1691.392
1025,15344,126,48,78,91.28
1026,9776,137,51,86,113.149
1027,4963,1151,1861,-710,-686.017
1028,13874,65635,71868,-6233,58.426
1029,9965,3115,2812,303,433.052
1030,6970,511,552,-41,-163.534
1031,1051,1049,1496,-447,93.226
1032,2945,3061,2689,372,644.923
1033,13883,61278,63120,-1842,-9445.709
1034,10029,11092,10440,652,1392.025
1035,4363,213,127,86,53.868
1036,13027,70,184,-114,-1072.139
1037,3378,64,24,40,139.334
1038,4939,117,2419,-2302,-3314.318
1039,6249,184,932,-748,1440.52
1040,10485,159,818,-659,127.485
1041,14021,506,6231,-5725,4393.427
1042,5751,129,95,34,31.969
1043,10920,67,90,-23,1487.172
1044,928,773,1198,-425,267.239
1045,13570,7784,353,7431,4795.421
1046,5794,125,80,45,43.903
1047,6130,406,3205,-2799,69.569
1048,5816,47370,20226,27144,-130.739
1049,2514,2221,1041,1180,-319.386
1050,1520,1949,776,1173,1232.081
1051,8114,161,483,-322,347.017
1052,9023,1065,742,323,22.059
1053,4187,132,162,-30,-4.035
1054,7182,59,43,16,32.514
1055,1544,7107,35169,-28062,1956.932
1056,15407,751,107,644,194.652
1057,8522,70,120,-50,-556.25
1058,7899,847,1762,-915,-509.572
1059,11854,13336,5282,8054,875.318
1060,249,617,6902,-6285,-1608.333
1061,5330,81,3341,-3260,-4703.319
1062,14772,39822,13397,26425,243.792
1063,2030,760,556,204,-578.386
1064,12357,43,30,13,7.918
1065,2259,180,62,118,-1216.726
1066,8407,5069,4675,394,-1424.901
1067,14095,406,162,244,590.572
1068,13932,6951,10500,-3549,-1262.262
1069,15130,135,77,58,756.223
1070,7923,1007,1357,-350,73.195
1071,8787,2278,3263,-985,709.784
1072,15489,459,605,-146,471.368
1073,10839,2520,2893,-373,-251.674
1074,11819,26611,32970,-6359,1370.628
1075,1068,1236,3135,-1899,1326.949
1076,8560,2285,4673,-2388,-3203.376
1077,13101,843,270,573,74.441
1078,10819,2277,269,2008,2981.037
1079,663,5149,11093,-5944,-5554.286
1080,12938,119,55,64,33.674
1081,14122,849,9615,-8766,-27104.547
1082,11580,54885,50537,4348,1989.753
1083,4294,77,96,-19,6.788
1084,8993,2421,4205,-1784,824.524
1085,1387,3496,3606,-110,271.744
1086,1529,11931,12656,-725,1162.246
1087,14331,1454,123,1331,374.637
1088,14201,16556,28029,-11473,4189.716
1089,10044,12302,10412,1890,-6566.591
1090,3827,893,227,666,133.526
1091,13840,1244,120,1124,-438.776
1092,3214,1448,810,638,83.694
1093,2638,823,981,-158,107.462
1094,5081,8670,7164,1506,978.349
1095,3924,546,382,164,198.082
1096,10867,5198,928,4270,-606.671
1097,9463,1146,1050,96,-1242.496
1098,12877,4960,6682,-1722,-2667.986
1099,15393,1636,195,1441,581.684
1100,14503,5736,5863,-127,-238.425
1101,10699,219,21,198,10.686
1102,5791,229,241,-12,31.446
1103,13724,936,822,114,2362.842
1104,4500,828,1766,-938,-1272.182
1105,5422,13377,15720,-2343,-4116.986
1106,8432,1744,3437,-1693,-1463.926
1107,9591,9881,9154,727,683.239
1108,1615,206,76,130,351.896
1109,2904,65,87,-22,864.316
1110,13434,21416,39248,-17832,-23799.296
1111,14833,843,121,722,238.527
1112,4488,20,19,1,4.948
1113,13802,8757,4289,4468,-1322.827
1114,6270,9248,9837,-589,1637.927
1115,13716,660,416,244,-5292.55
1116,9456,565,3162,-2597,-858.456
1117,2026,13413,21840,-8427,-3704.879
1118,3739,390,512,-122,-50.187
1119,5911,650,948,-298,-2066.83
1120,10098,686,13493,-12807,-8136.011
1121,2948,297,139,158,186.361
1122,5132,879,743,136,1436.917
1123,3763,345,121,224,75.215
1124,5843,30682,978,29704,1244.539
1125,5168,119,391,-272,-1989.33
1126,13081,432,154,278,-948.972
1127,761,19615,20311,-696,212.256
1128,14650,33,32,1,92.385
1129,6114,679,2964,-2285,-128.934
1130,12352,78,86,-8,-8.513
1131,7364,34,31,3,91.311
1132,9508,2148,7198,-5050,-2310.894
1133,8152,33,29,4,429.149
1134,457,1116,3009,-1893,-3581.09
1135,3215,102,47,55,-194.983
1136,253,67,78,-11,13.519
1137,11152,13624,11024,2600,181.299
1138,702,15871,11825,4046,-3825.955
1139,4183,52,148,-96,5.973
1140,6643,1967,484,1483,-3223.722
1141,9269,5785,2004,3781,1552.446
1142,7158,75,30,45,10.89
1143,10105,530,2043,-1513,-458.903
1144,14077,3134,2613,521,1174.882
1145,5498,20835,22422,-1587,3152.415
1146,4720,478,349,129,328.164
1147,1158,4184,3758,426,742.775
1148,204,6375,395,5980,-310.803
1149,11047,1479,589,890,-43.978
1150,601,273,210,63,94.875
1151,2380,254,327,-73,-7.717
1152,14223,2533,5388,-2855,3016.856
1153,8761,249,179,70,-3312.841
1154,2957,1682,1093,589,-368.213
1155,9291,10277,8977,1300,-5114.29
1156,4162,22,21,1,2.472
1157,7004,34,35,-1,9.556
1158,5292,5541,11985,-6444,-9720.343
1159,13392,10204,13150,-2946,-2700.057
1160,8727,1127,81,1046,2530.89
1161,8112,42,38,4,166.248
1162,14195,11931,2962,8969,-5501.086
1163,1616,2131,2334,-203,463.891
1164,784,211,129,82,487.825
1165,12708,2347,756,1591,995.034
1166,8533,539,7823,-7284,-1069.026
1167,6288,795,1949,-1154,-2136.285
1168,12343,182,47,135,68.109
1169,10067,6625,2962,3663,1226.488
1170,6649,2715,1940,775,505.789
1171,1011,172,796,-624,433.399
1172,2379,84,418,-334,-0.458
1173,2665,120,64,56,144.108
1174,15373,697,116,581,106.305
1175,13946,31855,33604,-1749,1161.409
1176,12992,603,93,510,-307.761
1177,1369,6013,23017,-17004,-7362.541
1178,11173,11674,10513,1161,-396.928
1179,5727,111,88,23,57.296
1180,8057,52,391,-339,77.358
1181,8303,5188,8854,-3666,-5.731
1182,2983,1047,259,788,741.872
1183,11102,12980,20007,-7027,-4743.872
1184,5538,135,362,-227,-761.142
1185,2861,244,3104,-2860,-1005.024
1186,2705,127,311,-184,-165.352
1187,13486,21287,36848,-15561,-4754.558
1188,2890,4159,2508,1651,124.967
1189,5874,61484,25621,35863,4743.54
1190,4068,59,497,-438,-182.026
1191,9330,6024,7647,-1623,1903.464
1192,1156,2668,5564,-2896,108.537
1193,5382,9988,4974,5014,1246.002
1194,4712,631,669,-38,262.988
1195,656,15299,10495,4804,-697.948
1196,14327,413,2617,-2204,-1897.29
1197,14481,3144,5150,-2006,139.196
1198,1247,227,289,-62,-764.128
1199,10594,297,212,85,-123.19
1200,13187,444,1131,-687,39.01
1201,10249,2336,796,1540,-118.487
1202,4836,1138,1020,118,435.532
1203,6695,5683,3740,1943,-1996.101
1204,2572,5780,1819,3961,2073.611
1205,7318,39,26,13,-0.025
1206,2272,463,877,-414,-1997.425
1207,8034,906,1735,-829,-118.86
1208,361,263,15069,-14806,-6443.355
1209,2435,314,715,-401,1577.169
1210,6578,5701,1891,3810,742.034
1211,15340,1653,1687,-34,-41.255
1212,2773,80,46,34,102.043
1213,2740,596,163,433,233.652
1214,9020,207,362,-155,-7.328
1215,5243,302,5851,-5549,-4660.721
1216,7325,24,32,-8,7.27
1217,8351,997,67,930,1768.094
1218,227,204,235,-31,930.923
1219,10196,2788,1494,1294,-429.731
1220,4742,2613,130,2483,459.629
1221,9156,2008,2481,-473,269.876
1222,2917,328,270,58,113.235
1223,701,11318,10051,1267,-1687.78
1224,11137,9736,10562,-826,-970.059
1225,10972,224,15487,-15263,-2266.508
1226,4930,360,6594,-6234,1053.137
1227,11175,12004,19343,-7339,-2608.119
1228,14417,2561,3482,-921,329.105
1229,13215,20933,26782,-5849,-6800.639
1230,9946,2093,4710,-2617,-422.208
1231,9359,774,1026,-252,-5764.672
1232,9369,11675,7623,4052,599.877
1233,10773,1281,1013,268,-3297.787
1234,8817,6748,11532,-4784,-5079.181
1235,10981,1548,2552,-1004,-50.815
1236,1653,241,276,-35,-77.813
1237,13404,21390,29885,-8495,-7399.649
1238,8429,3781,3761,20,-849.691
1239,1383,14478,11359,3119,-2471.313
1240,6634,8072,12278,-4206,-7501.821
1241,5172,163,7324,-7161,-2226.307
1242,12880,10950,8622,2328,-481.486
1243,296,618,568,50,-159.087
1244,8755,4551,3616,935,1928.235
1245,7807,128,70,58,5.952
1246,11229,215,986,-771,-1073.509
1247,15105,153,460,-307,-990.09
1248,11197,11340,19240,-7900,-1523.313
1249,11442,2954,148,2806,497.148
1250,6636,13709,19643,-5934,-578.273
1251,12703,163,727,-564,-566.505
1252,14147,45025,67296,-22271,-13132.587
1253,10797,238,117,121,2958.337
1254,4077,37,72,-35,7.804
1255,12549,4431,12119,-7688,1530.304
1256,7967,1185,1580,-395,-324.962
1257,2763,114,93,21,98.886
1258,14128,1686,612,1074,1197.388
1259,10499,510,1230,-720,370.071
1260,8942,8105,6584,1521,-8882.893
1261,14242,1006,325,681,8177.548
1262,9234,8779,8576,203,-4102.049
1263,14458,623,325,298,180.479
1264,3495,2052,3540,-1488,61.626
1265,5182,204,524,-320,-47.55
1266,2968,225,312,-87,532.204
1267,14393,1552,1012,540,-90.58
1268,5334,4486,1530,2956,2892.904
1269,9272,3782,7696,-3914,-5133.195
1270,14715,432,517,-85,3219.593
1271,9112,6069,6612,-543,-2990.804
1272,14726,26640,7753,18887,2475.965
1273,736,1923,965,958,514.794
1274,7936,136,80,56,475.127
1275,4538,8216,6184,2032,2599.765
1276,428,5120,4772,348,53.445
1277,2529,10139,10618,-479,-327.355
1278,6163,1516,1815,-299,-2382.114
1279,4738,450,106,344,-708.905
1280,12763,973,843,130,-65.52
1281,1658,126,186,-60,-151.71
1282,11812,660,5194,-4534,-14606.498
1283,9246,22,2281,-2259,-584.838
1284,12871,477,1745,-1268,-741.386
1285,12264,91,198,-107,-550.331
1286,4667,3242,8220,-4978,-4347.238
1287,8857,5137,9994,-4857,-504.05
1288,12475,29,21,8,7.571
1289,510,4713,8038,-3325,-1335.774
1290,7800,3111,4717,-1606,-1023.104
1291,9383,825,496,329,217.915
1292,8919,11644,5103,6541,4467.227
1293,8010,64,505,-441,5.165
1294,2163,103,51,52,-230.87
1295,5072,5777,3347,2430,1567.753
1296,3981,440,134,306,169.818
1297,1192,4678,6464,-1786,2681.572
1298,3238,150,52,98,-276.609
1299,12946,341,110,231,108.966
1300,9518,7740,11239,-3499,-619.112
1301,122,9583,2594,6989,594.886
1302,11024,427,277,150,-790.663
1303,11334,149,61,88,-66.204
1304,8521,740,325,415,53.667
1305,4253,142,298,-156,25.762
1306,6498,8934,9013,-79,-1400.685
1307,6401,25148,17139,8009,299.028
1308,5441,9783,14535,-4752,-6178.085
1309,7157,30,71,-41,-40.96
1310,2546,6334,4433,1901,-245.522
1311,7464,23,22,1,13.752
1312,28,40,33,7,17.06
1313,6894,30,75,-45,-237.927
1314,12716,148,1431,-1283,1016.227
1315,8512,3110,1292,1818,-1456.455
1316,11869,5739,12513,-6774,-6506.345
1317,4456,58,58,0,7.432
1318,1014,201,246,-45,271.702
1319,11828,28695,24783,3912,-3804.472
1320,11023,290,4093,-3803,-820.338
1321,10794,63,350,-287,5404.91
1322,9372,102,111,-9,186.625
1323,9574,9140,7011,2129,616.58
1324,12865,6521,5729,792,-1465.172
1325,9366,86,2956,-2870,-5645.131
1326,5155,12190,6878,5312,1786.31
1327,11120,14830,14555,275,-31.631
1328,13154,127,475,-348,27.966
1329,8402,177,49,128,-755.35
1330,14337,4527,5037,-510,-419.855
1331,13480,2142,12550,-10408,-14999.88
1332,13498,9002,10073,-1071,-2775.513
1333,295,455,640,-185,-706.188
1334,3701,207,116,91,98.033
1335,3583,221,263,-42,-35.058
1336,5766,79,433,-354,-367.886
1337,5906,1105,134,971,291.911
1338,11144,7046,8262,-1216,1597.745
1339,7971,195,729,-534,77.07
1340,4752,5662,3465,2197,930.556
1341,10587,174,174,0,3.681
1342,13988,5232,8923,-3691,-5520.037
1343,13862,32001,25792,6209,-8510.397
1344,2493,122,321,-199,-68.049
1345,3723,414,573,-159,-16.32
1346,12873,172,139,33,-2192.916
1347,5677,2700,1015,1685,264.677
1348,6263,156,696,-540,281.479
1349,167,1131,2846,-1715,455.527
1350,1108,251,26863,-26612,-8503.7
1351,12258,374,158,216,393.752
1352,9019,628,372,256,3616.188
1353,5326,3210,7308,-4098,457.459
1354,8187,549,726,-177,109.497
1355,13860,4864,19203,-14339,-13764.203
1356,12842,1235,460,775,-1860.33
1357,12976,978,107,871,304.25
1358,2825,505,1283,-778,182.131
1359,9759,38,17,21,259.183
1360,15366,125,103,22,145.119
1361,10758,4509,1274,3235,1791.235
1362,10415,2193,628,1565,-173.46
1363,14169,8577,5805,2772,651.091
1364,382,21283,23217,-1934,-265.218
1365,927,2984,4005,-1021,2006.789
1366,4967,3793,6275,-2482,-2128.157
1367,14259,48940,26947,21993,8198.687
1368,4458,39,32,7,12.09
1369,2267,8369,5219,3150,-587.1
1370,10092,358,116,242,959.309
1371,1253,63,103,-40,67.888
1372,6610,2883,6239,-3356,-395.95
1373,810,1063,7524,-6461,-290.87
1374,2438,329,2058,-1729,-913.859
1375,13271,588,9207,-8619,-10798.941
1376,2718,442,352,90,50.426
1377,13184,148,206,-58,11.799
1378,5313,2643,2976,-333,-1838.139
1379,13162,43,66,-23,114.669
1380,6623,5814,7512,-1698,-1816.797
1381,2335,368,100,268,290.544
1382,14706,1898,1779,119,-3385.383
1383,13393,683,1770,-1087,-2088.653
1384,13976,11781,9844,1937,-2083.907
1385,2404,142,315,-173,263.563
1386,13864,24565,38996,-14431,-19699.627
1387,11021,984,707,277,3840.834
1388,11594,39953,46193,-6240,-5432.698
1389,6660,18852,15543,3309,1247.535
1390,896,1331,2664,-1333,-4788.394
1391,8824,287,900,-613,-2199.987
1392,9670,6146,6734,-588,-1093.679
1393,10564,23,17,6,42.546
1394,12578,12104,22155,-10051,-1942.009
1395,158,1024,541,483,-634.745
1396,13892,47004,49529,-2525,-25728.798
1397,14194,1031,670,361,7973.846
1398,6038,27,24,3,2.444
1399,12581,187,394,-207,36.821
1400,6981,104,109,-5,-23.174
1401,11733,64,37,27,36.277
1402,13466,33205,18380,14825,-4189.77
1403,10736,555,880,-325,-870.55
1404,4868,2804,2642,162,262.719
1405,9996,329,186,143,1188.869
1406,14705,9511,27345,-17834,-1119.235
1407,13920,23834,32424,-8590,-10236.386
1408,3679,270,146,124,-43.121
1409,11036,187,1812,-1625,-1338.564
1410,12535,161,4401,-4240,161.32
1411,8056,1015,667,348,-16.629
1412,12655,117,2093,-1976,-869.617
1413,14918,38,21,17,14.252
1414,651,144,3733,-3589,-5218.212
1415,4134,105,74,31,26.276
1416,10257,61,84,-23,-361.998
1417,13429,949,711,238,-858.065
1418,13443,2863,39294,-36431,-12073.128
1419,3387,101,125,-24,23.531
1420,11556,1794,2639,-845,1245.31
1421,8389,222,277,-55,-829.378
1422,5884,19485,4834,14651,5450.503
1423,12730,777,750,27,147.067
1424,6629,2262,3328,-1066,327.052
1425,5229,2953,2356,597,-35.363
1426,5994,142,53,89,63.259
1427,12931,502,78,424,301.184
1428,12954,461,106,355,185.635
1429,12917,305,94,211,-448.931
1430,6279,144,493,-349,563.694
1431,13168,249,69,180,-49.633
1432,7023,23,22,1,2.361
1433,3842,225,178,47,616.929
1434,6046,132,148,-16,-14.029
1435,7189,38,49,-11,3.139
1436,12620,994,155,839,210.71
1437,14581,47,61,-14,65.049
1438,5117,428,173,255,-1103.795
1439,4327,135,131,4,-32.773
1440,4193,92,93,-1,16.546
1441,4279,139,231,-92,-47.429
1442,4071,21,32,-11,102.467
1443,5148,166,510,-344,308.864
1444,4192,33,31,2,24.163
1445,5178,5839,6608,-769,-138.179
1446,5085,1456,4904,-3448,1514.94
1447,9333,5763,4727,1036,-3884.374
1448,12771,243,357,-114,241.745
1449,8042,152,74,78,427.748
1450,442,4037,5435,-1398,-2048.97
1451,9549,984,737,247,-6586.204
1452,12279,771,2704,-1933,-1782.279
1453,3507,111,36,75,6.035
1454,12527,12837,28024,-15187,1290.258
1455,5136,516,271,245,169.42
1456,11269,142,8349,-8207,-1939.695
1457,12377,117,130,-13,-15.785
1458,2494,264,332,-68,-4161.882
1459,4817,394,553,-159,150.828
1460,10820,2309,8239,-5930,797.637
1461,6173,2512,1279,1233,261.099
1462,3811,138,121,17,422.402
1463,12817,2727,7102,-4375,-1274.866
1464,10033,241,10321,-10080,-4870.441
1465,6699,183,1451,-1268,-728.251
1466,6461,20811,12788,8023,3301.73
1467,3291,344,361,-17,70.405
1468,4217,193,188,5,-1.699
1469,8387,479,683,-204,395.605
1470,14370,56,2339,-2283,-719.415
1471,6521,1667,13253,-11586,-9934.709
1472,14750,3877,33071,-29194,-21150.993
1473,1163,251,881,-630,-36.187
1474,8822,6837,15507,-8670,182.694
1475,1074,3223,3077,146,1037.383
1476,15439,1225,132,1093,386.546
1477,8158,120,53,67,111.704
1478,14042,340,822,-482,636.323
1479,1563,152,323,-171,143.365
1480,10085,16219,11080,5139,793.622
1481,12207,60,132,-72,-71.226
1482,7078,27,16,11,7.461
1483,2579,1727,2125,-398,457.894
1484,14476,421,297,124,368.763
1485,6418,210,1266,-1056,-3702.598
1486,2107,1202,506,696,-91.78
1487,4621,11357,9600,1757,-846.291
1488,12595,6728,19142,-12414,-12137.815
1489,2624,67,121,-54,198.688
1490,6417,4621,3082,1539,514.359
1491,264,3523,968,2555,2053.674
1492,11117,13467,10180,3287,-147.399
1493,8762,874,324,550,-449.912
1494,2603,32,854,-822,-904.863
1495,14220,984,6772,-5788,-8046.48
1496,10226,21,505,-484,-420.967
1497,14239,2451,44583,-42132,-23330.032
1498,13352,4347,9816,-5469,-5486.907
1499,11138,566,2040,-1474,193.845
1500,13284,4178,30965,-26787,-14965.613
1501,8115,39,105,-66,424.193
1502,2334,275,114,161,185.566
1503,6972,37,410,-373,-635.899
1504,6242,823,1176,-353,2085.964
1505,10923,2856,497,2359,-107.132
1506,12556,1400,366,1034,-1304.484
1507,5304,341,1109,-768,-1357.547
1508,11558,53851,51608,2243,2218.385
1509,10223,56,47,9,455.987
1510,9775,88,36,52,-32.714
1511,4707,5265,3688,1577,364.217
1512,6840,28,16,12,7.647
1513,3285,93,30,63,-151.266
1514,14145,18094,10140,7954,-9766.251
1515,11183,12978,14635,-1657,-619.872
1516,271,5599,1083,4516,558.97
1517,10077,4819,3466,1353,907.133
1518,12859,6598,6214,384,1335.406
1519,10062,1513,305,1208,-1780.372
1520,11000,6320,9536,-3216,-1013.982
1521,3910,154,768,-614,382.073
1522,10664,39,19,20,12.004
1523,3938,647,1585,-938,-547.946
1524,508,2799,2361,438,455.275
1525,12929,484,377,107,137.025
1526,2982,439,2849,-2410,290.869
1527,6554,12124,16372,-4248,-696.078
1528,8452,3348,5703,-2355,-124.788
1529,2313,536,356,180,127.551
1530,2951,136,261,-125,-1696.563
1531,503,1485,2809,-1324,761.079
1532,10194,472,3019,-2547,-2094.265
1533,9167,5603,7164,-1561,1732.271
1534,13725,4992,24710,-19718,595.624
1535,8315,3976,8500,-4524,-1668.091
1536,1136,747,678,69,1781.775
1537,13720,534,687,-153,12624.432
1538,13479,494,18055,-17561,-2778.415
1539,5535,62,152,-90,1.585
1540,7399,17,247,-230,-178.496
1541,13299,7862,14468,-6606,-3808.244
1542,5755,34,160,-126,-40.752
1543,2980,99,371,-272,-14.122
1544,2180,461,1147,-686,-36.518
1545,1393,2618,16213,-13595,-5599.718
1546,431,3755,612,3143,1808.302
1547,2644,1174,360,814,453.533
1548,14018,366,191,175,-146.725
1549,610,5816,7972,-2156,1234.097
1550,10906,385,6721,-6336,3753.312
1551,14146,5283,36407,-31124,-18690.663
1552,13568,8526,6990,1536,1687.089
1553,13001,493,1426,-933,35.962
1554,2978,317,166,151,375.887
1555,6615,14024,9380,4644,73.102
1556,11490,116,107,9,388.953
1557,1444,2428,1451,977,19.173
1558,11114,6351,11930,-5579,-7170.326
1559,467,9801,10564,-763,3825.555
1560,13908,9110,17895,-8785,-7378.386
1561,819,2437,4724,-2287,-261.478
1562,11085,2318,1539,779,594.606
1563,14073,395,5057,-4662,-3704.319
1564,2006,4510,3294,1216,1739.081
1565,4555,152,4423,-4271,-2339.394
1566,2606,263,1251,-988,-281.131
1567,9172,264,2094,-1830,-462.724
1568,8416,1906,1989,-83,-57.956
1569,7838,112,513,-401,928.87
1570,4407,23,20,3,2.654
1571,12847,3528,4353,-825,399.543
1572,7913,1777,1696,81,264.897
1573,8709,529,1057,-528,894.793
1574,6435,22036,12879,9157,1836.392
1575,15046,5766,3843,1923,1006.248
1576,13916,13261,23852,-10591,-11260.192
1577,614,163,96,67,-274.576
1578,10325,23,22,1,10.879
1579,10903,1409,4757,-3348,-1620.014
1580,12584,3165,225,2940,1167.235
1581,6632,5247,8957,-3710,-3312.647
1582,14559,5875,6624,-749,28.25
1583,9945,7888,2882,5006,-251.607
1584,2083,11763,948,10815,943.686
1585,2885,7132,595,6537,468.805
1586,9665,482,298,184,2872.13
1587,2792,37,294,-257,-618.484
1588,12170,52,21,31,3.683
1589,6260,6848,4766,2082,656.426
1590,1572,1530,4925,-3395,-2125.481
1591,12788,180,68,112,1159.5
1592,5373,396,3111,-2715,-728.605
1593,11560,55480,43816,11664,606.558
1594,9169,1632,1449,183,232.256
1595,9427,4045,5870,-1825,-1030.822
1596,5245,12012,7838,4174,-852.716
1597,2231,4150,4107,43,1330.3
1598,3427,144,78,66,64.317
1599,7337,43,152,-109,-44.588
1600,13125,117,835,-718,-203.184
1601,14478,1725,2936,-1211,-75.831
1602,3972,3043,3033,10,-2976.87
1603,15133,113,132,-19,131.969
1604,10815,1272,1435,-163,582.814
1605,5960,135,44,91,675.153
1606,12827,1742,3090,-1348,890.527
1607,10438,339,221,118,486.759
1608,14307,223,159,64,117.376
1609,5648,443,964,-521,-263.39
1610,10629,270,41,229,-0.15
1611,743,29462,22921,6541,-3729.739
1612,14738,36295,34264,2031,2055.992
1613,11822,746,1478,-732,-864.919
1614,13377,810,208,602,-3109.343
1615,4660,5995,7938,-1943,-1794.003
1616,8710,1248,1394,-146,211.683
1617,12163,46,33,13,31.036
1618,420,762,385,377,-2313.488
1619,6540,3154,11457,-8303,-7334.247
1620,7061,71,58,13,7.235
1621,12158,34,26,8,-1.581
1622,326,7731,11325,-3594,623.373
1623,13842,24242,19237,5005,2167.46
1624,4541,599,1919,-1320,2210.939
1625,12973,1487,133,1354,572.797
1626,7885,1176,518,658,516.74
1627,10976,589,189,400,-1830.279
1628,10745,315,324,-9,1126.724
1629,9106,2915,1409,1506,1593.49
1630,632,14548,10142,4406,1641.683
1631,10054,5684,3539,2145,-370.503
1632,4638,1298,4906,-3608,-3180.375
1633,7852,543,1329,-786,-810.085
1634,8162,61,45,16,157.333
1635,10949,776,307,469,877.957
1636,3290,72,263,-191,-141.802
1637,14262,5473,46287,-40814,-26167.151
1638,10944,4578,3943,635,145.299
1639,6877,66,59,7,16.86
1640,8215,128,299,-171,357.211
1641,11177,1574,11789,-10215,-6069.019
1642,8028,542,931,-389,192.884
1643,13869,18152,19173,-1021,22.396
1644,11893,2084,13640,-11556,-6693.082
1645,9813,1466,104,1362,-25.907
1646,8439,335,1022,-687,-938.518
1647,7787,182,75,107,52.779
1648,12336,55,35,20,44.709
1649,1254,665,333,332,-341.642
1650,6564,43,851,-808,-396.322
1651,7288,152,364,-212,76.38
1652,8862,188,15428,-15240,-2809.068
1653,682,1895,2875,-980,-661.642
1654,10609,68,44,24,18.322
1655,14088,631,6446,-5815,9523.386
1656,4829,3588,3729,-141,2057.301
1657,12280,2620,1923,697,62.009
1658,11507,9125,37395,-28270,-6015.308
1659,109,465,1100,-635,5.699
1660,3466,1935,1224,711,-1388.246
1661,5298,3749,5028,-1279,1731.102
1662,6319,106,498,-392,-102.246
1663,3418,3676,3556,120,-4.772
1664,13416,20444,34907,-14463,-8065.37
1665,13252,1735,21172,-19437,-1056.059
1666,6616,1954,1295,659,278.879
1667,1633,287,123,164,252.823
1668,279,581,386,195,1211.388
1669,4179,126,135,-9,4.459
1670,862,3145,4951,-1806,-88.105
1671,15079,1587,2723,-1136,-2310.103
1672,5435,18165,11132,7033,1632.575
1673,9136,3778,4582,-804,3041.375
1674,14078,1796,840,956,7940.865
1675,5469,9497,19871,-10374,-11091.761
1676,15042,3242,12156,-8914,-2589.784
1677,12130,52,28,24,13.459
1678,8508,883,1189,-306,418.071
1679,802,4679,5973,-1294,-275.714
1680,9419,1622,1302,320,-693.976
1681,12607,97,184,-87,-186.34
1682,10402,157,178,-21,202.49
1683,6529,139,2708,-2569,-4343.894
1684,2292,3808,1661,2147,-1972.261
1685,9514,1249,2059,-810,-405.807
1686,314,329,3490,-3161,-3672.399
1687,5428,5818,11403,-5585,-3924.023
1688,4607,7773,6173,1600,-895.767
1689,2679,269,638,-369,-205.874
1690,537,680,4507,-3827,-3907.268
1691,3833,669,348,321,609.399
1692,9627,1757,1172,585,-348.205
1693,4627,1843,4820,-2977,-723.234
1694,6256,1021,2348,-1327,-1909.108
1695,9676,6070,7599,-1529,-456.696
1696,2082,1888,470,1418,3177.126
1697,3879,4292,2454,1838,-376.838
1698,6281,1167,1206,-39,-909.955
1699,3747,176,40,136,-65.543
1700,11825,2753,9928,-7175,-4366.542
1701,11890,6929,15319,-8390,-2360.512
1702,14020,134,444,-310,3951.356
1703,5708,29,54,-25,-1.892
1704,2987,91,101,-10,26.447
1705,2020,3767,3326,441,1008.212
1706,5613,137,917,-780,-71.792
1707,3865,4276,2480,1796,-254.194
1708,9083,704,2430,-1726,1154.468
1709,13547,225,1002,-777,3217.071
1710,3383,23,37,-14,53.519
1711,13867,39094,46047,-6953,-12496.623
1712,13375,17014,11277,5737,-2438.255
1713,9233,20009,25084,-5075,-4834.539
1714,8546,6291,8370,-2079,-853.08
1715,7979,1253,1258,-5,-693.155
1716,15009,5352,12818,-7466,-248.356
1717,12582,13066,9932,3134,-5063.618
1718,7661,25,13,12,5.27
1719,13363,6605,11062,-4457,-971.888
1720,5517,455,99,356,-24.96
1721,12836,433,905,-472,187.908
1722,8038,53,314,-261,35.414
1723,11018,665,3499,-2834,-3121.758
1724,3916,1253,365,888,52.198
1725,2657,260,165,95,74.909
1726,14846,196,116,80,110.902
1727,14883,543,254,289,33.171
1728,12994,563,180,383,261.964
1729,10774,99,18740,-18641,-1918.505
1730,2241,2467,464,2003,-213.782
1731,14577,2452,4956,-2504,549.315
1732,14408,1303,1789,-486,0.567
1733,5279,7992,7969,23,1597.816
1734,5388,968,2652,-1684,-4383.768
1735,1301,7034,1256,5778,2550.451
1736,10759,3430,16282,-12852,174.371
1737,8918,20123,16835,3288,-2189.469
1738,7765,94,621,-527,-2656.694
1739,9175,29,247,-218,-1661.39
1740,12206,41,40,1,92.247
1741,13583,658,547,111,-1333.167
1742,13234,16844,18346,-1502,14736.443
1743,8775,283,386,-103,129.74
1744,5415,2008,3727,-1719,-676.967
1745,6992,13,25,-12,51.254
1746,9111,2906,4941,-2035,-5053.605
1747,8446,2373,3872,-1499,28.539
1748,13083,539,1667,-1128,-631.151
1749,3161,42,89,-47,0.525
1750,15522,319,825,-506,-824.339
1751,13541,7704,258,7446,2151.669
1752,5184,48,117,-69,91.01
1753,4011,401,647,-246,-75.148
1754,13126,409,56,353,-0.545
1755,2533,10564,6560,4004,567.08
1756,6254,646,257,389,307.784
1757,8004,30,1456,-1426,-545.958
1758,12808,5027,8729,-3702,-2325.601
1759,1057,3407,3968,-561,357.711
1760,9341,690,6821,-6131,-4410.704
1761,8574,1273,2602,-1329,-648.671
1762,5762,209,388,-179,68.025
1763,1455,21257,21863,-606,-5430.778
1764,6151,318,891,-573,628.089
1765,10872,326,4363,-4037,1938.542
1766,8496,1004,1348,-344,258.572
1767,1077,3678,3004,674,941.318
1768,2329,201,135,66,127.798
1769,8137,69,63,6,332.206
1770,1085,2712,1622,1090,1359.314
1771,12752,533,166,367,450.799
1772,2062,2815,4304,-1489,-3624.56
1773,14315,1364,1229,135,55.752
1774,1549,32611,21543,11068,-3007.109
1775,7889,1664,3139,-1475,287.98
1776,5064,45593,17170,28423,4052.063
1777,6220,4930,7848,-2918,1565.607
1778,6317,160,134,26,87.995
1779,2444,115,140,-25,-26.046
1780,6062,165,105,60,52.491
1781,10531,34,43,-9,-47.874
1782,10296,171,212,-41,-287.921
1783,14434,248,364,-116,-98.816
1784,11888,1764,13016,-11252,-6533.977
1785,11700,120,36,84,6.479
1786,1096,1542,1172,370,3499.937
1787,6555,5220,4386,834,393.953
1788,5162,3850,6247,-2397,-3591.315
1789,12653,409,71,338,-296.041
1790,954,459,2496,-2037,-593.38
1791,660,1296,4809,-3513,-1118.171
1792,7582,143,90,53,7.581
1793,14764,2227,2411,-184,1445.57
1794,3381,91,306,-215,-138.485
1795,7058,47,27,20,9.005
1796,7942,1158,1672,-514,-717.849
1797,11823,525,2971,-2446,-4146.843
1798,5007,3217,2757,460,629.161
1799,4572,139,488,-349,-4416.756
1800,10907,284,4596,-4312,-1021.661
1801,3079,219,49,170,35.974
1802,15003,2767,4871,-2104,-4996.145
1803,10496,670,2830,-2160,-160.024
1804,2909,1985,2904,-919,-1552.122
1805,1668,107,550,-443,272.318
1806,10913,160,222,-62,927.998
1807,480,6831,5162,1669,896.013
1808,3182,38,18,20,-4.489
1809,6081,23,218,-195,-48.352
1810,11615,98,127,-29,13.915
1811,1985,183,120,63,1009.583
1812,13015,212,80,132,-264.703
1813,6456,5680,6354,-674,-3060.213
1814,584,7751,7966,-215,3002.054
1815,2457,1159,1574,-415,299.879
1816,14231,315,2407,-2092,-2327.791
1817,14218,22819,52658,-29839,-29421.128
1818,5584,2258,121,2137,798.713
1819,2676,108,202,-94,358.613
1820,8887,18916,3416,15500,1190.559
1821,14172,10127,34376,-24249,4420.462
1822,834,574,408,166,587.244
1823,13489,14474,18410,-3936,-1610.702
1824,2299,5273,2150,3123,-249.816
1825,475,5207,6912,-1705,-4303.345
1826,12297,1278,300,978,-207.869
1827,13367,6931,7338,-407,-5565.402
1828,10057,137,143,-6,186.538
1829,5789,141,123,18,85.687
1830,11147,5569,10850,-5281,-2685.628
1831,226,128,57,71,318.723
1832,5231,917,273,644,-932.129
1833,5164,5313,5335,-22,-317.341
1834,4581,2140,3196,-1056,-3854.605
1835,6167,1608,343,1265,-188.655
1836,6393,320,78,242,777.032
1837,12294,553,1898,-1345,565.295
1838,5276,296,154,142,146.287
1839,7717,1169,1483,-314,74.29
1840,9902,3211,4852,-1641,-437.551
1841,3173,23,27,-4,-28.287
1842,4827,541,5694,-5153,-2425.303
1843,1340,35816,14026,21790,2398.174
1844,4743,321,196,125,-247.052
1845,7190,26,45,-19,1.808
1846,5167,9473,11318,-1845,854.564
1847,12962,535,1252,-717,280.834
1848,1464,11126,14829,-3703,-1899.483
1849,3424,208,572,-364,-793.831
1850,7840,165,947,-782,207.566
1851,9440,2143,2771,-628,-516.053
1852,2569,3910,3708,202,230.671
1853,8994,2285,4842,-2557,-6641.323
1854,5610,41,125,-84,12.227
1855,9321,1075,986,89,-49.12
1856,12511,2389,2543,-154,940.054
1857,8287,337,198,139,546.821
1858,6138,1018,638,380,-1082.148
1859,1452,30785,26269,4516,1486.025
1860,10777,146,372,-226,-639.91
1861,9450,1979,6069,-4090,-2745.633
1862,11458,676,100,576,226.901
1863,6965,661,665,-4,76.198
1864,10908,431,416,15,-3142.605
1865,4682,230,6833,-6603,-3855.037
1866,9392,1903,977,926,-2438.502
1867,12846,7990,4302,3688,804.363
1868,14392,2409,3282,-873,-1762.94
1869,13439,37201,35915,1286,-6324.202
1870,14386,2258,1759,499,17.323
1871,1073,4090,3373,717,3642.103
1872,7816,2534,3528,-994,1085.848
1873,1042,1960,2582,-622,-3736.349
1874,1510,2582,7076,-4494,587.346
1875,9394,13224,10550,2674,627.807
1876,531,1254,390,864,-147.205
1877,5895,55318,23118,32200,-2918.107
1878,4426,30,22,8,5.639
1879,9390,8501,7226,1275,819.63
1880,7968,29,276,-247,-196.803
1881,10647,21,49,-28,-310.637
1882,10543,123,101,22,68.952
1883,6930,332,238,94,-159.822
1884,12589,121,375,-254,-1524.905
1885,1526,30385,9786,20599,507.69
1886,14023,7869,11117,-3248,625.027
1887,9519,6678,9095,-2417,-724.857
1888,13907,4212,10088,-5876,-10152.342
1889,3069,25,31,-6,-13.726
1890,5021,3210,2012,1198,641.877
1891,14875,423,1001,-578,-108.231
1892,9466,792,1537,-745,-1446.213
1893,2078,8964,4651,4313,1540.713
1894,5103,448,1390,-942,-2208.562
1895,5860,5400,13793,-8393,-10730.583
1896,2547,7961,7483,478,408.921
1897,10662,26,23,3,10.054
1898,4240,265,250,15,0.625
1899,5779,655,182,473,119.89
1900,5121,721,15034,-14313,-3549.372
1901,6987,383,511,-128,-338.347
1902,13286,12779,28573,-15794,-3708.521
1903,5958,63,239,-176,-34.732
1904,14759,69360,39955,29405,31922.887
1905,934,3484,4119,-635,-1084.421
1906,11130,11625,14843,-3218,26.767
1907,11801,26609,22264,4345,-4482.126
1908,10783,283,861,-578,414.915
1909,5397,1323,3024,-1701,-1136.775
1910,8335,2307,548,1759,708.741
1911,4373,102,56,46,-36.808
1912,8900,1721,4501,-2780,-1256.566
1913,9564,11007,7590,3417,109.54
1914,14751,17878,3503,14375,2204.117
1915,10709,203,610,-407,3411.779
1916,6838,19,14,5,19.284
1917,14161,10807,20975,-10168,-4595.687
1918,15087,4775,2295,2480,730.961
1919,2946,151,558,-407,-37.9
1920,5818,672,2869,-2197,-431.198
1921,1533,23492,5219,18273,845.657
1922,13764,6018,1561,4457,17190.146
1923,9245,7049,6304,745,-2969.436
1924,15131,411,111,300,253.002
1925,7792,74,192,-118,185.656
1926,14106,7103,33858,-26755,-10651.351
1927,838,5136,7772,-2636,-748.626
1928,8105,141,37,104,483.988
1929,8364,1162,560,602,-648.912
1930,487,1696,735,961,915.54
1931,13747,37459,21874,15585,2824.042
1932,6506,11005,25020,-14015,-6497.815
1933,2570,796,1652,-856,-405.492
1934,7079,24,40,-16,7.924
1935,1626,2297,1657,640,490.194
1936,10262,57,127,-70,-856.759
1937,8874,9095,1405,7690,772.714
1938,3216,691,1476,-785,-13.277
1939,13835,52215,61448,-9233,-182.876
1940,2894,2660,2410,250,153.549
1941,4114,106,71,35,1.2
1942,8550,389,448,-59,-1176.482
1943,2618,888,229,659,318.938
1944,5325,6803,4179,2624,1140.616
1945,1417,24667,25261,-594,-8138.537
1946,12927,1303,117,1186,602.394
1947,8233,111,126,-15,253.6
1948,13290,22902,25647,-2745,-8279.626
1949,14343,416,1718,-1302,-272.135
1950,3844,2979,1686,1293,633.854
1951,1461,5609,15735,-10126,-8276.993
1952,13211,6196,37786,-31590,-19171.566
1953,15571,682,225,457,106.084
1954,1062,2292,1871,421,218.47
1955,9929,166,654,-488,-358.6
1956,10974,223,128,95,-879.101
1957,2898,65,4158,-4093,-600.088
1958,9301,934,678,256,183.139
1959,135,1995,5200,-3205,-3854.547
1960,14179,2536,7747,-5211,-8913.539
1961,6539,1901,1982,-81,-1442.112
1962,14132,19435,12890,6545,2071.728
1963,12829,247,202,45,-1010.027
1964,706,279,4830,-4551,-1549.63
1965,6157,4856,1366,3490,-885.07
1966,9686,2620,3373,-753,1441.161
1967,1562,822,21919,-21097,-1863.049
1968,9546,7747,12730,-4983,-3223.441
1969,13301,17707,12159,5548,1960.431
1970,3925,90,451,-361,745.279
1971,10901,165,3554,-3389,-3412.006
1972,5344,434,3431,-2997,-2538.062
1973,10821,193,208,-15,151.668
1974,14578,4640,8196,-3556,-2.514
1975,297,204,16202,-15998,-4290.102
1976,594,236,2762,-2526,-2004.759
1977,11140,2408,1110,1298,131.259
1978,3001,27,59,-32,0.499
1979,4408,38,33,5,0.19
1980,9223,13626,13222,404,-1885.862
1981,3652,365,847,-482,-16.898
1982,9241,6279,15061,-8782,-13829.242
1983,9819,553,717,-164,-36.666
1984,6556,4592,4231,361,-1754.88
1985,14781,99302,33131,66171,39459.939
1986,1337,18966,26693,-7727,-588.408
1987,13423,6217,12698,-6481,3626.199
1988,10286,29,396,-367,-1596.855
1989,2506,4126,6531,-2405,-3355.417
1990,9042,2284,289,1995,1527.95
1991,8483,249,2085,-1836,880.095
1992,995,5150,3880,1270,-1784.942
1993,13768,7615,904,6711,12571.825
1994,5222,34,793,-759,761.267
1995,5051,3823,12527,-8704,-6070.675
1996,8743,1652,1130,522,-255.081
1997,544,1998,5210,-3212,-2827.826
1998,2193,834,2827,-1993,-948.448
1999,14038,2001,360,1641,2081.101
2000,9618,442,2635,-2193,-2951.764
2001,14325,1719,2297,-578,698.619
2002,8911,21115,9987,11128,3360.431
2003,4465,35,20,15,8.508
2004,14505,1419,1209,210,-835.716
2005,756,22632,22659,-27,3129.98
2006,1443,28608,26928,1680,600.349
2007,7323,44,133,-89,-24.617
2008,9974,143,809,-666,-822.603
2009,5817,35892,14649,21243,-3920.079
2010,6068,54,60,-6,-0.923
2011,6599,15235,7028,8207,2514.826
2012,126,1436,542,894,299.962
2013,2627,122,1361,-1239,-633.106
2014,9668,7723,8071,-348,53.111
2015,1590,33480,8489,24991,2981.977
2016,5680,1690,194,1496,8.4
2017,9140,2224,2481,-257,443.945
2018,10010,1222,1051,171,-33.134
2019,12611,307,175,132,154.532
2020,14030,4571,11827,-7256,-1690.307
2021,4928,2543,585,1958,2268.148
2022,6900,530,169,361,6.277
2023,14330,234,2107,-1873,-438.145
2024,15548,922,92,830,-756.031
2025,13212,3943,1814,2129,7303.238
2026,5273,629,1337,-708,-2.29
2027,3284,132,67,65,94.942
2028,7962,363,116,247,1192.01
2029,13959,732,210,522,728.343
2030,15364,271,1018,-747,67.147
2031,7346,93,47,46,13.669
2032,2939,402,406,-4,595.496
2033,13852,19038,29327,-10289,1300.957
2034,11244,1370,966,404,102.559
2035,15363,364,84,280,49.543
2036,14506,506,775,-269,353.867
2037,5102,4067,1113,2954,190.009
2038,4697,207,413,-206,-2171.103
2039,6842,41,62,-21,-8.219
2040,9307,162,2599,-2437,-1954.42
2041,7867,1285,1009,276,-16.242
2042,9926,2303,571,1732,1993.018
2043,1076,345,1608,-1263,-1721.882
2044,5399,3048,1158,1890,548.962
2045,13012,2562,846,1716,669.171
2046,6590,3389,13113,-9724,-1572.969
2047,12669,192,188,4,-326.166
2048,5668,4528,143,4385,458.854
2049,104,220,131,89,-1584.742
2050,9040,285,547,-262,-44.616
2051,4837,3235,891,2344,326.022
2052,1278,295,117,178,-235.287
2053,384,17062,19298,-2236,-211.912
2054,1261,162,69,93,190.208
2055,5738,430,451,-21,-20.312
2056,533,2910,1924,986,435.079
2057,4690,7780,3535,4245,111.441
2058,14305,1452,4845,-3393,-1205.752
2059,8036,646,122,524,-71.101
2060,7815,1271,384,887,444.596
2061,13045,1374,1017,357,909.156
2062,2502,33,100,-67,928.289
2063,7837,92,1699,-1607,-568.375
2064,14508,7005,8084,-1079,-335.884
2065,391,47,38,9,-1925.997
2066,15190,345,102,243,303.219
2067,483,2702,1141,1561,-5433.045
2068,15097,8840,12074,-3234,-45.271
2069,4442,38,29,9,8.103
2070,1053,2521,2991,-470,-1766.4
2071,8372,8506,8716,-210,-2642.366
2072,5157,1549,1928,-379,691.581
2073,13898,13792,33968,-20176,-20258.433
2074,14841,71,23,48,-9.205
2075,14166,407,1136,-729,-968.349
2076,446,3975,5836,-1861,-2129.406
2077,1547,819,289,530,2238.13
2078,10678,160,94,66,22.123
2079,549,471,139,332,-563.378
2080,9430,805,2663,-1858,-1029.069
2081,14796,573,6183,-5610,39.678
2082,1391,24248,20019,4229,5841.677
2083,11621,42,58,-16,29.839
2084,13983,11222,23749,-12527,-7371.255
2085,5756,108,95,13,72.811
2086,5720,453,200,253,117.708
2087,14714,34158,106128,-71970,-7635.528
2088,6108,1306,2132,-826,-462.946
2089,11134,8614,14788,-6174,-2851.03
2090,14730,2774,7429,-4655,944.634
2091,14007,1174,6963,-5789,6607.922
2092,5303,1255,1041,214,-1810.726
2093,9153,1689,803,886,681.421
2094,425,183,325,-142,-2576.339
2095,15018,1325,3252,-1927,-5026.477
2096,15027,252,274,-22,1549.427
2097,12632,45,273,-228,-880.342
2098,13493,11355,10497,858,-1583.09
2099,8531,153,222,-69,-539.345
2100,1177,1838,11920,-10082,-728.625
2101,15488,1130,531,599,281.954
2102,12735,57,102,-45,135.218
2103,2750,501,767,-266,-17.871
2104,9695,86,6111,-6025,-2908.405
2105,10500,80,33,47,-43.655
2106,8409,4539,6612,-2073,-2337.191
2107,14192,556,6296,-5740,-6062.037
2108,7701,149,33,116,309.508
2109,11427,115,75,40,230.346
2110,10161,426,1904,-1478,-1220.099
2111,15499,104,113,-9,-74.387
2112,6100,1660,3398,-1738,-842.178
2113,2631,276,222,54,25.354
2114,1642,441,795,-354,17.933
2115,5328,10295,9910,385,20.551
2116,12977,906,880,26,-154.692
2117,13974,1508,997,511,-2712.88
2118,4285,53,38,15,-13.894
2119,14289,4067,5325,-1258,4339.185
2120,8455,491,547,-56,50.35
2121,1331,27113,22150,4963,-2989.044
2122,3248,8,232,-224,-370.849
2123,4949,358,1701,-1343,313.934
2124,8785,330,285,45,364.728
2125,913,245,121,124,1566.555
2126,10106,2254,4692,-2438,-1679.431
2127,2519,1271,9664,-8393,-3216.592
2128,1429,12268,19817,-7549,-4780.515
2129,2893,369,1681,-1312,37.932
2130,4306,36,19,17,-11.043
2131,10547,333,342,-9,-110.733
2132,12041,16,14,2,6.47
2133,11283,2441,548,1893,2594.774
2134,12465,23,27,-4,3.435
2135,13958,24884,34289,-9405,-2286.789
2136,1508,552,11692,-11140,-1254.36
2137,11922,218,82,136,36.761
2138,6361,376,295,81,132.08
2139,7125,149,133,16,-0.215
2140,6165,3814,536,3278,-3077.844
2141,842,933,568,365,-983.968
2142,1140,11886,13375,-1489,10.204
2143,2039,884,2498,-1614,-2795.864
2144,4220,100,215,-115,-103.999
2145,2073,4458,15072,-10614,-3477.839
2146,7866,321,791,-470,-844.493
2147,8910,1372,2423,-1051,65.408
2148,6217,850,3561,-2711,229.686
2149,4560,1455,3395,-1940,1871.692
2150,680,8862,13574,-4712,-1710.264
2151,6287,1827,2705,-878,-3427.6
2152,11518,50836,54043,-3207,3664.397
2153,3206,118,1001,-883,-401.813
2154,13336,1106,16613,-15507,-8461.735
2155,5302,11968,12662,-694,-4398.76
2156,15127,56,31,25,90.432
2157,6837,124,114,10,20.875
2158,2495,678,1067,-389,415.955
2159,4862,338,574,-236,38.818
2160,3998,1784,601,1183,-219.19
2161,8741,3819,5494,-1675,-2033.602
2162,6515,2040,2143,-103,-3473.269
2163,9194,407,5070,-4663,-1336.777
2164,9780,165,157,8,-20.691
2165,5318,3038,1994,1044,-422.519
2166,15391,529,81,448,334.686
2167,13588,189,118,71,962.219
2168,14112,21032,19001,2031,-3434.252
2169,8855,6753,1198,5555,2267.904
2170,14732,452,63184,-62732,-18736.34
2171,6497,1001,3013,-2012,-852.617
2172,2784,28,165,-137,10.618
2173,14575,126,640,-514,123.356
2174,159,3192,2136,1056,134.736
2175,14765,36478,7636,28842,11264.629
2176,14031,1235,773,462,-1700.009
2177,6545,10914,20225,-9311,-939.722
2178,4653,3856,6486,-2630,881.467
2179,192,1087,2380,-1293,-1128.37
2180,1553,19430,8029,11401,-425.442
2181,10274,610,494,116,-119.689
2182,13096,1277,5771,-4494,2021.005
2183,358,8077,7973,104,-174.954
2184,10362,22,21,1,-1.254
2185,2416,479,1175,-696,-211.662
2186,10674,28,47,-19,16.223
2187,857,137,561,-424,-2.137
2188,8417,2643,9439,-6796,-1263.256
2189,855,1485,9280,-7795,-162.763
2190,591,237,1775,-1538,385.764
2191,2636,469,159,310,82.231
2192,994,605,122,483,-218.887
2193,1279,175,227,-52,298.305
2194,11585,466,337,129,1448.488
2195,13939,22850,19164,3686,-6229.573
2196,622,5165,12249,-7084,-4943.849
2197,1538,3645,1605,2040,957.312
2198,10063,2189,795,1394,-3332.312
2199,4245,73,49,24,-34.877
2200,2336,58,138,-80,-3.248
2201,3830,338,166,172,884.708
2202,5735,130,91,39,81.879
2203,14126,31214,27777,3437,-1247.599
2204,3224,64,350,-286,-25.001
2205,4184,55,32,23,24.011
2206,1537,103,15942,-15839,-5402.613
2207,3603,79,35,44,11.791
2208,9154,573,1345,-772,-1943.125
2209,641,271,2299,-2028,-4646.853
2210,7964,633,3750,-3117,-732.502
2211,3826,701,113,588,1182.839
2212,5892,35311,18009,17302,10677.652
2213,8955,15674,23362,-7688,4709.542
2214,1094,65,304,-239,-19.376
2215,887,3935,1320,2615,-329.639
2216,10495,74,356,-282,69.308
2217,8482,4638,5961,-1323,-1869.939
2218,2159,700,1785,-1085,-305.87
2219,4964,632,235,397,-430.912
2220,9999,316,85,231,-1668.319
2221,5014,9162,38569,-29407,-8272.995
2222,1127,978,99,879,1473.308
2223,8530,852,2356,-1504,-1455.083
2224,2760,54,34,20,-119.385
2225,2907,356,302,54,1194.929
2226,10726,3871,1590,2281,228.408
2227,9533,5692,6395,-703,-1145.483
2228,12576,20620,13294,7326,-3393.146
2229,5278,2702,2875,-173,-2669.283
2230,2126,894,148,746,1621.233
2231,12014,27,24,3,11.816
2232,2578,13387,6725,6662,1310.856
2233,8555,3084,7969,-4885,-2829.695
2234,2201,250,296,-46,214.066
2235,2447,1175,1976,-801,476.331
2236,9896,987,479,508,-75.782
2237,7054,31,31,0,-3.023
2238,566,656,352,304,-522.847
2239,14707,10361,19776,-9415,-14634.691
2240,7521,116,65,51,19.93
2241,5754,639,510,129,153.533
2242,12226,267,285,-18,392.018
2243,8363,2334,2255,79,-254.143
2244,10510,30,20,10,-11.54
2245,15014,5920,5982,-62,2275.678
2246,8450,2118,1185,933,160.861
2247,5362,725,2547,-1822,-1020.35
2248,4663,5653,5521,132,301.873
2249,8916,11835,10153,1682,3216.78
2250,4241,44,30,14,76.035
2251,879,767,1051,-284,-1574.126
2252,518,514,631,-117,200.661
2253,8879,6119,442,5677,1597.933
2254,10447,522,687,-165,382.405
2255,3688,1332,180,1152,4.671
2256,2530,5294,2785,2509,-165.534
2257,3961,67,1125,-1058,-3063.017
2258,12559,11366,34682,-23316,-4461.381
2259,6142,3935,3850,85,1843.392
2260,9944,22,2585,-2563,-3744.858
2261,4729,476,8135,-7659,1112.871
2262,3550,12,14,-2,19.579
2263,13929,866,126,740,1609.7
2264,11044,5051,548,4503,-1694.133
2265,9505,10816,7665,3151,-206.503
2266,878,5157,4286,871,-1299.623
2267,5033,8914,5123,3791,1720.441
2268,9322,4146,3352,794,-155.69
2269,14743,2059,2077,-18,4362.261
2270,2972,785,396,389,354.784
2271,7128,23,15,8,-77.922
2272,1603,399,804,-405,-650.164
2273,3689,273,110,163,112.419
2274,4906,3140,14829,-11689,-6315.116
2275,6409,5821,13630,-7809,-4741.172
2276,2837,298,3593,-3295,-2238.908
2277,4231,18,120,-102,10.853
2278,6358,160,351,-191,-95.935
2279,5004,7367,3175,4192,848.169
2280,6273,86,77,9,-1893.245
2281,5743,112,370,-258,49.244
2282,555,1432,2793,-1361,-1694.646
2283,3470,3130,1712,1418,390.802
2284,2218,6401,8861,-2460,-4057.763
2285,4937,102,112,-10,-3241.255
2286,8485,6501,5947,554,-2003.153
2287,5346,270,986,-716,-3419.554
2288,8520,1216,1259,-43,257.039
2289,5576,464,440,24,214.821
2290,5383,371,70,301,277.197
2291,5739,100,90,10,23.228
2292,11524,35333,12621,22712,-1062.402
2293,9387,5302,8804,-3502,-1277.836
2294,11041,182,3987,-3805,-839.401
2295,653,8444,6940,1504,-2139.136
2296,8843,222,9013,-8791,-412.623
2297,11532,605,88,517,712.911
2298,14015,1490,5785,-4295,-1446.93
2299,4625,511,1288,-777,567.523
2300,12113,35,86,-51,2.381
2301,4891,76,735,-659,-887.343
2302,5266,2583,4609,-2026,126.709
2303,5475,619,511,108,-5151.693
2304,9403,2361,2622,-261,-97.003
2305,8924,3674,1613,2061,139.563
2306,637,6970,4634,2336,871.359
2307,8339,3279,1056,2223,-1023.651
2308,12781,878,740,138,96.107
2309,11185,2058,8756,-6698,-6572.534
2310,10119,4670,3523,1147,90.645
2311,13038,1558,1249,309,278.333
2312,11543,178,3181,-3003,-5499.952
2313,3213,1009,1337,-328,228.378
2314,4049,95,777,-682,-257.457
2315,14464,222,916,-694,-184.456
2316,3764,56,47,9,342.617
2317,6187,2361,6399,-4038,-1902.321
2318,10645,49,28,21,20.629
2319,10740,218,648,-430,769.978
2320,9043,266,879,-613,1101.672
2321,529,407,1381,-974,-329.934
2322,953,678,934,-256,512.395
2323,4773,349,154,195,45.066
2324,12310,129,217,-88,-48.577
2325,14432,91,487,-396,-203.604
2326,10616,190,53,137,28.681
2327,779,2750,4444,-1694,402.483
2328,11850,19493,25055,-5562,-2695.2
2329,6439,3205,5507,-2302,-771.302
2330,8169,199,66,133,218.21
2331,3404,1649,678,971,-1.501
2332,12395,48,28,20,2.611
2333,6625,958,198,760,640.145
2334,6166,4425,8018,-3593,1342.71
2335,9251,8246,7411,835,-1592.863
2336,8423,146,152,-6,-236.201
2337,12815,741,802,-61,39.914
2338,4053,49,403,-354,-201.317
2339,2297,1002,2456,-1454,-1930.949
2340,13391,2771,9570,-6799,-5368.402
2341,3963,323,1543,-1220,-127.958
2342,13118,130,81,49,135.77
2343,5107,3052,189,2863,1065.905
2344,14835,120,589,-469,11.899
2345,7954,176,93,83,-782.37
2346,4355,33,51,-18,14.663
2347,11040,2079,6661,-4582,44.786
2348,3574,133,262,-129,-1.898
2349,9039,256,128,128,-12.645
2350,5699,159,70,89,225.578
2351,1983,1455,213,1242,1942.494
2352,5682,44,217,-173,502.159
2353,12245,318,2920,-2602,312.563
2354,6272,4816,3926,890,-540.089
2355,4942,207,133,74,1252.655
2356,2790,26,178,-152,-31.16
2357,2696,205,44,161,5.982
2358,2285,4440,8953,-4513,-744.203
2359,1321,18088,31624,-13536,-253.565
2360,7922,932,586,346,495.384
2361,11832,14753,15701,-948,-2648.519
2362,5804,226,1154,-928,7880.316
2363,5697,180,75,105,698.579
2364,7802,1098,889,209,-533.761
2365,6937,59,325,-266,9.256
2366,11498,324,86,238,-598.704
2367,14863,367,89,278,302.213
2368,10764,7493,797,6696,402.523
2369,5916,2240,266,1974,264.598
2370,10502,101,138,-37,-109.276
2371,8821,274,307,-33,27.272
2372,11112,13271,10446,2825,-402.776
2373,4634,257,2103,-1846,-1673.241
2374,6663,10416,16000,-5584,-4277.939
2375,1069,913,1760,-847,209.19
2376,181,1990,3506,-1516,-1143.73
2377,9478,1223,2395,-1172,-95.46
2378,5634,982,147,835,391.149
2379,8471,5813,7879,-2066,-1382.151
2380,13530,10393,7133,3260,1135.633
2381,11077,8950,10982,-2032,-1587.544
2382,672,5932,9184,-3252,-4468.981
2383,3593,28,18,10,-3.066
2384,8869,192,11440,-11248,-6226.453
2385,10952,3018,4560,-1542,45.255
2386,13523,11850,582,11268,3186.228
2387,5338,1235,2155,-920,-1907.51
2388,6520,13928,10308,3620,1394.368
2389,5856,437,1275,-838,1037.696
2390,13283,29595,18594,11001,1387.936
2391,7575,30,86,-56,-1.524
2392,7234,52,16,36,264.21
2393,9080,2022,2527,-505,413.868
2394,8860,9752,9877,-125,492.468
2395,11649,55,22,33,8.566
2396,2042,1817,3200,-1383,-1862.353
2397,12353,194,78,116,7.705
2398,10733,15844,3008,12836,4187.004
2399,13717,2023,452,1571,1466.505
2400,5109,579,231,348,575.83
2401,11504,8267,32893,-24626,-20930.636
2402,2853,3361,3013,348,1513.523
2403,11542,50188,51202,-1014,-1387.402
2404,6261,1227,159,1068,148.392
2405,4985,1269,1800,-531,1402.371
2406,1131,24805,27941,-3136,236.667
2407,2622,520,88,432,-207.072
2408,1139,12254,5964,6290,-410.139
2409,7995,2142,1855,287,-31.506
2410,2055,1430,458,972,3096.263
2411,3551,46,30,16,15.221
2412,12579,21205,34195,-12990,-9657.402
2413,5312,207,383,-176,-2627.379
2414,14069,39,12770,-12731,-10027.797
2415,7827,773,633,140,607.407
2416,3720,233,119,114,93.045
2417,10256,100,91,9,126.138
2418,13229,3780,15037,-11257,8253.968
2419,9550,11532,10944,588,1054.543
2420,13181,199,105,94,110.614
2421,3733,123,168,-45,128.421
2422,13335,16561,4551,12010,3933.103
2423,12710,924,1719,-795,-1223.562
2424,340,4901,8010,-3109,-1106.723
2425,13472,4474,35543,-31069,-8923.383
2426,850,1798,833,965,3350.002
2427,343,6028,4300,1728,-1339.423
2428,3497,2368,3714,-1346,354.394
2429,11262,614,942,-328,59.077
2430,8963,614,107,507,-388.893
2431,12843,898,4799,-3901,1221.781
2432,5083,7624,5754,1870,-3951.909
2433,14836,97,32,65,60.929
2434,8967,7773,4344,3429,375.321
2435,9480,1521,393,1128,-140.979
2436,1356,10824,12715,-1891,2790.523
2437,13345,5297,9936,-4639,-6010.178
2438,14130,4199,9181,-4982,2752.314
2439,10605,73,69,4,-18.862
2440,1050,2879,3148,-269,-1431.272
2441,4731,306,258,48,-978.112
2442,12020,15,44,-29,2.938
2443,9179,2257,4431,-2174,-788.537
2444,13798,8567,5985,2582,5328.299
2445,1040,2667,3557,-890,-947.503
2446,14380,387,2670,-2283,-271.168
2447,1189,12514,28754,-16240,-1586.832
2448,9630,27,1573,-1546,-783.045
2449,10688,145,101,44,20.31
2450,13918,9049,14768,-5719,-8912.17
2451,10436,96,230,-134,-187.275
2452,8170,251,169,82,170.385
2453,11573,189,174,15,-580.556
2454,2171,618,102,516,-42.733
2455,3869,258,374,-116,-191.243
2456,5086,2056,29259,-27203,-9402.418
2457,534,1357,2850,-1493,-2892.523
2458,8583,3143,3995,-852,192.348
2459,11887,10526,13992,-3466,-7930.478
2460,3995,2578,3016,-438,899.897
2461,13903,13448,17001,-3553,-1468.283
2462,7824,5946,5403,543,-914.173
2463,9388,2848,1706,1142,419.861
2464,5252,3835,272,3563,2427.735
2465,4102,112,83,29,3.772
2466,7605,23,28,-5,8.706
2467,11858,1459,3136,-1677,-9456.125
2468,6944,222,81,141,-7.727
2469,2869,211,3992,-3781,-2740.217
2470,10376,52,49,3,79.239
2471,9836,157,44,113,-74.848
2472,9492,6855,1256,5599,1460.529
2473,12517,6743,24604,-17861,-6027.523
2474,7733,1271,2004,-733,-640.299
2475,13677,130,106,24,-0.021
2476,3592,211,270,-59,-77.811
2477,10963,2607,5291,-2684,520.225
2478,6244,15223,6729,8494,470.619
2479,11545,19706,22721,-3015,-6553.652
2480,14054,15089,5904,9185,818.403
2481,11568,19085,45646,-26561,-21876.359
2482,13230,10028,3306,6722,311.225
2483,13243,265,30870,-30605,-11611.702
2484,2072,3879,7736,-3857,-2987.343
2485,9682,3187,1737,1450,-826.018
2486,4218,153,134,19,-28.312
2487,14041,3368,5692,-2324,-1611.167
2488,3405,1628,2028,-400,184.181
2489,9624,7862,7838,24,591.289
2490,640,5781,1864,3917,1217.02
2491,10804,120,8798,-8678,-2156.702
2492,11156,2300,2143,157,-873.703
2493,2954,2331,3352,-1021,-845.475
2494,8006,196,109,87,-174.009
2495,8809,1701,1786,-85,1317.631
2496,5360,3873,6132,-2259,-2504.008
2497,3987,1846,1926,-80,1039.492
2498,3121,19,15,4,3.234
2499,9182,2346,3035,-689,1368.13
2500,7949,2226,1118,1108,559.829
2501,504,254,200,54,164.859
2502,10755,14265,1172,13093,2479.977
2503,2575,3930,525,3405,1265.019
2504,10835,113,193,-80,1735.065
2505,2178,1313,481,832,316.083
2506,5995,60,72,-12,21.272
2507,14448,3542,710,2832,-552.84
2508,9700,63,57,6,-9.253
2509,6919,176,543,-367,12.359
2510,14321,2363,4756,-2393,-1454.92
2511,14363,373,1832,-1459,-1445.81
2512,9576,9844,6198,3646,128.512
2513,13224,28412,22866,5546,387.295
2514,320,10383,9064,1319,524.85
2515,1381,3163,1465,1698,3375.834
2516,11064,3807,1067,2740,143.473
2517,7988,57,416,-359,349.757
