,index,forward,backward,delta,pred
0,5629,45,45,0,32.251
1,10592,153,115,38,19.712
2,4762,73,105,-32,50.927
3,10821,17,17,0,-274.436
4,970,3553,2035,1518,6400.794
5,7116,18,10,8,-13.52
6,4549,206,2550,-2344,-2207.164
7,13021,947,445,502,113.078
8,15130,49,38,11,112.082
9,6719,15,23,-8,10.254
10,14068,1927,679,1248,1374.116
11,13127,26,120,-94,-194.048
12,6452,4006,12785,-8779,-6551.534
13,3587,26,39,-13,-1.801
14,2322,181,339,-158,3.919
15,12978,175,42,133,170.896
16,4494,50,37,13,26.199
17,10879,163,664,-501,494.08
18,11918,136,70,66,-26.887
19,1297,34,124,-90,46.274
20,9936,7410,1452,5958,1695.365
21,8467,10208,9055,1153,-417.732
22,8373,3054,4043,-989,-1014.663
23,2320,11,29,-18,-10.676
24,15191,62,110,-48,79.461
25,1171,13809,16054,-2245,348.187
26,14290,0,0,0,-3731.802
27,4235,20,30,-10,5.24
28,9676,1252,2984,-1732,-2869.109
29,7412,19,35,-16,-0.255
30,5751,121,73,48,-2.633
31,13723,28708,9924,18784,4507.736
32,605,129,1622,-1493,-3639.213
33,459,7380,6661,719,3002.587
34,14575,44,44,0,35.285
35,10838,180,219,-39,340.468
36,3573,17,23,-6,3.395
37,12102,6,21,-15,-58.606
38,809,5113,6469,-1356,486.84
39,11143,1624,1101,523,-1690.871
40,6551,31,4131,-4100,-3907.776
41,9869,81,583,-502,19.727
42,14647,21,21,0,8.743
43,1476,5012,21565,-16553,-4155.175
44,11363,27,27,0,9.477
45,9270,7056,6031,1025,6793.154
46,14956,15,15,0,13.053
47,12328,22,32,-10,-51.824
48,7457,12,12,0,2.055
49,4879,1,11,-10,-386.612
50,1254,44,31,13,43.08
51,12675,742,623,119,-462.395
52,14528,10,2559,-2549,-1867.071
53,9309,4000,5227,-1227,-313.83
54,9125,2421,4255,-1834,-807.249
55,1430,18080,18222,-142,802.459
56,7989,784,615,169,45.638
57,3106,15,15,0,-0.051
58,13634,55,55,0,1.896
59,15076,0,0,0,-184.871
60,4819,4,538,-534,-1195.738
61,11183,2261,4395,-2134,-1377.72
62,6323,21,207,-186,-12.678
63,12806,4903,2782,2121,-825.844
64,10178,861,1311,-450,282.478
65,2009,20,20,0,-1270.172
66,10741,3039,8084,-5045,826.839
67,14576,8560,5076,3484,-474.037
68,575,231,3814,-3583,-5620.563
69,6171,700,3828,-3128,-42.277
70,12116,3,3,0,14.079
71,8369,521,247,274,274.578
72,1388,701,312,389,1469.266
73,11625,38,38,0,19.121
74,2844,4250,2157,2093,410.922
75,6717,9,9,0,0.257
76,9971,156,787,-631,-20.94
77,13811,0,0,0,-3893.008
78,3086,20,35,-15,-2.6
79,6791,9,23,-14,-2.88
80,398,188,60,128,-6515.609
81,14536,1013,619,394,345.521
82,1118,9579,13031,-3452,-444.432
83,7778,87,86,1,700.759
84,5990,30,37,-7,93.515
85,3069,10,21,-11,-14.472
86,1398,2633,2131,502,-10.482
87,13905,35720,22162,13558,-2991.692
88,7409,11,17,-6,15.259
89,12227,1065,245,820,128.009
90,138,215,4872,-4657,-2692.402
91,3184,16,16,0,13.588
92,6081,373,145,228,32.624
93,12604,32,55,-23,48.816
94,8046,299,1147,-848,-27.236
95,263,44,3830,-3786,287.085
96,9543,11912,11183,729,-31.583
97,10622,11,43,-32,-18.279
98,8524,3425,4169,-744,-871.365
99,11987,3,4,-1,-8.309
100,14646,44,44,0,48.391
101,6102,488,2679,-2191,-1684.255
102,6916,47,102,-55,5.364
103,5900,1,1,0,-60.029
104,1222,6,13,-7,62.875
105,13840,71201,81723,-10522,-6604.712
106,9526,32,32,0,-155.555
107,15549,104,204,-100,-235.403
108,3398,58,58,0,-47.47
109,4101,80,87,-7,2.232
110,397,11795,18169,-6374,-5889.445
111,3252,444,142,302,27.431
112,14300,2771,3700,-929,-540.38
113,5532,84,143,-59,332.057
114,6574,16297,5585,10712,1275.732
115,10584,52,64,-12,28.274
116,2132,1337,1020,317,-166.432
117,6763,18,18,0,-1.215
118,8704,195,2855,-2660,-1503.932
119,3391,59,139,-80,63.261
120,6531,20413,12696,7717,2815.634
121,3705,90,38,52,-8.503
122,8465,9313,3673,5640,-46.746
123,1314,2972,8338,-5366,-5633.187
124,13356,614,152,462,-611.614
125,5936,1206,200,1006,-124.188
126,11335,18,70,-52,-57.987
127,1163,157,14802,-14645,-3260.959
128,11641,165,59,106,113.401
129,10595,102,90,12,-106.777
130,1934,175,175,0,601.853
131,11019,6889,6875,14,16.554
132,15389,119,192,-73,-104.51
133,7449,14,14,0,-0.012
134,8755,57,168,-111,1164.898
135,6153,5101,936,4165,-2910.944
136,10713,16933,391,16542,8405.431
137,9396,7965,10165,-2200,-712.425
138,52,18,22,-4,-19.473
139,11779,13,18,-5,-0.425
140,8540,4631,1912,2719,-282.942
141,5760,243,109,134,11.198
142,3842,56,189,-133,-17.389
143,11033,23429,18893,4536,464.362
144,4720,65,351,-286,-1273.631
145,13984,15331,12483,2848,-2932.987
146,11351,10,40,-30,-13.352
147,2705,23,23,0,1.663
148,4954,36,188,-152,1165.338
149,3952,149,253,-104,-61.131
150,12263,138,1053,-915,55.931
151,13334,927,229,698,-62.048
152,2941,6594,5648,946,1217.889
153,5607,55,64,-9,64.917
154,5441,1515,12133,-10618,-3531.076
155,796,8194,18913,-10719,-7796.262
156,10901,7,7,0,-1009.252
157,8946,883,838,45,-1545.776
158,2592,260,62,198,171.203
159,5527,176,141,35,-559.94
160,2707,18,18,0,9.335
161,5029,29674,42200,-12526,-4135.802
162,2732,8,40,-32,-23.918
163,12802,4281,9267,-4986,-3081.174
164,2075,8412,11553,-3141,635.911
165,14137,9574,6422,3152,6533.661
166,10257,423,1081,-658,-2.709
167,12207,234,138,96,118.907
168,7000,118,39,79,1.289
169,9137,3466,5154,-1688,-173.069
170,13856,81013,81663,-650,-11110.938
171,1728,72,104,-32,184.533
172,11668,830,109,721,-23.047
173,15489,532,706,-174,-137.304
174,4111,0,0,0,-22.517
175,3185,24,21,3,13.041
176,4437,3,6,-3,-2.491
177,12260,131,117,14,-202.488
178,13424,108,17338,-17230,-11388.918
179,4634,3780,1313,2467,-3647.444
180,2043,1718,272,1446,1201.218
181,10179,273,3029,-2756,-738.343
182,3435,2147,1389,758,-737.857
183,3007,184,23,161,-8.901
184,4654,530,272,258,-159.335
185,8082,48,1,47,91.629
186,13487,2174,15618,-13444,-14780.897
187,2145,1341,1614,-273,251.585
188,5720,124,208,-84,40.604
189,8721,2862,3225,-363,231.956
190,10509,305,208,97,1.383
191,6086,77,256,-179,-138.201
192,3207,27,19,8,-7.982
193,14073,14528,6024,8504,518.783
194,4878,2685,1303,1382,-456.425
195,12400,7,7,0,1.705
196,14583,4734,4642,92,-349.992
197,5097,1192,197,995,-1954.968
198,5646,252,90,162,684.598
199,14344,465,709,-244,5.315
200,8445,38,40,-2,-4.685
201,8475,1027,1191,-164,89.2
202,12824,4889,6553,-1664,-412.674
203,8705,3207,5300,-2093,-1428.606
204,6815,20,20,0,1.233
205,4514,932,3634,-2702,466.353
206,11559,908,1500,-592,-947.259
207,11859,1747,11906,-10159,-9375.612
208,4594,79,780,-701,-1930.527
209,15430,347,287,60,60.494
210,9221,27777,19485,8292,9753.648
211,8994,6470,17756,-11286,-6528.685
212,2295,2005,4600,-2595,-1249.364
213,10399,16,6,10,-16.741
214,2116,62,62,0,-18.043
215,5328,3725,6347,-2622,527.812
216,14248,18138,3476,14662,-4016.344
217,3565,9,8,1,-0.026
218,11950,15,15,0,-0.02
219,14064,479,6253,-5774,-457.786
220,1414,2262,336,1926,1331.063
221,5521,2567,91,2476,114.023
222,15524,369,134,235,-28.934
223,1921,440,196,244,-335.517
224,7246,47,64,-17,35.755
225,196,2141,2383,-242,-1121.608
226,3456,1525,2082,-557,139.823
227,7128,18,32,-14,15.499
228,7205,24,34,-10,-21.582
229,5711,7,9,-2,-8.847
230,13183,32,32,0,9.192
231,175,5589,2047,3542,329.022
232,15080,28,2906,-2878,-4821.692
233,3794,343,277,66,102.457
234,7385,18,237,-219,-87.776
235,6628,123,7277,-7154,-3292.249
236,4793,37,37,0,3.024
237,8560,16,17,-1,38.465
238,4369,20,20,0,5.68
239,13658,21,21,0,27.824
240,14079,196,2148,-1952,89.23
241,3839,222,13600,-13378,-1980.312
242,3436,301,1576,-1275,-825.528
243,4033,69,59,10,-72.506
244,12537,15020,19170,-4150,2918.039
245,11334,51,238,-187,166.014
246,15154,33,91,-58,-0.5
247,14739,1588,2912,-1324,5174.489
248,11121,8782,8315,467,-2025.551
249,14179,4144,17109,-12965,-4077.51
250,5306,75,3924,-3849,-1204.078
251,1126,18787,3601,15186,-38.793
252,1480,16624,33537,-16913,-3332.976
253,10404,3262,1186,2076,217.636
254,10235,250,925,-675,926.289
255,14569,567,1058,-491,-3929.212
256,8858,2347,4794,-2447,-234.724
257,13098,1737,2810,-1073,1404.662
258,6035,16,164,-148,-92.722
259,1513,15652,6907,8745,-6697.855
260,15335,30,30,0,13.589
261,4092,578,1069,-491,-195.07
262,3490,305,144,161,-20.7
263,6180,401,1994,-1593,-914.088
264,13835,17683,20320,-2637,-3002.768
265,13068,414,3007,-2593,147.317
266,15084,5950,11445,-5495,-411.165
267,1216,23,23,0,18.679
268,13676,59,116,-57,-49.956
269,6107,828,708,120,-703.795
270,5028,108,8372,-8264,2941.667
271,3248,28,36,-8,26.407
272,3190,4,5,-1,-9.527
273,8320,8674,4319,4355,426.875
274,6691,15162,22447,-7285,-2130.497
275,1249,113,133,-20,10.139
276,1520,297,5823,-5526,157.908
277,8807,862,400,462,785.525
278,9203,8812,8909,-97,3898.544
279,11839,11878,4424,7454,-1811.914
280,15092,0,0,0,-60.15
281,9186,205,1561,-1356,1740.548
282,10722,3177,189,2988,530.357
283,8885,180,299,-119,-1403.979
284,521,1079,218,861,-310.96
285,1447,2187,5278,-3091,-2754.0
286,9209,7146,6167,979,2828.01
287,2305,446,331,115,11.617
288,6244,2454,637,1817,-1371.223
289,14349,2721,3042,-321,3.605
290,11556,43440,33940,9500,1221.726
291,1309,33422,19623,13799,1926.558
292,15210,32,32,0,14.437
293,3639,6,7,-1,40.69
294,2121,543,654,-111,167.284
295,7569,8,7,1,-1.017
296,7430,7,8,-1,0.173
297,10720,1853,9123,-7270,394.016
298,7532,41,46,-5,0.009
299,1206,199,76,123,172.147
300,4296,26,26,0,10.656
301,4760,474,1295,-821,-830.293
302,12726,711,1641,-930,316.198
303,12869,1294,552,742,-1819.553
304,3148,21,24,-3,14.616
305,9078,411,99,312,390.302
306,9198,3579,4894,-1315,-267.225
307,9054,267,662,-395,23.957
308,12356,7,12,-5,-2.71
309,10984,1594,1216,378,208.294
310,11113,51,9606,-9555,-2226.303
311,4976,5578,10037,-4459,-758.246
312,6992,348,191,157,-87.908
313,7320,26,27,-1,0.226
314,10548,356,258,98,9.581
315,7458,14,14,0,0.163
316,13757,418,6466,-6048,1669.685
317,457,14235,7041,7194,3749.213
318,13716,543,8318,-7775,5157.486
319,7050,56,26,30,-0.584
320,11194,139,140,-1,-1095.674
321,11144,1814,3239,-1425,3729.601
322,8887,55,474,-419,1784.626
323,11394,40,53,-13,0.834
324,1255,133,192,-59,280.66
325,2503,748,1561,-813,396.78
326,9628,0,0,0,-3.481
327,1322,345,4314,-3969,750.021
328,14052,272,272,0,1780.666
329,9802,160,128,32,114.835
330,8337,920,3284,-2364,-1886.952
331,5107,49,55,-6,-1655.338
332,8604,30,44,-14,-12.81
333,4813,151,1739,-1588,-1169.303
334,4486,2,13,-11,-7.153
335,6562,1056,1002,54,-2121.948
336,7126,16,25,-9,4.684
337,3023,107,23,84,-1.165
338,9548,64,1977,-1913,-238.499
339,8423,1508,402,1106,-917.536
340,1561,6542,4620,1922,578.212
341,531,193,153,40,37.835
342,5326,10145,10909,-764,-4484.492
343,598,39,1183,-1144,-1596.366
344,8166,12,43,-31,54.457
345,5274,6771,6321,450,-1715.297
346,9235,6857,8833,-1976,-7655.968
347,6360,207,39,168,25.053
348,8587,736,869,-133,-357.092
349,14724,13881,21959,-8078,-15679.383
350,4851,2411,3794,-1383,26.855
351,10954,1030,219,811,292.779
352,3840,1879,13990,-12111,-2248.983
353,3449,2790,2287,503,-608.691
354,2208,6022,4093,1929,-2327.79
355,1515,1346,2190,-844,-332.947
356,4395,1,1,0,1.67
357,978,254,81,173,-195.893
358,2109,1286,108,1178,-213.324
359,12358,15,25,-10,-3.46
360,7014,23,22,1,7.345
361,7140,3,35,-32,-19.575
362,5099,685,7075,-6390,-4160.51
363,4029,22,31,-9,21.453
364,4036,15,15,0,3.052
365,8063,899,906,-7,414.704
366,2651,799,343,456,-210.897
367,9659,240,3096,-2856,-3541.96
368,766,19910,10788,9122,-4858.112
369,6468,26360,18086,8274,1014.78
370,9431,5,1511,-1506,-2388.531
371,10087,3074,7820,-4746,-8119.318
372,8328,1,399,-398,-1153.264
373,27,57,57,0,46.262
374,14006,7011,2077,4934,322.27
375,10814,19,43,-24,683.906
376,2069,1497,14564,-13067,-4674.686
377,6443,9778,10392,-614,-872.974
378,7966,153,570,-417,192.235
379,6164,5030,6359,-1329,-968.235
380,4553,14402,15688,-1286,200.185
381,9276,7226,7817,-591,3031.206
382,5972,449,204,245,-28.975
383,5207,4355,1891,2464,-590.687
384,11652,3,32,-29,-41.746
385,3388,40,40,0,-1.746
386,11027,584,12228,-11644,-2106.104
387,5506,93,68,25,520.642
388,3304,106,40,66,-15.023
389,11569,1208,276,932,523.77
390,10091,75,99,-24,-68.429
391,13849,14032,16150,-2118,-1228.567
392,5123,28,203,-175,194.852
393,13566,7589,3978,3611,911.68
394,7853,2354,2333,21,-518.958
395,6503,1129,1216,-87,-5510.575
396,3212,40,57,-17,-13.476
397,3833,117,326,-209,1145.42
398,14790,27722,42333,-14611,-7051.396
399,6680,28,3332,-3304,-3369.346
400,1875,99,3883,-3784,1038.788
401,14743,32341,34018,-1677,613.139
402,7982,77,461,-384,92.75
403,8208,284,207,77,277.109
404,9915,134,356,-222,-363.364
405,7777,43,607,-564,-337.787
406,5389,614,3819,-3205,-2737.353
407,14428,2190,1191,999,23.563
408,8739,2008,2494,-486,428.009
409,1168,60,78,-18,-311.097
410,10425,2096,814,1282,109.945
411,3258,175,172,3,105.608
412,8669,48,134,-86,-222.745
413,3177,10,10,0,-0.219
414,3437,122,935,-813,7.786
415,2703,34,34,0,-116.408
416,13220,16247,20495,-4248,-5876.396
417,12173,111,56,55,7.202
418,10651,0,0,0,-138.272
419,380,1733,4594,-2861,-5733.688
420,8362,26,63,-37,20.559
421,7416,10,10,0,-0.094
422,13701,13865,34521,-20656,-2272.662
423,2724,55,92,-37,-13.132
424,13881,1658,23300,-21642,-22195.904
425,13565,2797,5108,-2311,-4901.189
426,2949,1831,463,1368,-507.304
427,9893,172,138,34,-57.648
428,11863,14555,10849,3706,997.809
429,4381,6,6,0,0.73
430,1253,59,59,0,72.991
431,14029,549,1159,-610,-20824.11
432,12429,9,11,-2,13.084
433,4946,1955,363,1592,5218.463
434,7918,75,60,15,134.786
435,717,2525,5269,-2744,-3244.236
436,1170,3496,6321,-2825,3780.984
437,4343,11,11,0,-0.619
438,6224,882,987,-105,-256.92
439,3043,24,26,-2,11.568
440,11807,813,8163,-7350,-8977.301
441,14487,887,164,723,568.12
442,1588,2815,1217,1598,417.173
443,11008,1917,1551,366,-2092.171
444,12651,72,72,0,101.617
445,6676,19094,20809,-1715,-4098.255
446,3950,333,77,256,230.565
447,9150,5596,6642,-1046,-1340.144
448,14367,3574,2021,1553,231.04
449,12060,19,28,-9,12.426
450,8307,3537,4412,-875,-121.19
451,1770,61,118,-57,107.611
452,7313,23,198,-175,-32.994
453,12852,1140,1274,-134,-1448.505
454,15391,123,123,0,-659.488
455,6073,2,41,-39,-31.263
456,2165,102,166,-64,369.907
457,14667,36,36,0,60.08
458,7426,9,79,-70,-19.9
459,14704,12731,2446,10285,-2466.094
460,6271,1271,4052,-2781,-980.573
461,5246,602,449,153,217.344
462,2352,16,578,-562,-421.997
463,6926,29,100,-71,0.857
464,4056,33,52,-19,-151.34
465,2062,16106,21246,-5140,250.993
466,11376,74,82,-8,-123.642
467,5421,1945,9570,-7625,-1661.836
468,5928,158,91,67,154.473
469,14035,434,2280,-1846,-5612.198
470,14769,74646,15235,59411,15505.581
471,14786,823,4508,-3685,-150.179
472,1098,2655,3335,-680,-335.126
473,11338,24,44,-20,-7.774
474,9267,4921,12982,-8061,-15918.133
475,14294,63900,36622,27278,9843.968
476,10455,89,115,-26,177.13
477,2995,319,377,-58,-634.956
478,3189,10,10,0,0.365
479,14275,5981,6774,-793,-4549.937
480,15158,27,34,-7,-5.797
481,5758,43,22,21,-148.091
482,12094,7,7,0,0.5
483,11222,9273,2157,7116,792.263
484,8261,76,76,0,104.958
485,4380,18,18,0,0.936
486,14470,17,1573,-1556,-1889.638
487,13923,9927,19653,-9726,1748.286
488,13827,24474,42868,-18394,-13911.828
489,10465,691,165,526,821.064
490,15182,48,60,-12,277.369
491,13503,16013,40831,-24818,1754.846
492,15293,34,34,0,33.811
493,4069,329,1116,-787,-269.793
494,9182,877,1415,-538,-830.202
495,2223,2790,2622,168,-5317.579
496,12710,424,971,-547,12.09
497,1483,3979,5212,-1233,-2469.49
498,12436,3,3,0,-0.816
499,13204,26341,11421,14920,-203.391
500,276,210,178,32,238.802
501,14431,770,285,485,276.048
502,4161,4,5,-1,-3.813
503,3326,28,67,-39,20.743
504,11102,1160,4333,-3173,-1162.661
505,1905,27,64,-37,68.066
506,874,625,4657,-4032,-136.87
507,13704,29226,11148,18078,3207.236
508,7117,9,13,-4,-2.211
509,14694,67,156,-89,113.599
510,5657,43,43,0,27.707
511,11277,6056,1127,4929,1173.444
512,14467,16,47,-31,-185.714
513,1740,245,268,-23,84.307
514,4351,17,22,-5,2.475
515,13508,123,218,-95,893.326
516,8397,21,21,0,183.604
517,12022,18,19,-1,0.51
518,10251,880,1226,-346,43.673
519,14507,877,552,325,88.576
520,13519,20201,12943,7258,984.894
521,9274,13781,10912,2869,8844.193
522,2331,203,277,-74,-3.719
523,3308,34,67,-33,27.596
524,5806,6407,9386,-2979,-5965.38
525,6949,133,136,-3,-42.421
526,4873,4597,2372,2225,794.29
527,2582,248,1567,-1319,2704.806
528,5512,26,26,0,44.653
529,134,103,251,-148,-246.414
530,10916,108,152,-44,-612.422
531,14978,12,12,0,-3.254
532,10644,43,20,23,35.837
533,2922,17,227,-210,1293.054
534,5288,5826,6179,-353,-710.148
535,14824,65,82,-17,60.108
536,15223,24,24,0,12.95
537,13139,37,37,0,21.34
538,10898,61,2331,-2270,2125.878
539,7342,12,12,0,-0.511
540,8687,47,47,0,86.499
541,1362,11746,2056,9690,1261.313
542,2139,73,162,-89,144.199
543,11665,28,28,0,7.262
544,12635,60,1402,-1342,-836.043
545,14554,8158,5063,3095,-164.809
546,3405,73,832,-759,-102.058
547,3664,733,256,477,45.736
548,3660,18,18,0,77.684
549,1050,9,9,0,-1298.519
550,4231,82,31,51,-76.748
551,5061,5995,8848,-2853,944.251
552,15376,637,135,502,355.706
553,1457,23929,20571,3358,622.729
554,6830,2,2,0,2.256
555,12540,84,10284,-10200,-5098.807
556,12733,84,146,-62,187.452
557,4284,133,168,-35,24.433
558,2429,863,463,400,225.599
559,13853,54,892,-838,-15278.875
560,7196,149,122,27,-18.073
561,5767,404,281,123,24.355
562,11044,51,2058,-2007,-3452.951
563,2613,72,753,-681,27.118
564,15105,40,66,-26,-39.822
565,12961,15,19,-4,5.697
566,6612,19772,17359,2413,-2787.412
567,6032,13,12,1,-0.026
568,7987,2310,3835,-1525,483.102
569,7213,28,35,-7,-4.566
570,4589,3319,9746,-6427,-2449.714
571,11257,64,101,-37,151.972
572,6438,3681,8375,-4694,-2187.128
573,14880,31,35,-4,2.177
574,6656,0,0,0,-106.448
575,14590,3692,6128,-2436,4.357
576,10605,12,13,-1,-1.11
577,4600,4650,4975,-325,913.216
578,9821,58,300,-242,-300.191
579,3937,1044,4281,-3237,-510.495
580,1815,44,70,-26,46.405
581,12614,56,207,-151,-14.582
582,3141,14,12,2,-0.242
583,8830,4184,2198,1986,-225.52
584,12185,20,28,-8,-0.696
585,11518,52709,52873,-164,1594.024
586,14920,18,18,0,3.25
587,13546,2769,1651,1118,4974.948
588,8386,86,739,-653,-1715.931
589,7157,22,22,0,3.518
590,6862,12,12,0,-0.928
591,3879,1434,10759,-9325,-593.476
592,3015,15,15,0,-3.301
593,904,144,1849,-1705,-580.719
594,8303,10632,5369,5263,-184.136
595,13460,1213,28811,-27598,-21554.99
596,9657,45,40,5,41.076
597,11296,549,8249,-7700,-1980.085
598,7939,68,296,-228,307.88
599,4037,122,168,-46,-104.302
600,11812,2389,6647,-4258,-1775.099
601,4854,2076,2679,-603,-11.425
602,10986,56,262,-206,38.23
603,2696,35,35,0,67.203
604,1212,63,1777,-1714,-747.812
605,6401,1026,1159,-133,-4638.087
606,14200,10371,17415,-7044,1557.386
607,13313,17281,15960,1321,4406.683
608,1943,79,80,-1,9.536
609,13560,1883,1779,104,-3336.449
610,11606,297,68,229,10.482
611,14434,895,147,748,296.134
612,4750,54,54,0,106.798
613,8952,14,7666,-7652,-4544.013
614,1358,18,159,-141,352.979
615,8170,53,53,0,98.321
616,14642,9,43,-34,-8.434
617,9863,30,238,-208,127.434
618,611,18,2802,-2784,-3575.599
619,8971,625,1279,-654,1074.044
620,12408,3,6,-3,-1.885
621,10363,27,42,-15,-35.989
622,7526,10,16,-6,1.743
623,4755,1852,4196,-2344,-40.115
624,15334,60,60,0,-9.712
625,5764,61,29,32,22.276
626,15082,6066,14108,-8042,-6960.99
627,3960,229,1611,-1382,-62.568
628,6373,58,61,-3,-40.115
629,14227,373,2128,-1755,-529.002
630,2523,5557,400,5157,531.271
631,8023,153,82,71,-234.972
632,1495,106,106,0,-413.635
633,7740,49,52,-3,22.496
634,3621,44,45,-1,49.671
635,6704,16,18,-2,5.669
636,5575,42,141,-99,23.559
637,7536,5,4,1,1.217
638,9386,0,0,0,-459.416
639,11826,2224,12141,-9917,-3665.871
640,12688,833,246,587,3.013
641,1473,7364,16133,-8769,-170.832
642,7804,73,49,24,-11.327
643,10706,802,1354,-552,3053.52
644,49,57,33,24,-3.155
645,9414,438,776,-338,-522.444
646,12150,16,16,0,14.229
647,10719,94,2482,-2388,1100.627
648,14645,24,26,-2,2.128
649,5851,24162,793,23369,2676.233
650,10844,66,1394,-1328,121.858
651,7252,24,24,0,-1.532
652,14916,23,26,-3,-7.608
653,6040,578,105,473,-16.004
654,4224,81,327,-246,46.266
655,9204,2509,3685,-1176,1472.811
656,5187,775,848,-73,-1235.329
657,8880,17314,6683,10631,-1.616
658,15458,851,534,317,-27.938
659,5344,2724,2300,424,-1465.043
660,4358,124,46,78,-13.348
661,12444,15,15,0,3.021
662,10810,567,109,458,307.018
663,4308,298,92,206,-31.158
664,3544,4,4,0,1.384
665,13217,14810,21729,-6919,-5178.888
666,1372,15927,7987,7940,542.042
667,3580,44,93,-49,19.152
668,3768,174,361,-187,-31.549
669,10249,178,380,-202,148.075
670,5219,836,2314,-1478,541.73
671,1852,129,129,0,642.577
672,99,12,43,-31,-29.923
673,9211,74,2695,-2621,1192.878
674,5407,1191,5509,-4318,-583.959
675,7607,16,19,-3,9.053
676,15106,66,43,23,105.711
677,6525,9799,9370,429,-1185.435
678,11248,9279,3235,6044,482.796
679,1866,798,2304,-1506,-152.447
680,14014,222,7995,-7773,-1307.164
681,3658,147,797,-650,-96.079
682,8133,47,671,-624,-686.108
683,10940,3102,5274,-2172,-418.851
684,2816,2777,6577,-3800,3692.554
685,4058,464,993,-529,-185.171
686,12196,16,16,0,5.648
687,1101,2522,4697,-2175,-6823.039
688,4674,90,841,-751,-1347.023
689,6746,12,15,-3,-1.787
690,2358,118,66,52,16.948
691,15288,21,28,-7,10.087
692,12647,80,335,-255,29.9
693,2779,207,154,53,37.603
694,2999,4133,2241,1892,765.716
695,14301,4762,3285,1477,165.748
696,9275,15542,12085,3457,3381.821
697,1711,54,79,-25,-224.682
698,1387,10874,13926,-3052,1816.604
699,1663,2729,368,2361,28.953
700,11252,250,209,41,2006.32
701,3789,24,99,-75,-118.857
702,10140,114,1086,-972,1969.648
703,6599,9450,13033,-3583,-494.509
704,13059,768,840,-72,120.274
705,1523,1919,190,1729,-1185.967
706,4542,4588,2703,1885,1162.022
707,670,9,1362,-1353,-1397.632
708,10864,14,14,0,-516.227
709,4741,59,13,46,667.937
710,15491,246,511,-265,13.594
711,1751,312,132,180,324.078
712,15089,80,6971,-6891,-1636.278
713,2895,3497,4551,-1054,176.781
714,5533,47,47,0,-0.388
715,12867,1387,1169,218,103.153
716,4402,6,6,0,0.056
717,3423,50,836,-786,-621.98
718,1076,1827,1886,-59,1049.688
719,4286,17,34,-17,-22.886
720,1790,210,147,63,61.657
721,13417,51068,29333,21735,6499.709
722,9667,1842,1469,373,89.549
723,4771,174,155,19,444.847
724,12217,83,1056,-973,92.021
725,10967,226,83,143,-17.337
726,13989,9254,11117,-1863,-1580.669
727,10292,28,36,-8,31.345
728,15438,7,73,-66,-273.949
729,1082,0,0,0,-553.166
730,9864,3,157,-154,-248.796
731,2201,2179,4476,-2297,-1504.131
732,6336,18,18,0,3.283
733,12849,174,3201,-3027,-833.741
734,7023,20,20,0,28.858
735,1797,45,36,9,112.259
736,2344,542,369,173,96.601
737,705,4104,11648,-7544,-3085.169
738,9626,612,538,74,-891.882
739,7990,579,311,268,-491.209
740,680,797,11067,-10270,-6538.367
741,13124,9,11,-2,10.902
742,6913,15,15,0,1.484
743,6104,1503,1368,135,-374.304
744,1657,141,113,28,-158.044
745,814,400,3008,-2608,-4001.497
746,3031,24,24,0,3.535
747,584,2819,7038,-4219,-2358.96
748,13597,374,903,-529,417.306
749,200,1747,591,1156,70.333
750,5684,23,47,-24,61.021
751,3117,420,72,348,103.94
752,532,156,107,49,875.784
753,4826,925,5004,-4079,-1688.456
754,12690,41,173,-132,-132.029
755,5954,89,459,-370,-137.61
756,7031,42,48,-6,-22.901
757,9875,132,1746,-1614,-22.373
758,9784,43,43,0,65.972
759,8893,294,6382,-6088,-1301.469
760,7920,3421,3680,-259,-218.02
761,14696,49,49,0,17.429
762,8384,7029,2960,4069,661.061
763,4487,35,31,4,8.534
764,11477,1117,243,874,-756.954
765,5741,42,30,12,17.793
766,4803,406,2184,-1778,-218.918
767,14126,35681,59416,-23735,-6113.587
768,1000,3430,2019,1411,386.134
769,13397,196,688,-492,-209.514
770,11251,78,416,-338,-404.337
771,9925,416,377,39,109.084
772,9172,73,73,0,484.474
773,13602,23,22,1,-7.366
774,7790,144,145,-1,1238.977
775,12155,27,70,-43,-19.41
776,13974,13027,12337,690,-6129.918
777,6275,51,586,-535,-1105.349
778,8151,6,6,0,22.258
779,2641,55,32,23,46.711
780,5359,4566,4550,16,599.855
781,13518,3699,9156,-5457,656.044
782,8037,1071,1667,-596,662.287
783,12354,29,74,-45,3.227
784,3052,7,10,-3,-2.88
785,1248,1415,501,914,335.025
786,4884,1841,6303,-4462,-650.268
787,14941,10,10,0,-3.082
788,14439,2517,2941,-424,-2236.029
789,4911,469,1191,-722,-1091.893
790,6653,12184,15041,-2857,-3670.125
791,14577,6101,8485,-2384,16.988
792,8603,55,55,0,40.452
793,14158,9500,8679,821,799.445
794,9223,12018,10528,1490,-4271.857
795,5883,26,198,-172,595.402
796,1417,3357,7990,-4633,-2388.303
797,4294,35,23,12,-16.067
798,13151,76,61,15,-19.741
799,10321,22,22,0,-3.616
800,14971,12,12,0,11.533
801,4277,13,36,-23,-38.508
802,10654,61,99,-38,-4.15
803,167,1172,1737,-565,-2014.521
804,4025,24,148,-124,-189.171
805,5964,271,78,193,-245.783
806,4831,393,147,246,309.598
807,9461,644,1564,-920,-1012.27
808,7763,149,71,78,-1626.32
809,6690,1374,1708,-334,661.049
810,1451,8669,7060,1609,-3337.628
811,3160,11,11,0,-0.528
812,4081,33,33,0,1.973
813,3206,111,312,-201,-340.258
814,6658,5584,6514,-930,484.683
815,6314,39,39,0,40.091
816,9201,4244,10673,-6429,-10512.629
817,10566,91,103,-12,-4.961
818,6956,2,3,-1,-35.588
819,14650,37,31,6,-156.437
820,3064,37,37,0,6.881
821,2579,3582,835,2747,-1322.951
822,15324,36,179,-143,-493.254
823,3536,19,19,0,26.822
824,14120,1212,3021,-1809,-16227.796
825,1769,15,247,-232,41.189
826,2500,1439,11199,-9760,-4482.948
827,6131,7964,470,7494,290.887
828,8131,55,32,23,150.55
829,11983,11,14,-3,0.286
830,15194,51,316,-265,-602.447
831,12693,557,693,-136,-15.478
832,6451,2107,6895,-4788,-728.103
833,12639,60,51,9,262.415
834,5989,45,119,-74,20.803
835,10903,197,197,0,-446.085
836,1198,33,9917,-9884,-6807.079
837,12282,19,305,-286,-1259.917
838,11120,2599,2085,514,-1299.283
839,13909,9683,23207,-13524,-4575.987
840,6307,1548,163,1385,-8.598
841,13592,15624,5355,10269,2422.34
842,7043,12,12,0,-6.059
843,4848,7744,2334,5410,229.252
844,11400,607,94,513,175.075
845,9841,39,49,-10,-221.046
846,9362,995,899,96,-1252.719
847,9630,7060,8624,-1564,-903.223
848,15006,362,1905,-1543,-69.854
849,2541,9865,10826,-961,-1393.546
850,13221,2251,6857,-4606,-14782.785
851,2958,383,337,46,1420.162
852,4415,21,21,0,16.718
853,8117,9,9,0,-19.093
854,12128,58,67,-9,1.457
855,2325,21,21,0,10.285
856,12083,3,1,2,2.408
857,7124,7,12,-5,-5.283
858,855,2786,1156,1630,416.526
859,714,20151,24266,-4115,-3485.113
860,10219,1438,1644,-206,-15.69
861,14511,1539,667,872,195.889
862,14067,5217,2698,2519,233.019
863,6111,794,1011,-217,-23.017
864,7234,18,41,-23,-16.222
865,9499,69,63,6,-886.965
866,7144,63,29,34,0.652
867,12212,58,466,-408,358.477
868,3713,81,847,-766,-175.623
869,7452,4,2,2,2.578
870,2484,739,208,531,317.109
871,2820,97,214,-117,169.566
872,7945,70,52,18,-164.04
873,10483,249,122,127,34.109
874,6863,10,60,-50,-174.215
875,15142,51,52,-1,57.737
876,7757,95,95,0,429.602
877,1961,106,106,0,83.661
878,8544,879,984,-105,-952.819
879,4855,2165,2405,-240,-126.414
880,4886,7731,4311,3420,471.62
881,4330,20,132,-112,-50.366
882,9785,19,19,0,-2.912
883,9446,670,3637,-2967,-343.978
884,8894,387,943,-556,1900.606
885,7521,77,168,-91,-32.688
886,1565,829,8416,-7587,-1327.88
887,15521,1547,1718,-171,-14.204
888,4863,1710,3730,-2020,-1985.819
889,3147,7,12,-5,-7.381
890,13594,620,10825,-10205,-12814.531
891,14242,4465,2424,2041,-8055.452
892,903,629,2438,-1809,1242.453
893,10881,406,3853,-3447,-195.052
894,3506,29,83,-54,-6.143
895,11600,43,132,-89,-39.923
896,9264,244,179,65,1319.89
897,7775,103,78,25,-9.554
898,14466,5184,2956,2228,612.859
899,11733,6,3,3,8.265
900,5955,503,282,221,219.399
901,8482,4070,3966,104,1774.889
902,14430,5181,898,4283,974.672
903,15592,162,32,130,402.557
904,9371,29,1316,-1287,448.785
905,10344,32,55,-23,8.906
906,1241,16,17,-1,4.464
907,1694,459,387,72,224.684
908,8455,2800,3426,-626,-1268.611
909,4050,10,13,-3,-17.428
910,12360,88,123,-35,-13.795
911,7567,9,17,-8,-12.679
912,6478,1851,2144,-293,284.316
913,8717,1082,1780,-698,177.351
914,13065,3548,4305,-757,-27.374
915,5625,784,1946,-1162,16.623
916,793,20104,15225,4879,-2480.807
917,11730,11,11,0,-1.464
918,859,180,472,-292,485.186
919,8740,7,22,-15,-1478.039
920,9606,9952,6688,3264,45.543
921,959,1065,4120,-3055,-3054.245
922,9168,84,276,-192,144.865
923,9946,250,2074,-1824,1422.821
924,9777,63,63,0,8.939
925,5847,18814,17404,1410,-892.571
926,3755,17,23,-6,9.055
927,1359,12945,12799,146,2095.605
928,2334,21,21,0,7.145
929,6461,20219,23177,-2958,728.708
930,7182,34,42,-8,-0.148
931,1850,178,209,-31,1387.368
932,10053,13128,9024,4104,893.585
933,12376,20,58,-38,-7.091
934,5081,98,4283,-4185,550.622
935,10263,3,131,-128,-295.447
936,9243,17851,19552,-1701,-15135.724
937,4997,592,14112,-13520,-5620.467
938,1469,4470,9436,-4966,-7999.194
939,15205,18,18,0,-1.514
940,7039,144,33,111,18.279
941,621,8368,14532,-6164,-3962.336
942,1336,1416,29529,-28113,-2627.468
943,9705,43,43,0,-16.783
944,8300,836,946,-110,699.14
945,10007,385,13949,-13564,-7540.33
946,9338,0,0,0,1.966
947,1871,145,172,-27,-845.01
948,13741,661,16666,-16005,-3638.191
949,15057,13801,5506,8295,-118.407
950,12267,307,139,168,23.773
951,3374,37,83,-46,-2.631
952,9041,80,80,0,-308.842
953,11757,18,22,-4,5.657
954,1910,144,170,-26,658.253
955,13443,57552,66468,-8916,2578.392
956,6441,2204,3278,-1074,-1359.167
957,222,336,8731,-8395,-25.224
958,10128,639,2112,-1473,-79.495
959,5312,3602,7438,-3836,-2240.868
960,3927,0,0,0,-68.062
961,7637,10,12,-2,-4.805
962,12590,6383,9011,-2628,-2302.733
963,10820,1357,107,1250,599.376
964,13431,28754,7809,20945,1128.791
965,8862,234,247,-13,-2319.279
966,2914,3717,540,3177,-1640.624
967,1187,11692,9945,1747,-203.831
968,6944,92,310,-218,-160.651
969,2814,4750,606,4144,-1008.718
970,3589,36,35,1,-2.48
971,3116,7,14,-7,-8.878
972,9252,4019,12587,-8568,-8363.231
973,9546,33,33,0,-1117.506
974,8194,42,35,7,27.306
975,13841,0,0,0,-601.216
976,14709,6384,77360,-70976,-29530.773
977,7507,25,25,0,26.062
978,10647,74,45,29,-8.266
979,11897,0,0,0,-423.48
980,2390,29,29,0,21.615
981,5268,1350,295,1055,430.856
982,7974,347,809,-462,77.768
983,13683,26,26,0,9.077
984,6781,11,11,0,0.669
985,6618,28,4532,-4504,-6765.63
986,9491,206,770,-564,740.672
987,2773,8,8,0,1.848
988,4663,1299,5437,-4138,-3157.343
989,11016,671,848,-177,-1279.888
990,11977,6,6,0,2.472
991,2510,40,329,-289,666.978
992,2859,283,6665,-6382,-477.805
993,517,2271,6875,-4604,-2689.052
994,7465,5,15,-10,67.921
995,13526,4,282,-278,-3569.233
996,13483,141,15763,-15622,-5951.741
997,11356,14,33,-19,13.674
998,11500,16127,31085,-14958,-521.604
999,5926,783,167,616,166.538
1000,6425,0,0,0,-192.947
1001,11808,26425,19608,6817,1916.098
1002,5149,47,47,0,221.88
1003,3266,106,69,37,-2.002
1004,13686,87,29,58,41.847
1005,7100,15,48,-33,5.557
1006,4955,28,952,-924,-608.577
1007,6747,39,35,4,28.472
1008,2095,11,32,-21,1330.858
1009,14355,409,389,20,68.347
1010,5266,33,2336,-2303,-4308.397
1011,9932,309,2715,-2406,885.263
1012,3507,51,32,19,39.61
1013,9286,417,8823,-8406,-11322.391
1014,11872,82,4094,-4012,-4566.956
1015,13234,13313,17040,-3727,-846.502
1016,13219,6040,4825,1215,-3562.484
1017,10294,490,92,398,373.011
1018,4645,5,5792,-5787,-2455.46
1019,2656,34,678,-644,-1075.384
1020,8764,471,356,115,1048.212
1021,1680,100,652,-552,26.351
1022,13804,6781,22028,-15247,-18467.263
1023,8349,7177,3919,3258,-1525.764
1024,3851,1885,301,1584,-609.461
1025,11372,57,57,0,-84.807
1026,6904,16,35,-19,20.781
1027,10561,51,48,3,4.472
1028,4327,27,27,0,-9.396
1029,8733,4120,3806,314,996.703
1030,1945,152,152,0,854.844
1031,11507,132,89,43,474.699
1032,4000,3,375,-372,-295.904
1033,14215,2643,2318,325,-1187.455
1034,6433,2614,12851,-10237,-5067.009
1035,426,8571,9657,-1086,217.92
1036,9278,5081,13429,-8348,-13171.405
1037,7078,34,38,-4,-23.418
1038,10756,501,150,351,1516.294
1039,558,5763,9138,-3375,1925.13
1040,14009,4332,3640,692,-429.162
1041,10853,434,71,363,632.512
1042,6377,377,232,145,33.399
1043,10074,9591,17565,-7974,2147.393
1044,7679,7,10,-3,-0.19
1045,9587,2,3749,-3747,-1707.57
1046,5941,199,370,-171,21.526
1047,8371,2067,3981,-1914,-597.67
1048,6257,4122,1770,2352,-170.165
1049,1941,15,45,-30,125.146
1050,15581,11,120,-109,-92.234
1051,6871,25,30,-5,21.871
1052,5132,2682,2232,450,115.05
1053,9746,8,9,-1,-0.476
1054,6203,499,1103,-604,-1239.538
1055,2244,2495,4093,-1598,-858.917
1056,939,63,465,-402,170.926
1057,7613,18,8,10,-0.433
1058,5465,8722,19386,-10664,-12535.302
1059,5248,2376,948,1428,-891.93
1060,6928,171,426,-255,-1.875
1061,12456,4,5,-1,-3.903
1062,6541,16630,24484,-7854,-1311.254
1063,9935,1427,3149,-1722,-192.389
1064,7527,22,23,-1,2.212
1065,1239,59,59,0,53.448
1066,7392,312,65,247,36.968
1067,6136,1680,886,794,1107.483
1068,998,137,137,0,1747.704
1069,332,9648,9325,323,556.465
1070,10896,595,1169,-574,-1072.529
1071,4867,1364,5261,-3897,-1432.565
1072,7299,112,853,-741,8.662
1073,14761,541,3542,-3001,-5492.608
1074,13071,445,570,-125,-840.992
1075,6090,12,12,0,2.389
1076,4515,17,893,-876,-2517.169
1077,7713,63,63,0,175.29
1078,10323,13,13,0,-1.693
1079,14700,28672,34579,-5907,-787.08
1080,6366,26,26,0,-95.138
1081,2284,5330,4444,886,-5627.833
1082,13281,13138,6612,6526,-15748.569
1083,3690,681,15,666,-13.759
1084,12543,9750,7079,2671,1454.836
1085,8389,569,722,-153,-34.129
1086,13747,28611,6947,21664,7635.031
1087,1217,107,116,-9,-156.711
1088,5087,15357,24787,-9430,-5668.713
1089,14765,47582,66326,-18744,-7078.624
1090,1360,25794,13509,12285,665.777
1091,11300,27,27,0,-16.021
1092,12524,92,2297,-2205,1142.137
1093,8011,1477,792,685,96.752
1094,6532,2878,3256,-378,-1362.406
1095,6502,11987,12019,-32,956.182
1096,7321,21,21,0,5.535
1097,14503,489,1790,-1301,-365.634
1098,13826,7661,30183,-22522,-18203.947
1099,6980,299,559,-260,-110.265
1100,10237,28,33,-5,25.323
1101,15406,44,33,11,74.436
1102,11605,23,39,-16,120.598
1103,9767,16,16,0,-33.057
1104,9953,25,2078,-2053,-2497.783
1105,15091,5434,14676,-9242,-2501.156
1106,9905,1320,2780,-1460,-1101.306
1107,13316,4742,22481,-17739,-5977.545
1108,8105,7,132,-125,-313.61
1109,7599,16,16,0,-2.795
1110,3732,217,65,152,-108.622
1111,11804,14576,16995,-2419,-3961.296
1112,6482,121,2927,-2806,-3221.357
1113,10269,2286,500,1786,366.117
1114,1862,123,265,-142,992.978
1115,9622,8228,8471,-243,-1715.563
1116,14526,0,0,0,-11.445
1117,9741,32,32,0,-12.136
1118,5434,5051,1646,3405,-6286.474
1119,15252,12,30,-18,-4.028
1120,6762,4,6,-2,-0.875
1121,10365,42,42,0,19.228
1122,819,586,617,-31,875.81
1123,14866,129,49,80,45.277
1124,14993,6,3,3,0.566
1125,11205,103,102,1,176.08
1126,9723,52,52,0,27.043
1127,3017,47,142,-95,24.947
1128,1046,901,1388,-487,-174.799
1129,1575,398,3078,-2680,-8826.797
1130,952,894,2693,-1799,1023.53
1131,986,3401,1772,1629,528.784
1132,1620,86,57,29,124.592
1133,4054,45,84,-39,-4.294
1134,9537,5395,5560,-165,-1106.344
1135,15506,485,145,340,41.626
1136,8054,43,171,-128,25.332
1137,8344,2941,2706,235,-1146.285
1138,3448,58,23,35,51.598
1139,3530,30,32,-2,13.387
1140,977,26,44,-18,262.133
1141,10386,28,39,-11,-5.79
1142,171,1523,1181,342,-558.04
1143,4198,77,63,14,5.921
1144,4658,124,387,-263,-3063.472
1145,11788,29,25,4,-7.739
1146,9282,20161,17162,2999,3257.609
1147,1631,206,373,-167,-526.016
1148,10607,23,66,-43,32.089
1149,10001,395,1767,-1372,-1075.312
1150,10322,50,50,0,-18.645
1151,15518,99,186,-87,1.786
1152,13558,73,567,-494,-4864.641
1153,827,1652,1050,602,-1196.324
1154,8301,59,3526,-3467,-1606.973
1155,3841,104,54,50,822.153
1156,636,333,6943,-6610,-5052.918
1157,15148,135,295,-160,191.428
1158,13872,60768,66882,-6114,1765.307
1159,13411,7161,10792,-3631,-2279.631
1160,3854,154,289,-135,-511.202
1161,7386,105,43,62,30.286
1162,13896,20240,57932,-37692,-22341.331
1163,12236,140,82,58,260.25
1164,10731,8538,3026,5512,1791.338
1165,3954,433,258,175,177.761
1166,10487,199,106,93,541.426
1167,15528,485,1694,-1209,-609.478
1168,8469,5,509,-504,-1644.573
1169,14740,1365,1558,-193,-19112.088
1170,15280,38,38,0,-1.515
1171,11060,4434,6739,-2305,-1726.121
1172,8613,23,23,0,-5.647
1173,4978,4854,7841,-2987,-98.457
1174,14356,24,24,0,48.177
1175,3800,2821,5219,-2398,86.239
1176,242,83,131,-48,-19.73
1177,15449,118,118,0,142.528
1178,2771,156,93,63,59.677
1179,4404,28,45,-17,0.245
1180,1928,94,94,0,78.547
1181,6266,78,75,3,-527.261
1182,8563,699,595,104,155.677
1183,2835,790,7447,-6657,862.387
1184,10222,28,106,-78,-164.124
1185,8481,728,646,82,-576.264
1186,5677,49,49,0,62.441
1187,10452,92,143,-51,261.189
1188,9697,1417,1196,221,70.394
1189,13366,598,405,193,-917.807
1190,10435,35,77,-42,-47.912
1191,10715,823,1407,-584,267.395
1192,12997,132,45,87,66.819
1193,3171,28,21,7,2.216
1194,11704,123,51,72,-3.402
1195,9918,235,92,143,206.935
1196,6974,18,20,-2,-50.809
1197,10084,6902,1537,5365,3538.001
1198,4673,324,1824,-1500,-1378.36
1199,8008,1396,1015,381,-335.643
1200,7789,34,34,0,44.122
1201,12296,2103,385,1718,-67.09
1202,5027,7493,844,6649,-992.55
1203,3974,995,805,190,-399.325
1204,11940,2,1,1,-0.379
1205,14419,1099,2490,-1391,-81.392
1206,12466,3,5,-2,-3.23
1207,1057,19,19,0,44.007
1208,12331,27,39,-12,-33.255
1209,3760,34,116,-82,41.528
1210,4574,94,1416,-1322,57.972
1211,6010,120,498,-378,-46.609
1212,7976,19,26,-7,132.266
1213,14595,130,839,-709,-3.235
1214,5048,364,125,239,-1170.882
1215,4439,48,36,12,10.903
1216,6917,260,435,-175,-234.118
1217,13947,21846,21586,260,524.18
1218,13018,1620,1254,366,504.115
1219,8051,467,267,200,-133.534
1220,5417,7841,8923,-1082,-4975.878
1221,14495,2498,645,1853,112.465
1222,2359,4,4,0,-2.316
1223,8507,8110,5156,2954,-681.183
1224,12286,260,275,-15,258.611
1225,10796,1124,466,658,88.394
1226,64,34,58,-24,5.571
1227,13574,7602,341,7261,5518.327
1228,4939,2650,1448,1202,1455.783
1229,14440,114,2435,-2321,-2429.291
1230,5580,198,558,-360,18.826
1231,11603,51,105,-54,151.707
1232,13062,94,217,-123,-432.24
1233,14675,73,73,0,-16.305
1234,12268,471,307,164,-15.162
1235,8043,802,565,237,51.693
1236,267,735,11702,-10967,-6017.337
1237,8247,200,2472,-2272,-914.693
1238,11449,125,1154,-1029,-370.584
1239,9134,209,3402,-3193,-1170.682
1240,7258,21,58,-37,-2.767
1241,1299,24,27,-3,35.53
1242,3424,1396,1138,258,-877.156
1243,651,2560,5302,-2742,360.924
1244,11785,48,57,-9,16.222
1245,9683,2018,2290,-272,-26.115
1246,3307,24,39,-15,14.174
1247,2717,18,123,-105,-191.561
1248,2395,19,18,1,14.56
1249,4068,138,153,-15,-1.928
1250,12999,422,435,-13,269.219
1251,9844,73,211,-138,241.682
1252,10484,2722,415,2307,478.476
1253,2578,5097,7987,-2890,-446.747
1254,4475,32,56,-24,-3.499
1255,951,5250,7205,-1955,1184.659
1256,3025,5,9,-4,-2.957
1257,5966,1261,133,1128,-106.268
1258,3977,2338,3033,-695,633.408
1259,762,647,1216,-569,-128.326
1260,11342,38,34,4,42.713
1261,3939,5068,2621,2447,348.612
1262,6528,259,5848,-5589,-7518.291
1263,8248,67,67,0,-242.509
1264,9735,47,47,0,87.538
1265,14105,31014,62627,-31613,-3743.028
1266,8801,179,192,-13,-603.781
1267,7091,29,35,-6,-6.65
1268,5179,108,123,-15,-6496.457
1269,4581,5569,2755,2814,1336.141
1270,1841,35,112,-77,187.912
1271,10418,180,80,100,123.886
1272,3357,15,15,0,8.519
1273,9731,14,23,-9,30.834
1274,10872,559,392,167,-1168.169
1275,8570,3202,11793,-8591,-1410.515
1276,15027,7713,12234,-4521,-685.366
1277,14919,7,7,0,-0.149
1278,12834,42,42,0,69.338
1279,8561,837,787,50,-385.842
1280,4024,12,34,-22,-20.579
1281,10555,51,45,6,-22.16
1282,1653,110,110,0,-482.436
1283,2006,4258,3993,265,-3065.271
1284,8610,43,43,0,-74.352
1285,6727,4,4,0,-12.034
1286,15339,73,127,-54,-117.873
1287,746,7178,8493,-1315,-737.459
1288,2694,63,991,-928,-509.106
1289,6485,1286,11378,-10092,-5694.646
1290,14804,1093,940,153,99.204
1291,7845,2353,3238,-885,-413.8
1292,10812,51,112,-61,-1362.865
1293,6396,612,211,401,62.549
1294,11729,12,12,0,-0.732
1295,2382,17,26,-9,1.096
1296,1093,1857,1979,-122,-1296.024
1297,12716,14,996,-982,-2513.825
1298,14074,3210,10626,-7416,2881.798
1299,10341,41,30,11,1.736
1300,6720,18,22,-4,6.083
1301,8317,121,121,0,64.139
1302,14334,34,70,-36,19.351
1303,152,2793,1566,1227,31.903
1304,7592,4,4,0,-1.29
1305,3169,14,26,-12,-0.658
1306,4179,18,18,0,2.666
1307,897,3359,2682,677,-2593.14
1308,8659,26,32,-6,-11.032
1309,887,1485,3951,-2466,539.698
1310,15547,46,46,0,43.847
1311,5493,3947,2028,1919,1129.69
1312,1729,57,57,0,172.437
1313,12740,442,98,344,289.434
1314,11111,426,963,-537,-129.297
1315,8543,2222,294,1928,883.335
1316,8724,351,142,209,154.292
1317,7393,18,18,0,14.888
1318,11631,208,156,52,-137.628
1319,7013,33,36,-3,21.287
1320,232,167,398,-231,917.01
1321,320,9039,10252,-1213,-2711.781
1322,9440,792,2229,-1437,-1227.944
1323,323,5318,7580,-2262,-208.531
1324,7747,140,94,46,161.725
1325,2554,339,470,-131,-210.913
1326,2931,1147,193,954,498.746
1327,10517,24,17,7,-0.284
1328,6154,1945,3894,-1949,683.414
1329,9579,944,290,654,-86.264
1330,1760,49,136,-87,233.321
1331,235,386,104,282,1103.348
1332,7417,19,18,1,26.602
1333,1695,399,3952,-3553,481.675
1334,14518,4456,4635,-179,-1.783
1335,13940,11842,12524,-682,-8038.11
1336,1045,2618,2430,188,1140.402
1337,13571,543,1590,-1047,-6468.972
1338,4681,1331,6717,-5386,-2025.435
1339,15358,367,759,-392,21.214
1340,10131,10,57,-47,293.963
1341,291,869,989,-120,701.79
1342,11999,6,12,-6,-3.846
1343,6679,35,1019,-984,-1358.475
1344,5984,387,137,250,-44.555
1345,8143,11,21,-10,-121.865
1346,8767,1991,3083,-1092,-2668.946
1347,1393,17385,37544,-20159,-86.356
1348,14865,23,50,-27,-142.247
1349,5569,16,35,-19,67.702
1350,11707,25,42,-17,25.511
1351,5556,57,57,0,1026.123
1352,3721,17,46,-29,49.3
1353,14104,11000,41695,-30695,-6895.179
1354,13830,36033,58600,-22567,-19509.286
1355,6712,10,10,0,-0.451
1356,3242,242,955,-713,-1397.719
1357,5540,49,49,0,18.836
1358,7513,37,20,17,-0.349
1359,10613,16,30,-14,9.649
1360,4202,165,67,98,3.672
1361,103,30,3861,-3831,-2329.395
1362,3537,54,58,-4,7.504
1363,15220,21,21,0,-0.25
1364,10319,21,33,-12,11.587
1365,11522,53138,45672,7466,1856.958
1366,10528,29,74,-45,5.379
1367,1208,24,24,0,105.309
1368,13104,28,124,-96,-99.999
1369,15496,204,110,94,184.245
1370,12526,1465,2351,-886,-1851.654
1371,4642,953,2989,-2036,-536.308
1372,13718,739,3294,-2555,-3009.793
1373,14794,52,22551,-22499,-9660.472
1374,13751,29795,18103,11692,1482.519
1375,14644,3,13,-10,1.652
1376,353,88,165,-77,-923.93
1377,11878,33,10127,-10094,-4768.506
1378,2575,187,381,-194,386.993
1379,15110,47,63,-16,38.309
1380,6399,38,38,0,7.485
1381,8478,7907,8777,-870,-538.566
1382,12017,9,26,-17,-11.823
1383,11818,15687,13599,2088,1115.758
1384,6702,25,25,0,5.852
1385,12617,565,434,131,-263.717
1386,8097,710,575,135,134.985
1387,10831,1087,153,934,-404.666
1388,8078,20,54,-34,-26.672
1389,7383,31,19,12,15.325
1390,12144,17,17,0,-90.395
1391,676,15260,10055,5205,3430.325
1392,5963,58,94,-36,-355.504
1393,5903,46,111,-65,-9.358
1394,2491,130,2117,-1987,-877.297
1395,8372,5254,3452,1802,-1246.991
1396,6860,2,2,0,-72.328
1397,2740,74,44,30,2.212
1398,1589,330,3082,-2752,-10026.232
1399,7872,2174,2095,79,307.703
1400,12340,102,165,-63,-0.021
1401,3313,212,152,60,234.172
1402,5602,29,29,0,30.755
1403,14030,15,22588,-22573,9655.264
1404,14138,10923,19108,-8185,2574.51
1405,7276,25,25,0,22.185
1406,11837,8575,4344,4231,102.115
1407,5478,17346,12844,4502,-4090.255
1408,10774,12859,3187,9672,5680.694
1409,2450,3051,2953,98,332.404
1410,10327,25,51,-26,-35.561
1411,10004,2835,3517,-682,-567.496
1412,11663,30,129,-99,-79.935
1413,2893,232,87,145,841.082
1414,10797,4512,1179,3333,3361.261
1415,3105,397,64,333,3.898
1416,8198,16,593,-577,-951.173
1417,8637,26,43,-17,41.317
1418,12940,98,70,28,219.365
1419,11427,49,49,0,86.725
1420,7961,84,55,29,-868.781
1421,10883,152,152,0,593.567
1422,14698,3,52,-49,31.258
1423,8583,3801,712,3089,-259.076
1424,13306,183,1257,-1074,-10227.821
1425,11020,7802,22301,-14499,-3172.435
1426,12309,12,12,0,0.059
1427,6824,26,188,-162,-199.138
1428,1674,101,101,0,1927.771
1429,13902,23,4400,-4377,-4059.486
1430,15069,14324,9397,4927,3639.149
1431,10742,17105,16132,973,-1467.877
1432,9205,9124,13297,-4173,4952.032
1433,1280,42,42,0,37.056
1434,15395,204,95,109,132.626
1435,13276,10370,28766,-18396,-7236.572
1436,2519,17895,9389,8506,801.667
1437,12881,7665,2789,4876,222.051
1438,2871,287,265,22,845.602
1439,7838,254,363,-109,185.356
1440,2532,45,58,-13,127.887
1441,5262,1045,626,419,-774.819
1442,3679,28,117,-89,-181.008
1443,10182,1223,2526,-1303,-276.022
1444,13605,38,38,0,-16.223
1445,13137,7,51,-44,-137.29
1446,12557,3440,1000,2440,2779.74
1447,7547,11,11,0,0.312
1448,11179,2426,3761,-1335,-2404.085
1449,5666,30,100,-70,74.649
1450,12595,275,5874,-5599,-8383.254
1451,4167,129,173,-44,5.806
1452,12194,5,50,-45,-51.04
1453,829,8513,1434,7079,3031.375
1454,5858,5896,4490,1406,-3689.264
1455,3289,191,510,-319,-1343.503
1456,2339,0,0,0,-205.177
1457,15471,43,572,-529,-407.135
1458,7793,5386,896,4490,823.005
1459,4405,14,29,-15,-11.306
1460,14666,63,37,26,34.848
1461,4493,10,26,-16,-7.877
1462,7269,28,88,-60,6.576
1463,14038,1619,359,1260,-135.934
1464,12757,37,99,-62,-76.155
1465,11431,21,32,-11,3.442
1466,11080,1107,1652,-545,371.751
1467,13778,367,1879,-1512,383.668
1468,11706,51,32,19,5.413
1469,10724,7997,1644,6353,1564.535
1470,14777,5313,28076,-22763,252.16
1471,13839,8550,31093,-22543,-23916.441
1472,15275,14,14,0,-0.686
1473,15219,19,25,-6,7.797
1474,15552,48,78,-30,-107.016
1475,11440,51,51,0,-8.136
1476,962,1616,282,1334,-164.861
1477,11452,15,21,-6,1.02
1478,8744,2375,2495,-120,-1148.032
1479,1842,58,58,0,-65.413
1480,12198,19,19,0,0.669
1481,3804,87,114,-27,100.229
1482,2119,48,36,12,107.508
1483,3271,992,1730,-738,-373.767
1484,10960,116,184,-68,584.781
1485,3981,141,687,-546,185.576
1486,13222,23959,23007,952,-9812.844
1487,13638,24,24,0,18.143
1488,14918,16,16,0,-0.57
1489,8835,1109,1003,106,935.172
1490,7404,148,29,119,3.975
1491,1958,83,93,-10,235.863
1492,10062,986,465,521,673.914
1493,1005,12,28,-16,479.101
1494,11551,22,11009,-10987,-3530.174
1495,11701,23,23,0,-6.224
1496,10057,13211,3992,9219,3374.937
1497,2561,9036,10976,-1940,-1649.708
1498,15073,44,3540,-3496,-2519.059
1499,14271,4562,2618,1944,-8450.582
1500,8412,5123,8318,-3195,-1423.465
1501,1175,15617,7641,7976,-1454.578
1502,6179,1771,491,1280,-76.802
1503,8679,36,36,0,53.372
1504,14713,12271,5783,6488,1115.705
1505,6706,2,4,-2,-0.439
1506,9187,3822,4148,-326,1429.252
1507,6633,6101,6092,9,-6554.661
1508,5902,17,19,-2,-3.641
1509,12972,555,79,476,105.743
1510,10146,1539,1600,-61,-1449.563
1511,10538,123,87,36,-3.659
1512,3860,4582,80,4502,1191.817
1513,15396,76,469,-393,-367.638
1514,9505,31,540,-509,-1161.923
1515,7304,34,72,-38,-13.123
1516,12626,325,635,-310,576.07
1517,3157,7,6,1,-3.568
1518,395,23107,5557,17550,-2438.912
1519,14678,142,79,63,3.311
1520,11870,16937,20317,-3380,-2826.298
1521,15482,115,63,52,42.906
1522,10086,2215,931,1284,1464.284
1523,5348,60,1052,-992,156.219
1524,3590,216,239,-23,-12.095
1525,4078,15,30,-15,21.173
1526,15068,4971,5228,-257,1543.465
1527,11455,46,55,-9,163.604
1528,13319,503,75,428,-4681.145
1529,400,5515,772,4743,-1076.375
1530,9226,30301,23682,6619,6157.131
1531,9704,30,63,-33,119.391
1532,9014,148,148,0,1708.981
1533,6537,5559,5058,501,697.585
1534,3035,21,21,0,-1.074
1535,15597,669,302,367,82.468
1536,12190,15,56,-41,-127.327
1537,10385,19,19,0,4.287
1538,9435,2709,1497,1212,11.45
1539,4865,2789,2643,146,-314.695
1540,9572,0,0,0,-73.059
1541,2768,91,113,-22,-48.766
1542,3920,761,1029,-268,-396.047
1543,9921,1487,3404,-1917,1039.541
1544,12419,11,11,0,0.915
1545,5572,393,89,304,299.647
1546,946,156,2891,-2735,-2728.429
1547,11365,57,74,-17,77.226
1548,9347,0,0,0,-15.866
1549,1278,128,128,0,29.698
1550,8000,78,84,-6,52.525
1551,11782,18,27,-9,-19.703
1552,1332,414,135,279,-3114.642
1553,5102,12,7,5,129.273
1554,3179,12,15,-3,-1.327
1555,9110,61,61,0,205.109
1556,10972,679,445,234,2534.074
1557,5078,372,227,145,-1293.496
1558,7517,28,20,8,4.112
1559,647,2686,1733,953,184.14
1560,7215,50,112,-62,28.669
1561,4708,1112,1343,-231,61.791
1562,1703,112,165,-53,512.065
1563,10893,56,56,0,-315.797
1564,11086,104,120,-16,529.866
1565,11196,1866,2900,-1034,680.93
1566,7601,4,9,-5,-1.566
1567,2887,49,49,0,40.182
1568,2375,64,25,39,-0.144
1569,15541,560,736,-176,-74.66
1570,251,464,79,385,75.639
1571,2232,7943,7081,862,11.431
1572,5622,66,66,0,88.194
1573,6159,7466,1569,5897,-1005.725
1574,4991,2285,1282,1003,-3124.973
1575,5835,39840,9279,30561,7603.442
1576,1341,260,589,-329,-4465.571
1577,15323,524,179,345,183.847
1578,3418,422,166,256,350.424
1579,1791,138,244,-106,753.808
1580,4320,12,12,0,1.54
1581,10828,70,110,-40,20.356
1582,5732,143,286,-143,35.264
1583,5235,2035,3009,-974,-532.252
1584,4040,84,44,40,13.973
1585,11035,2272,269,2003,771.442
1586,15138,13,13,0,0.849
1587,3073,15,21,-6,0.861
1588,8593,7090,6119,971,-150.675
1589,1583,143,678,-535,-1086.895
1590,10918,396,176,220,3691.179
1591,8085,55,115,-60,-83.047
1592,9024,1238,238,1000,284.062
1593,15090,208,176,32,614.797
1594,9017,899,1936,-1037,-1383.684
1595,14925,2,3,-1,-1.875
1596,14573,69,949,-880,-946.956
1597,6381,12,33,-21,-19.127
1598,8934,21369,10115,11254,1481.791
1599,4800,3847,3790,57,248.493
1600,1539,25594,22546,3048,-1430.812
1601,4567,2178,2754,-576,899.773
1602,8470,177,96,81,206.666
1603,6446,0,0,0,-152.572
1604,2239,1292,3501,-2209,-2014.42
1605,11489,22,23,-1,-33.56
1606,1666,76,84,-8,-156.459
1607,8171,2,2,0,-186.12
1608,4607,7602,8143,-541,2487.723
1609,12341,25,42,-17,23.37
1610,14563,0,0,0,-73.264
1611,9552,0,0,0,-267.145
1612,10075,10661,18162,-7501,2805.624
1613,13493,7178,26240,-19062,-7847.802
1614,3020,41,20,21,1.099
1615,1718,98,148,-50,278.416
1616,13764,6692,29297,-22605,-14444.633
1617,7371,22,22,0,17.483
1618,11018,5088,4976,112,-1713.774
1619,10032,1134,9371,-8237,-2838.738
1620,6840,29,54,-25,-5.481
1621,5007,21133,2985,18148,1062.698
1622,14165,6473,27458,-20985,-13374.716
1623,5327,10302,13438,-3136,-1472.971
1624,14115,45406,65826,-20420,-26762.678
1625,11083,482,5347,-4865,-1438.18
1626,11825,29438,22214,7224,1989.008
1627,8992,1852,4540,-2688,-745.936
1628,11152,275,259,16,145.995
1629,2000,422,1117,-695,219.963
1630,7726,167,114,53,687.074
1631,1773,73,105,-32,256.032
1632,9191,335,94,241,875.757
1633,12803,3077,3988,-911,-1652.606
1634,14086,126,1066,-940,-169.206
1635,6777,5,4,1,-0.742
1636,5652,67,67,0,7.672
1637,569,730,1359,-629,-970.729
1638,11499,32,32,0,30.804
1639,12711,2618,2456,162,387.971
1640,11391,116,68,48,206.5
1641,9233,19140,17472,1668,-2645.066
1642,4505,272,265,7,122.02
1643,1097,1462,2595,-1133,-1134.827
1644,11214,18,45,-27,-379.11
1645,4361,96,138,-42,-0.47
1646,2675,95,317,-222,77.397
1647,1490,26580,27355,-775,741.319
1648,3135,33,24,9,3.732
1649,2774,119,109,10,-29.184
1650,11354,89,599,-510,56.724
1651,12759,553,1311,-758,164.335
1652,2950,4999,4493,506,-651.174
1653,7916,88,232,-144,-40.893
1654,2150,443,587,-144,230.344
1655,9686,2046,5732,-3686,-2147.692
1656,6961,307,80,227,20.611
1657,9891,455,157,298,-155.865
1658,10409,2003,1419,584,285.409
1659,13767,104,3682,-3578,-5439.791
1660,9404,8691,4486,4205,-1080.653
1661,13421,0,0,0,-1556.453
1662,143,660,2469,-1809,671.298
1663,1552,0,0,0,-132.869
1664,1701,99,587,-488,237.936
1665,5445,1714,4921,-3207,-2987.378
1666,14446,2,1273,-1271,-204.162
1667,523,3403,7465,-4062,-2836.547
1668,385,9877,6018,3859,-407.072
1669,1963,29,2321,-2292,165.918
1670,5970,134,288,-154,6.801
1671,12863,3367,3097,270,-1469.017
1672,9837,291,259,32,57.924
1673,14195,14092,23355,-9263,-8017.978
1674,11390,26,26,0,-5.904
1675,8568,0,0,0,-7.366
1676,15038,3110,11839,-8729,-8025.551
1677,661,111,111,0,-446.827
1678,241,933,441,492,630.504
1679,199,1168,1148,20,77.551
1680,68,36,36,0,34.365
1681,1475,1558,10922,-9364,-6145.66
1682,4089,8,132,-124,-195.63
1683,13282,43507,17228,26279,8026.658
1684,7301,13,13,0,-2.613
1685,4220,122,70,52,-8.569
1686,15507,909,634,275,215.234
1687,14404,79,391,-312,3.75
1688,6349,15,18,-3,-178.228
1689,12650,34,172,-138,36.899
1690,11199,8028,3871,4157,126.421
1691,767,2056,9684,-7628,-7053.612
1692,12495,2,4,-2,-0.38
1693,2151,206,425,-219,20.845
1694,6071,26,82,-56,-0.671
1695,11613,24,24,0,25.722
1696,13370,1295,341,954,1303.18
1697,10422,127,130,-3,274.659
1698,13033,1615,1394,221,80.842
1699,11429,276,493,-217,-90.961
1700,10558,24,68,-44,-28.728
1701,11946,23,23,0,4.188
1702,12935,96,413,-317,97.725
1703,7242,12,12,0,33.881
1704,6280,369,1724,-1355,-1301.561
1705,9224,11582,16319,-4737,102.582
1706,7735,29,42,-13,50.194
1707,4495,10,15,-5,-0.402
1708,6255,3647,2677,970,-2486.11
1709,7259,53,102,-49,-109.402
1710,3807,640,197,443,-341.724
1711,1195,69,69,0,370.944
1712,5631,46,46,0,36.091
1713,6464,4290,11879,-7589,-4496.053
1714,8909,4531,4342,189,462.331
1715,10052,606,14575,-13969,-6594.641
1716,898,2844,2336,508,-830.109
1717,954,206,1261,-1055,-986.621
1718,7396,9,9,0,0.775
1719,11541,9194,33781,-24587,-7346.611
1720,15580,633,323,310,125.095
1721,13776,30761,11821,18940,7000.389
1722,4119,165,116,49,5.964
1723,2890,2681,1036,1645,1049.624
1724,6510,29260,12854,16406,3128.323
1725,2106,456,1026,-570,-147.779
1726,11961,14,14,0,12.738
1727,14214,39423,49609,-10186,-19993.073
1728,12741,14,14,0,-131.624
1729,14887,81,581,-500,-98.544
1730,8608,52,62,-10,-31.877
1731,12470,12,13,-1,1.164
1732,12362,160,349,-189,-26.615
1733,3199,3,3,0,-2.373
1734,3665,1106,251,855,0.993
1735,3442,1287,395,892,430.907
1736,10411,717,160,557,-63.287
1737,12288,1641,229,1412,-313.678
1738,7102,11,11,0,-8.003
1739,7369,16,16,0,21.012
1740,11170,166,2367,-2201,-1709.368
1741,3567,14,19,-5,2.146
1742,363,327,2432,-2105,-5062.459
1743,8515,3339,2808,531,855.501
1744,6419,2088,1333,755,-3668.427
1745,317,5938,7942,-2004,-1035.304
1746,6933,79,455,-376,-92.995
1747,9976,362,102,260,-335.212
1748,10034,2982,6646,-3664,-6384.987
1749,5071,234,7513,-7279,-2156.15
1750,12301,11,20,-9,-2.853
1751,13900,13470,10534,2936,635.801
1752,10932,183,2022,-1839,-1023.871
1753,3514,15,15,0,-17.635
1754,11505,0,0,0,-642.053
1755,14185,55942,47813,8129,-4519.061
1756,5997,68,191,-123,46.114
1757,13982,262,754,-492,1686.739
1758,12669,64,137,-73,-155.022
1759,13390,2133,11969,-9836,-9373.517
1760,9317,0,0,0,-93.125
1761,13292,8116,14704,-6588,-8752.411
1762,6199,1043,6978,-5935,-1430.82
1763,6404,5837,3647,2190,-3033.526
1764,9436,501,1902,-1401,-92.443
1765,1303,3306,4000,-694,1550.133
1766,7180,19,19,0,-42.782
1767,3204,679,316,363,87.709
1768,12680,121,30,91,11.38
1769,322,6,1858,-1852,-2762.231
1770,13044,1417,1693,-276,-292.046
1771,818,1499,171,1328,1554.353
1772,4031,91,205,-114,-85.282
1773,302,13265,18106,-4841,-3089.166
1774,9117,2251,3554,-1303,-559.27
1775,1220,150,63,87,79.934
1776,436,862,576,286,-1716.31
1777,2830,206,5046,-4840,-1046.837
1778,1169,2,2884,-2882,-4953.422
1779,5129,35,9015,-8980,-3998.727
1780,10149,2220,1498,722,771.09
1781,13944,2585,7676,-5091,-8363.911
1782,14722,366,66836,-66470,-34613.376
1783,5795,143,157,-14,-93.902
1784,824,4741,4544,197,1305.131
1785,9955,126,126,0,1010.423
1786,11682,6,19,-13,27.349
1787,6713,13,13,0,2.094
1788,4268,21,21,0,-34.204
1789,8632,110,49,61,40.418
1790,2540,475,3397,-2922,-609.842
1791,6735,8,8,0,-0.713
1792,8621,28,28,0,25.871
1793,2108,575,79,496,75.996
1794,1831,101,101,0,70.67
1795,11871,1646,3515,-1869,-3521.081
1796,3512,43,43,0,21.733
1797,6778,13,13,0,0.31
1798,10120,2865,3804,-939,864.232
1799,7890,3248,612,2636,632.178
1800,6988,47,30,17,-60.378
1801,14823,328,834,-506,90.451
1802,7017,42,48,-6,20.557
1803,14210,46,6857,-6811,-5722.209
1804,14952,7,13,-6,-2.97
1805,3605,43,101,-58,-56.808
1806,3156,6,9,-3,-3.75
1807,13507,313,282,31,-713.754
1808,12457,6,6,0,3.857
1809,7860,3903,2881,1022,228.14
1810,2211,165,1340,-1175,-719.627
1811,6934,191,87,104,-0.234
1812,14838,55,906,-851,-272.95
1813,15283,14,14,0,8.692
1814,2280,82,360,-278,-1463.781
1815,7036,38,42,-4,86.854
1816,12332,117,143,-26,-3.625
1817,8938,3954,3795,159,-3377.824
1818,10394,5,21,-16,-16.133
1819,14812,158,63,95,32.901
1820,6166,97,408,-311,337.739
1821,10680,15,15,0,-0.609
1822,2031,224,2049,-1825,-4434.536
1823,11772,18,18,0,-16.036
1824,15368,1749,327,1422,285.555
1825,14159,650,6264,-5614,2698.851
1826,8618,49,48,1,-154.792
1827,13808,3708,1854,1854,-685.523
1828,3659,1784,181,1603,-15.443
1829,10375,101,91,10,261.608
1830,14436,1006,2352,-1346,-49.59
1831,14340,4351,3783,568,51.748
1832,3991,1378,1699,-321,-1214.446
1833,3694,30,57,-27,32.877
1834,5815,44017,31027,12990,-4097.509
1835,9621,190,3314,-3124,-2665.163
1836,1471,15,12701,-12686,-2888.141
1837,4051,480,265,215,-13.999
1838,13603,29,29,0,5.778
1839,5203,1106,1486,-380,1219.35
1840,15470,100,201,-101,77.43
1841,4466,20,23,-3,8.395
1842,3576,35,19,16,-0.13
1843,14406,52,2264,-2212,-758.262
1844,4692,2600,2972,-372,-1156.118
1845,13149,68,68,0,46.536
1846,12503,1377,2783,-1406,-3344.437
1847,10718,27,527,-500,-2583.701
1848,8449,286,289,-3,-1853.4
1849,6546,26153,24326,1827,2515.717
1850,9545,0,0,0,-48.724
1851,9390,2968,3323,-355,-138.781
1852,6555,1482,2546,-1064,-401.484
1853,3747,575,373,202,126.694
1854,6843,3,59,-56,-16.389
1855,10877,1152,11922,-10770,-1004.586
1856,3192,5,5,0,-0.082
1857,5563,67,123,-56,-71.265
1858,4981,8992,6096,2896,270.362
1859,6354,46,71,-25,6.761
1860,4070,26,43,-17,20.179
1861,338,17291,10427,6864,1115.791
1862,1804,72,108,-36,65.13
1863,8421,786,1675,-889,-290.163
1864,3975,629,3803,-3174,841.967
1865,2977,51,77,-26,186.731
1866,6188,870,430,440,-573.327
1867,12829,2574,247,2327,94.369
1868,14561,4056,4259,-203,-9.49
1869,4309,9,21,-12,-9.308
1870,6398,15,287,-272,-125.96
1871,520,2999,2740,259,506.819
1872,8269,182,2205,-2023,-196.744
1873,14649,169,186,-17,8.855
1874,9068,2354,2215,139,-168.66
1875,8447,119,93,26,-118.635
1876,6051,282,60,222,5.164
1877,4550,12606,17135,-4529,-49.047
1878,1594,346,28584,-28238,-8409.129
1879,11445,17,17,0,25.004
1880,821,3569,3864,-295,-340.769
1881,13922,3,3,0,-2198.79
1882,8729,1461,2258,-797,-694.396
1883,12965,296,581,-285,-122.089
1884,10159,99,681,-582,469.609
1885,10135,142,118,24,-589.9
1886,7940,1191,321,870,154.798
1887,9082,566,6591,-6025,-434.545
1888,3867,105,179,-74,-384.71
1889,14331,1289,225,1064,-633.118
1890,8030,117,166,-49,-78.744
1891,11933,294,51,243,-10.252
1892,4917,3947,1599,2348,1805.434
1893,7062,35,38,-3,8.818
1894,9617,91,1279,-1188,-40.318
1895,662,1933,1322,611,785.454
1896,9518,24,24,0,-382.163
1897,4716,12,30,-18,93.45
1898,5362,5682,4058,1624,158.498
1899,530,1792,1277,515,202.519
1900,12923,29,458,-429,-338.435
1901,6842,18,24,-6,-24.256
1902,11761,23,23,0,10.56
1903,6814,5,10,-5,-2.301
1904,244,2163,142,2021,114.948
1905,8306,217,55,162,233.445
1906,11698,40,30,10,33.954
1907,351,10444,9702,742,-4672.604
1908,5930,20,41,-21,7.519
1909,11412,133,51,82,126.547
1910,1311,40,10662,-10622,-5656.476
1911,13435,30132,17526,12606,380.597
1912,606,1810,714,1096,2611.971
1913,1486,0,0,0,-462.514
1914,9101,4605,1991,2614,667.323
1915,6682,9215,9814,-599,-2238.349
1916,6241,182,2267,-2085,-3469.06
1917,1200,188,69,119,12.921
1918,10868,63,471,-408,-287.692
1919,7530,47,103,-56,-171.857
1920,857,5513,8904,-3391,2224.347
1921,14039,369,25395,-25026,4619.917
1922,3395,14,14,0,2.289
1923,10886,1662,5578,-3916,-812.795
1924,4375,29,83,-54,13.37
1925,8619,5,12,-7,12.927
1926,2290,3241,1818,1423,-4640.291
1927,6804,13,43,-30,-21.865
1928,12311,68,29,39,5.747
1929,12730,420,208,212,38.12
1930,7791,114,104,10,-102.146
1931,8772,2509,3628,-1119,-1006.388
1932,10082,16,40,-24,1753.606
1933,13005,3787,1728,2059,-759.384
1934,217,71,7752,-7681,-2844.925
1935,936,60,3116,-3056,-1253.227
1936,8793,1513,2051,-538,-2903.768
1937,5595,26,75,-49,103.054
1938,10567,7,162,-155,-47.486
1939,15022,179,162,17,58.306
1940,3447,301,2015,-1714,-125.575
1941,3523,252,47,205,39.087
1942,15529,41,41,0,79.912
1943,14775,789,20818,-20029,-22025.061
1944,6274,39,92,-53,10.906
1945,11128,8535,18544,-10009,-2673.589
1946,12487,6,6,0,4.057
1947,13335,13112,8234,4878,-2400.79
1948,14735,6873,14712,-7839,3587.021
1949,9085,357,202,155,643.799
1950,8294,33,97,-64,46.888
1951,6454,190,369,-179,-697.113
1952,11496,747,97,650,324.841
1953,2913,163,511,-348,-109.343
1954,5111,160,163,-3,531.608
1955,10965,39,39,0,79.87
1956,12169,57,23,34,7.1
1957,10400,52,92,-40,12.18
1958,11558,37489,28296,9193,-108.568
1959,9394,1354,652,702,-104.572
1960,2808,1597,1952,-355,610.526
1961,13291,157,2982,-2825,-12949.146
1962,10913,266,205,61,69.365
1963,7166,56,62,-6,1.123
1964,6659,19044,22550,-3506,421.553
1965,6915,28,28,0,3.036
1966,12251,1639,200,1439,376.672
1967,15325,285,941,-656,-59.658
1968,1553,173,22020,-21847,-5068.876
1969,4018,190,98,92,-7.688
1970,8586,2223,6604,-4381,187.156
1971,7799,30,27,3,-1315.164
1972,1685,807,1719,-912,-18.991
1973,3712,25,31,-6,15.403
1974,462,2541,4664,-2123,-1253.587
1975,13612,41,40,1,14.81
1976,491,1177,1925,-748,-953.897
1977,14964,23,23,0,39.9
1978,9076,719,307,412,566.679
1979,7732,5073,541,4532,561.511
1980,8487,0,0,0,-221.139
1981,15153,54,48,6,-616.941
1982,6931,20,18,2,8.391
1983,2689,98,1131,-1033,-1153.508
1984,2788,18,18,0,-14.569
1985,6749,6,6,0,-0.199
1986,573,1706,2264,-558,-756.379
1987,974,14,14,0,-2526.165
1988,14801,116,614,-498,8.482
1989,2451,2918,5204,-2286,-1201.202
1990,7199,26,80,-54,-1.615
1991,6792,10,10,0,0.204
1992,8978,1486,3301,-1815,-3149.352
1993,3217,7,219,-212,-177.172
1994,14492,32,31,1,347.296
1995,12902,367,127,240,352.424
1996,13447,25101,18258,6843,-2294.652
1997,889,2,1670,-1668,-1707.412
1998,9377,12986,10556,2430,492.242
1999,1848,67,67,0,285.224
2000,1353,5302,3472,1830,-1618.816
2001,5383,11602,8650,2952,-816.271
2002,10738,1320,4606,-3286,-204.598
2003,7783,1217,85,1132,43.152
2004,2077,1093,108,985,310.218
2005,2787,13,40,-27,-46.484
2006,8062,605,960,-355,-82.561
2007,9092,91,375,-284,656.8
2008,681,5027,9967,-4940,-5440.101
2009,12299,1422,356,1066,517.978
2010,9523,9999,9508,491,-502.348
2011,4391,7,6,1,0.73
2012,3891,204,664,-460,-393.581
2013,1381,16230,19834,-3604,950.766
2014,11962,38,36,2,20.139
2015,8791,374,792,-418,-84.054
2016,4602,1806,253,1553,-1248.373
2017,7121,15,21,-6,-93.709
2018,13895,62777,77191,-14414,5398.79
2019,14187,376,14577,-14201,-4380.203
2020,15590,896,239,657,100.47
2021,460,4623,2757,1866,19.764
2022,5570,73,79,-6,-28.887
2023,13815,0,0,0,-1718.395
2024,12465,4,3,1,-0.512
2025,11446,1622,119,1503,432.164
2026,6905,216,100,116,4.071
2027,14413,578,131,447,279.403
2028,11917,19,19,0,3.376
2029,12800,4951,14099,-9148,-2385.254
2030,3321,27,27,0,-51.451
2031,230,803,64,739,214.687
2032,2396,5,33,-28,-15.807
2033,1861,414,181,233,91.972
2034,788,3169,772,2397,-25.217
2035,6304,314,76,238,43.44
2036,5270,8879,8958,-79,-3424.662
2037,11951,101,35,66,-0.088
2038,9599,2,200,-198,-1143.162
2039,12066,17,17,0,7.732
2040,2645,36,647,-611,-156.486
2041,14442,2979,2313,666,6.242
2042,6297,845,669,176,-2476.332
2043,10957,7,69,-62,-247.548
2044,10530,31,52,-21,8.656
2045,8895,5500,18343,-12843,-3855.996
2046,13094,3970,2276,1694,1562.561
2047,3857,875,1202,-327,-902.833
2048,2669,7,513,-506,-504.195
2049,4019,74,178,-104,-104.959
2050,7307,5,2,3,1.478
2051,8146,781,301,480,26.665
2052,14311,3222,6813,-3591,-5226.801
2053,8468,0,0,0,-8.227
2054,11696,330,99,231,1.658
2055,8358,7820,4573,3247,120.162
2056,4729,845,8600,-7755,465.135
2057,6196,20,2503,-2483,-2533.063
2058,5574,320,133,187,486.592
2059,9206,3028,478,2550,1166.283
2060,3504,65,230,-165,-14.578
2061,9729,39,41,-2,-60.062
2062,10798,311,870,-559,1645.613
2063,11831,1867,4548,-2681,-2878.99
2064,10083,4029,2672,1357,2328.653
2065,12463,7,8,-1,2.962
2066,5062,37813,17233,20580,4052.545
2067,1509,34931,4770,30161,2533.92
2068,12323,13,24,-11,-36.009
2069,11139,24,12215,-12191,-5508.685
2070,3790,124,260,-136,-101.903
2071,1384,8313,2296,6017,309.421
2072,11478,507,130,377,191.099
2073,11332,522,200,322,125.714
2074,1500,32479,8530,23949,1136.212
2075,1194,136,135,1,721.879
2076,7586,25,25,0,-1.286
2077,5388,5,1113,-1108,-1433.453
2078,10360,41,31,10,0.808
2079,12657,47,94,-47,-193.062
2080,538,3672,3582,90,-1434.804
2081,9389,2,2410,-2408,-2452.824
2082,2757,436,347,89,82.056
2083,4861,2293,2186,107,13.048
2084,2452,809,3019,-2210,-996.931
2085,5473,12136,16692,-4556,-5968.822
2086,14333,4102,4161,-59,-1032.038
2087,14835,82,78,4,52.211
2088,4901,9230,2868,6362,1113.172
2089,7531,124,162,-38,-9.477
2090,2786,0,0,0,-94.173
2091,6417,13992,17401,-3409,-2548.278
2092,14849,419,934,-515,-92.065
2093,2969,81,263,-182,-2381.605
2094,5709,39,39,0,19.381
2095,11710,15,15,0,-0.782
2096,2815,19,609,-590,-997.091
2097,565,57,57,0,1012.293
2098,3597,27,27,0,1.343
2099,14753,6144,6657,-513,-17459.805
2100,4582,10041,12642,-2601,-1959.008
2101,7615,7,8,-1,0.333
2102,9020,229,229,0,571.56
2103,2476,18,139,-121,-397.195
2104,3548,1,5,-4,-4.104
2105,4206,19,19,0,-0.365
2106,447,6171,8985,-2814,-3354.958
2107,5468,3167,6931,-3764,-5244.377
2108,3226,13,29,-16,-81.967
2109,13575,2802,1126,1676,-2901.811
2110,8709,895,835,60,721.102
2111,7669,6,6,0,-0.598
2112,1095,4081,3376,705,665.386
2113,5377,13523,9403,4120,680.189
2114,7746,89,89,0,446.514
2115,3598,31,31,0,15.387
2116,9979,768,1479,-711,44.255
2117,5357,1435,3646,-2211,-836.058
2118,7993,1563,946,617,589.109
2119,12586,9814,25255,-15441,-6677.151
2120,5993,30,21,9,-25.52
2121,10969,1308,2311,-1003,-421.867
2122,12498,7,17,-10,-5.979
2123,10444,131,131,0,434.299
2124,2072,2701,7850,-5149,487.628
2125,2843,364,1198,-834,405.616
2126,3791,16,294,-278,-145.287
2127,896,1330,6404,-5074,-342.685
2128,4083,20,25,-5,-176.537
2129,3802,182,933,-751,-695.775
2130,4484,64,112,-48,5.453
2131,5025,8122,9814,-1692,-2101.658
2132,3529,2,4,-2,-1.901
2133,12553,1595,16002,-14407,-8209.73
2134,13109,9,45,-36,-91.8
2135,1899,108,126,-18,-163.063
2136,190,176,1327,-1151,-991.552
2137,15064,5409,3137,2272,652.121
2138,12244,99,14,85,-56.948
2139,15362,50,93,-43,3.013
2140,2205,5549,14346,-8797,1213.428
2141,12468,19,19,0,-9.708
2142,14878,430,214,216,-32.014
2143,10924,30,30,0,7.914
2144,6022,33,58,-25,-38.351
2145,2744,483,356,127,70.004
2146,10134,326,790,-464,1124.179
2147,6721,10,10,0,27.054
2148,14458,388,737,-349,-34.421
2149,11617,298,247,51,-49.72
2150,12304,74,26,48,22.59
2151,15416,99,43,56,-42.682
2152,663,9753,10070,-317,-369.392
2153,9924,3816,5472,-1656,-3679.166
2154,14111,344,130,214,12163.632
2155,10244,65,42,23,733.99
2156,4159,0,0,0,-183.006
2157,9437,2024,559,1465,-172.222
2158,12254,2384,1604,780,-277.766
2159,4592,36,194,-158,-1616.597
2160,12714,43,1598,-1555,-727.941
2161,14903,7,16,-9,-3.152
2162,13490,66467,55708,10759,553.389
2163,592,404,3005,-2601,-1481.112
2164,6879,9,9,0,0.537
2165,14285,32195,37127,-4932,19276.996
2166,7712,385,83,302,269.974
2167,14943,15,16,-1,3.036
2168,11242,605,626,-21,-1231.493
2169,3741,120,452,-332,-149.087
2170,2427,24,606,-582,117.316
2171,10098,1976,1336,640,435.793
2172,2206,12356,4688,7668,-1420.769
2173,2406,1371,1067,304,119.784
2174,6368,260,65,195,-98.839
2175,1389,1197,555,642,-3063.416
2176,9308,128,112,16,109.242
2177,1397,20780,9432,11348,879.346
2178,4637,5832,14168,-8336,-188.582
2179,373,442,748,-306,1128.429
2180,2182,2047,454,1593,178.031
2181,5853,7415,2233,5182,3650.677
2182,3980,297,193,104,-346.371
2183,13753,10007,18872,-8865,-1131.653
2184,9719,32,32,0,4.982
2185,14565,7836,7522,314,-81.328
2186,555,4593,3990,603,1193.692
2187,2984,2986,2107,879,486.598
2188,7084,211,91,120,-0.736
2189,6250,5794,10785,-4991,1239.614
2190,10790,1100,526,574,347.123
2191,2160,498,1890,-1392,32.011
2192,10526,40,64,-24,-135.732
2193,11593,424,432,-8,1580.82
2194,8119,714,50,664,-43.53
2195,6492,12485,16676,-4191,-2238.885
2196,9132,2528,2500,28,282.338
2197,10015,2017,3299,-1282,-1809.168
2198,8988,10366,5256,5110,-2565.751
2199,9104,871,1580,-709,1989.357
2200,9919,2080,2160,-80,-1273.252
2201,14719,7372,1721,5651,-539.965
2202,11875,23830,18238,5592,1481.488
2203,12280,95,129,-34,-243.543
2204,4182,15,15,0,-1.786
2205,3139,25,19,6,7.352
2206,3525,39,211,-172,-56.464
2207,10541,206,162,44,-5.221
2208,8049,1101,825,276,4.187
2209,9710,59,53,6,24.414
2210,13394,6432,12067,-5635,-13317.264
2211,15207,15,22,-7,-11.372
2212,6705,2,4,-2,0.009
2213,3574,8,11,-3,-0.579
2214,13227,39375,17881,21494,8710.296
2215,5861,3782,15237,-11455,-27759.931
2216,8462,11232,6170,5062,-15.714
2217,5736,24,24,0,66.825
2218,13377,8143,8349,-206,-6134.158
2219,3561,21,20,1,11.961
2220,2317,239,121,118,66.34
2221,1616,4066,651,3415,269.995
2222,3846,4260,1500,2760,-120.827
2223,12947,38,38,0,30.422
2224,8057,71,465,-394,27.865
2225,5263,885,1838,-953,-1717.306
2226,4510,5268,249,5019,1775.794
2227,7665,7,10,-3,-0.759
2228,10659,31,32,-1,15.389
2229,13046,31,55,-24,25.603
2230,11716,32,28,4,12.924
2231,3400,67,119,-52,78.095
2232,5380,6081,5758,323,-534.461
2233,12147,43,44,-1,-20.244
2234,3211,595,813,-218,5.649
2235,13939,4132,6204,-2072,-92.337
2236,4215,13,12,1,8.284
2237,7290,31,33,-2,-11.678
2238,12172,69,41,28,30.185
2239,9949,2119,2139,-20,302.397
2240,7795,42,4305,-4263,-253.601
2241,9311,1714,4690,-2976,-379.996
2242,8660,21,36,-15,-28.718
2243,12619,164,325,-161,59.067
2244,8820,5897,18194,-12297,-389.931
2245,10221,15,35,-20,239.232
2246,8949,9035,6579,2456,-7357.939
2247,7390,16,22,-6,-11.629
2248,9876,18,18,0,1.951
2249,11158,105,105,0,-264.82
2250,8205,3307,1742,1565,652.726
2251,11591,512,3661,-3149,1744.525
2252,10727,954,985,-31,-533.651
2253,9684,84,114,-30,-124.851
2254,4678,2957,7252,-4295,-974.585
2255,1290,17,32,-15,14.796
2256,861,2239,1077,1162,8.46
2257,13467,1139,918,221,-7.883
2258,8951,2910,5065,-2155,2548.781
2259,15467,327,1269,-942,-647.753
2260,13332,8504,13310,-4806,-4960.644
2261,6357,207,845,-638,-104.603
2262,11567,8769,16257,-7488,-1643.045
2263,783,353,3413,-3060,-3864.408
2264,10012,13701,3833,9868,194.375
2265,8625,45,61,-16,35.953
2266,5774,45,36,9,-5.574
2267,2014,6197,18743,-12546,-4201.585
2268,10324,72,64,8,14.49
2269,9406,1798,636,1162,-328.015
2270,8898,9764,8322,1442,2222.545
2271,160,2750,4228,-1478,-975.291
2272,15515,1001,144,857,278.943
2273,9080,647,2360,-1713,3165.866
2274,5879,14343,20093,-5750,-1832.845
2275,4578,5377,14702,-9325,-1759.404
2276,247,5459,1042,4417,1728.375
2277,7858,1917,1887,30,-992.56
2278,12713,173,149,24,-289.349
2279,2413,1295,101,1194,121.583
2280,626,4419,2773,1646,-729.308
2281,14154,4976,4049,927,690.523
2282,2039,4664,4861,-197,50.704
2283,8322,799,3599,-2800,-3313.776
2284,7476,12,12,0,-2.139
2285,8474,0,0,0,-14.493
2286,13168,33,34,-1,-54.362
2287,11984,11,11,0,4.856
2288,1619,2952,2449,503,149.344
2289,9261,13562,20983,-7421,-10645.373
2290,2050,15846,19620,-3774,96.618
2291,1260,65,65,0,82.488
2292,1576,51,51,0,147.237
2293,12913,555,505,50,234.108
2294,6588,5829,2069,3760,2023.316
2295,15081,2662,3264,-602,549.57
2296,735,9646,11290,-1644,-2742.711
2297,14307,745,154,591,23.58
2298,14175,25851,30319,-4468,-4907.877
2299,1131,54,8861,-8807,-4434.123
2300,9701,54,54,0,66.918
2301,3780,200,132,68,17.181
2302,6765,14,14,0,1.765
2303,7914,1315,1597,-282,58.13
2304,13376,3754,1536,2218,-7430.899
2305,463,3093,3506,-413,2034.954
2306,14596,340,216,124,-1042.263
2307,6242,208,55,153,-1149.109
2308,5221,9887,9104,783,-2545.109
2309,14727,23239,8951,14288,-759.921
2310,2654,12,606,-594,-442.164
2311,128,81,1513,-1432,-1383.596
2312,9241,2127,11078,-8951,-9566.213
2313,11467,339,87,252,2.367
2314,1364,12843,28111,-15268,-3459.865
2315,8126,92,162,-70,58.985
2316,12072,10,14,-4,-1.088
2317,7743,4109,502,3607,350.11
2318,3497,5,50,-45,615.134
2319,6050,162,24,138,52.444
2320,12479,4,4,0,0.896
2321,12344,152,118,34,-62.767
2322,5675,31,182,-151,-247.878
2323,11304,3,8,-5,-7.717
2324,5335,462,644,-182,-90.838
2325,3838,27,108,-81,1544.607
2326,1088,2270,3144,-874,-2254.902
2327,14066,5723,18647,-12924,728.442
2328,15370,6,17,-11,86.618
2329,6006,4,11,-7,-10.195
2330,7943,3,353,-350,-439.554
2331,11010,4040,999,3041,619.888
2332,14682,11,57,-46,75.897
2333,2970,2237,1467,770,1107.962
2334,5480,21824,21866,-42,-1555.213
2335,1064,1333,1758,-425,-5.374
2336,4569,602,4800,-4198,4351.676
2337,3556,17,17,0,0.105
2338,12555,33615,17636,15979,3510.738
2339,6632,3622,4727,-1105,-1501.422
2340,9513,391,453,-62,144.486
2341,11364,34,35,-1,11.13
2342,5971,71,49,22,296.179
2343,4525,19538,10624,8914,-564.598
2344,12813,51,1268,-1217,-1632.804
2345,2455,14,1996,-1982,-2218.133
2346,7546,80,64,16,18.362
2347,4347,25,26,-1,6.359
2348,5063,14584,9027,5557,4840.738
2349,3826,588,133,455,395.875
2350,1753,663,90,573,113.804
2351,533,2449,3780,-1331,-411.747
2352,7025,80,95,-15,-0.944
2353,4972,3695,3432,263,279.24
2354,11017,306,775,-469,-1153.882
2355,6352,42,42,0,69.748
2356,11884,14770,17435,-2665,688.404
2357,7194,8,8,0,0.065
2358,9228,19153,17848,1305,-13184.147
2359,7397,10,16,-6,-2.154
2360,5819,423,8664,-8241,-4469.809
2361,13439,5387,26346,-20959,-10325.467
2362,9765,22,22,0,-4.014
2363,8873,672,144,528,-184.753
2364,6731,14,17,-3,-0.113
2365,7925,365,1608,-1243,806.208
2366,11089,69,705,-636,-912.235
2367,5410,2060,11219,-9159,-11772.633
2368,3612,482,397,85,13.918
2369,2228,0,0,0,-92.302
2370,3320,53,30,23,0.889
2371,4226,157,35,122,84.381
2372,15265,42,42,0,2.921
2373,8836,3009,623,2386,644.494
2374,2986,121,334,-213,273.895
2375,15570,104,1606,-1502,-62.242
2376,7558,24,34,-10,0.444
2377,8446,11346,6158,5188,-137.086
2378,11734,242,41,201,15.373
2379,5257,7810,6947,863,1167.264
2380,2488,3840,3824,16,-829.725
2381,10841,46,117,-71,2298.899
2382,3274,0,0,0,-39.373
2383,11727,17,51,-34,-119.753
2384,11495,95,64,31,59.255
2385,8530,2675,2042,633,-1719.969
2386,11712,41,41,0,71.079
2387,10306,40,60,-20,-16.195
2388,6901,6,17,-11,-9.799
2389,15557,24,24,0,4.428
2390,9991,1047,7403,-6356,-931.952
2391,7277,43,184,-141,102.547
2392,8453,4382,7234,-2852,-921.114
2393,4768,53,53,0,269.031
2394,5890,1104,538,566,3330.121
2395,5827,23128,32977,-9849,96.2
2396,6434,7063,18885,-11822,-6480.615
2397,10239,167,344,-177,-305.871
2398,13705,6312,4429,1883,-1193.279
2399,10858,7639,284,7355,526.311
2400,8811,78,229,-151,-3416.213
2401,7648,3,5,-2,-11.608
2402,12822,184,2201,-2017,-1986.233
2403,4460,44,37,7,10.4
2404,4705,71,83,-12,551.348
2405,591,3728,5108,-1380,-1089.753
2406,1445,25765,17770,7995,-3.176
2407,10809,8073,513,7560,239.085
2408,12469,14,2,12,-0.282
2409,11198,80,80,0,270.477
2410,8969,7280,3075,4205,1765.611
2411,11838,8356,22538,-14182,-7925.803
2412,17,37,37,0,5.551
2413,14984,4,27,-23,-28.879
2414,11846,0,0,0,-112.414
2415,14950,13,17,-4,-6.768
2416,5537,33,33,0,105.352
2417,8281,94,146,-52,898.838
2418,15267,24,24,0,0.903
2419,12431,18,18,0,-4.4
2420,3285,441,270,171,57.274
2421,10229,30,39,-9,122.377
2422,5115,1503,2045,-542,-102.528
2423,10154,3656,4045,-389,-119.217
2424,3810,79,79,0,62.986
2425,8457,840,239,601,-242.97
2426,6251,29,2414,-2385,-3653.637
2427,5066,9207,31140,-21933,-5707.766
2428,15287,15,15,0,6.24
2429,7491,11,4,7,0.867
2430,14886,36,67,-31,229.279
2431,10387,15,18,-3,-1.783
2432,15487,226,1051,-825,325.765
2433,13975,591,113,478,131.55
2434,14481,74,47,27,-770.433
2435,1491,16843,13271,3572,-6049.23
2436,8552,18,18,0,-1743.984
2437,9287,4517,3167,1350,4502.806
2438,4811,173,760,-587,84.815
2439,14425,704,2194,-1490,-2275.407
2440,10649,6,50,-44,-164.195
2441,536,1242,465,777,3024.721
2442,5294,10415,8755,1660,-4471.732
2443,13391,5696,12446,-6750,-7964.446
2444,12399,233,138,95,1.818
2445,11249,365,706,-341,238.698
2446,10989,154,154,0,497.992
2447,14932,9,9,0,-0.128
2448,13091,2474,1424,1050,773.489
2449,3485,732,2068,-1336,-827.82
2450,2293,0,0,0,-98.403
2451,14499,837,1702,-865,170.352
2452,9538,8733,5388,3345,181.255
2453,15463,100,61,39,29.555
2454,3259,21,304,-283,-316.598
2455,6350,14,26,-12,-55.608
2456,5960,33,79,-46,-22.87
2457,11531,5829,32041,-26212,-9090.793
2458,12308,131,162,-31,-39.497
2459,8749,417,142,275,145.842
2460,10381,9,33,-24,-16.303
2461,5047,201,2434,-2233,-3571.774
2462,10488,386,394,-8,1671.737
2463,3282,56,363,-307,0.081
2464,9166,66,2666,-2600,-1490.407
2465,9504,4643,3259,1384,495.705
2466,10024,9389,11193,-1804,-3397.402
2467,13191,36,29,7,11.669
2468,10210,24,1320,-1296,-738.151
2469,6143,575,234,341,131.882
2470,5226,300,2327,-2027,-3907.32
2471,13066,30,58,-28,44.987
2472,11907,22,22,0,-3.122
2473,14847,921,831,90,15.2
2474,6978,368,204,164,-130.253
2475,15015,2836,3632,-796,1158.837
2476,6624,179,122,57,291.517
2477,4287,59,38,21,13.009
2478,12093,6,6,0,4.526
2479,5447,1388,2144,-756,-5746.052
2480,10479,266,193,73,-42.361
2481,4775,73,191,-118,-554.356
2482,11530,6637,2731,3906,2424.218
2483,4283,79,42,37,-81.708
2484,5456,12554,10050,2504,-2523.835
2485,6884,28,42,-14,9.128
2486,5697,83,83,0,113.631
2487,3103,11,10,1,-0.793
2488,5490,2537,9140,-6603,-328.36
2489,2327,229,191,38,72.199
2490,3175,20,23,-3,0.713
2491,6518,2613,3729,-1116,142.793
2492,7833,4242,1781,2461,693.971
2493,11154,0,0,0,-44.962
2494,13956,21880,32311,-10431,-7536.003
2495,8122,433,418,15,18.156
2496,4234,105,29,76,-46.341
2497,1085,3309,3198,111,-889.059
2498,12742,37,118,-81,-445.284
2499,5770,70,31,39,34.479
2500,547,1525,3297,-1772,-814.112
2501,3018,16,16,0,0.104
2502,11381,26,37,-11,27.897
2503,13678,44,59,-15,-59.265
2504,14876,21,23,-2,7.06
2505,13763,22341,5847,16494,14787.951
2506,1042,2214,1695,519,12.061
2507,2778,280,799,-519,-267.843
2508,1100,2697,2507,190,1214.729
2509,7896,2232,4553,-2321,8.962
2510,11751,32,32,0,5.8
2511,4938,6047,10794,-4747,259.986
2512,534,81,219,-138,-1107.275
2513,13700,171,171,0,-1090.988
2514,8868,206,2482,-2276,611.228
2515,11555,16635,49912,-33277,-13251.931
2516,312,10378,17033,-6655,-2627.873
2517,4015,87,321,-234,-109.135
2518,2346,342,507,-165,-33.778
2519,1784,57,1769,-1712,-489.172
2520,10529,9,13,-4,6.732
2521,1096,3218,3295,-77,-734.376
2522,13685,23,23,0,2.34
2523,2894,387,347,40,-1701.231
2524,10635,39,49,-10,13.971
2525,10725,2496,1464,1032,457.762
2526,5292,1270,599,671,-2766.152
2527,13211,30344,19534,10810,-17387.544
2528,3604,95,83,12,414.191
2529,2978,2729,8429,-5700,4114.861
2530,10532,22,99,-77,-38.267
2531,6262,1031,2376,-1345,-1250.558
2532,3309,48,63,-15,12.251
2533,3342,20,57,-37,45.674
2534,8127,53,346,-293,-198.393
2535,5354,7062,5020,2042,1294.345
2536,11947,25,72,-47,-27.789
2537,13768,31582,21199,10383,5829.607
2538,10392,13,21,-8,-5.235
2539,2379,4,4,0,-0.447
2540,1935,57,117,-60,-24.708
2541,6301,28,860,-832,-213.049
2542,237,75,559,-484,-34.345
2543,117,2786,3469,-683,228.222
2544,13202,7958,6735,1223,-751.176
2545,10981,116,1042,-926,-860.186
2546,7509,10,10,0,-0.982
2547,14631,23,23,0,23.915
2548,1013,25,1526,-1501,-4845.774
2549,451,1035,7739,-6704,-6197.386
2550,15170,1611,437,1174,-10.686
2551,10716,470,754,-284,2517.038
2552,13845,50837,48075,2762,-3678.442
2553,9834,23,1139,-1116,-407.425
2554,12939,146,29,117,130.784
2555,2219,503,902,-399,-754.532
2556,10176,119,141,-22,-221.807
2557,12964,51,51,0,123.512
2558,1970,124,124,0,-908.114
2559,10562,176,163,13,-3.292
2560,8408,2679,2012,667,-1683.679
2561,8360,2730,3811,-1081,209.5
2562,306,275,1353,-1078,753.394
2563,4108,116,150,-34,-14.366
2564,12247,39,392,-353,-153.721
2565,10911,689,390,299,133.284
2566,11853,173,4080,-3907,982.743
2567,14450,1777,796,981,-54.347
2568,3941,1165,313,852,81.759
2569,1560,11032,2905,8127,1873.887
2570,7451,8,8,0,-1.96
2571,14260,1526,50497,-48971,-32069.968
2572,9060,76,94,-18,61.492
2573,2644,1355,453,902,-17.226
2574,13669,21,51,-30,64.537
2575,6836,66,40,26,7.145
2576,2753,26,68,-42,-36.291
2577,5924,392,385,7,32.677
2578,13762,682,18846,-18164,-10731.408
2579,4383,140,39,101,-10.854
2580,15522,287,232,55,-361.608
2581,14748,1626,3470,-1844,-6938.488
2582,6591,46,6719,-6673,-4392.444
2583,8493,957,3360,-2403,-200.423
2584,470,11985,7755,4230,1900.24
2585,6567,150,1269,-1119,-33.543
2586,2700,18,18,0,-1.437
2587,6605,115,286,-171,235.174
2588,14772,11872,53435,-41563,-24971.012
2589,12573,413,3155,-2742,2741.705
2590,5290,0,0,0,-815.637
2591,5228,63,1225,-1162,-2363.203
2592,5557,20,287,-267,444.76
2593,9980,25,60,-35,851.266
2594,7309,24,26,-2,10.437
2595,3429,656,632,24,-298.061
2596,6710,14,21,-7,-1.667
2597,2326,25,25,0,9.773
2598,2795,15,11,4,-78.838
2599,13058,1520,1951,-431,786.681
2600,2713,728,87,641,131.859
2601,7012,4,4,0,-1.516
2602,7606,4,4,0,-2.175
2603,358,5632,16766,-11134,-6729.538
2604,2107,1070,2770,-1700,-65.127
2605,562,846,696,150,-641.528
2606,15367,570,1001,-431,-217.368
2607,14296,4428,50542,-46114,-29339.251
2608,10436,91,216,-125,-760.259
2609,5349,1078,1392,-314,448.449
2610,6545,31,31,0,-668.888
2611,2314,543,366,177,79.744
2612,1448,1593,13187,-11594,-1134.195
2613,3676,7,217,-210,-206.337
2614,11934,34,42,-8,-82.301
2615,11074,41,41,0,-850.689
2616,15190,583,983,-400,1143.801
2617,5291,3377,4800,-1423,812.256
2618,2005,12624,1008,11616,2091.02
2619,3888,4308,1692,2616,697.76
2620,13986,350,79,271,-268.376
2621,1066,2,165,-163,-2431.72
2622,6736,7,10,-3,-1.578
2623,5192,25,161,-136,1326.091
2624,11146,7592,6867,725,1435.553
2625,7316,24,23,1,5.557
2626,9049,193,489,-296,-388.321
2627,2110,276,700,-424,-553.882
2628,7919,329,594,-265,-337.223
2629,5638,601,1237,-636,46.712
2630,13593,795,332,463,-1145.663
2631,3235,71,36,35,-44.871
2632,15297,16,16,0,5.422
2633,11399,37,37,0,52.493
2634,5536,162,243,-81,302.477
2635,4778,2232,656,1576,2020.586
2636,12906,48,791,-743,-810.356
2637,399,2281,6175,-3894,-4113.836
2638,13113,4,109,-105,-9.619
2639,282,1264,1207,57,1969.829
2640,5763,14,14,0,4.76
2641,72,20,53,-33,-43.577
2642,9478,26,26,0,-163.714
2643,5773,19,36,-17,-7.476
2644,15102,68,152,-84,44.259
2645,9379,0,0,0,-301.46
2646,10714,195,259,-64,-143.555
2647,11047,9745,6764,2981,1317.25
2648,10419,26,29,-3,145.776
2649,4842,2343,3820,-1477,570.576
2650,683,2242,3579,-1337,-143.329
2651,12968,200,216,-16,101.692
2652,1535,34044,8539,25505,1883.608
2653,5885,3232,4319,-1087,1028.467
2654,5772,627,355,272,137.239
2655,992,219,219,0,1687.449
2656,120,2561,2612,-51,369.625
2657,12274,163,388,-225,472.332
2658,191,2580,1889,691,-1221.003
2659,10208,41,46,-5,273.281
2660,1174,11352,27415,-16063,197.762
2661,4536,902,239,663,1155.567
2662,1135,93,93,0,-318.399
2663,12213,641,1518,-877,-232.694
2664,8013,179,642,-463,-809.321
2665,1824,46,47,-1,-4.474
2666,2598,8069,6402,1667,532.877
2667,1477,3448,7634,-4186,-6093.422
2668,2247,1289,2307,-1018,-2368.063
2669,4452,16,33,-17,-13.559
2670,3719,11,28,-17,-135.096
2671,8975,4599,5680,-1081,-4678.797
2672,9564,0,0,0,-49.896
2673,5728,81,48,33,0.244
2674,3737,427,521,-94,-97.841
2675,3051,5,24,-19,-17.835
2676,8840,756,498,258,277.89
2677,7934,2811,3299,-488,-1958.898
2678,5342,6183,8995,-2812,1610.998
2679,3021,14,18,-4,-0.521
2680,8244,66,66,0,176.45
2681,14234,1766,328,1438,3074.118
2682,15156,564,222,342,132.124
2683,5238,765,1183,-418,189.76
2684,13014,48,48,0,-234.058
2685,15550,63,181,-118,18.141
2686,11744,16,16,0,0.451
2687,9145,1111,2342,-1231,-1335.306
2688,11419,109,71,38,77.889
2689,10166,1353,340,1013,761.987
2690,15431,68,192,-124,142.106
2691,4191,76,113,-37,4.516
2692,4132,3,3,0,1.519
2693,13794,28092,11416,16676,1009.247
2694,15218,9,10,-1,-3.39
2695,1526,0,0,0,-180.234
2696,100,5682,9733,-4051,162.739
2697,2401,2214,3343,-1129,-301.621
2698,6694,10169,11416,-1247,98.145
2699,13679,42,42,0,-18.937
2700,12208,30,127,-97,536.505
2701,1897,134,134,0,851.89
2702,9253,16139,13848,2291,-2417.004
2703,8875,2024,1152,872,794.235
2704,1598,0,0,0,-123.247
2705,2595,170,316,-146,274.791
2706,1886,28,28,0,-44.049
2707,12009,14,27,-13,-14.836
2708,10371,8,18,-10,-11.538
2709,5860,8162,22743,-14581,-3235.712
2710,8283,335,222,113,69.501
2711,8456,3404,3550,-146,187.783
2712,12603,136,80,56,-74.218
2713,12284,35,816,-781,-1242.474
2714,3582,16,16,0,5.697
2715,2343,19,622,-603,-198.646
2716,11243,93,2454,-2361,-933.229
2717,7473,15,21,-6,10.44
2718,13297,565,16777,-16212,-9636.306
2719,14571,24,3370,-3346,-2708.08
2720,7772,5028,743,4285,836.218
2721,14053,2370,595,1775,2256.893
2722,8588,1976,579,1397,134.923
2723,1444,19324,11353,7971,-1051.93
2724,8491,1531,1167,364,-476.329
2725,2536,9197,10189,-992,3749.93
2726,9194,108,257,-149,248.891
2727,14070,755,1513,-758,-4120.604
2728,14560,99,228,-129,-87.131
2729,7195,25,20,5,3.498
2730,4034,15,15,0,10.762
2731,3484,129,82,47,44.418
2732,2991,28,1181,-1153,-799.995
2733,13734,682,682,0,1205.299
2734,9733,19,22,-3,-10.852
2735,14712,15370,23068,-7698,1732.646
2736,13580,1011,200,811,592.088
2737,8124,89,51,38,81.03
2738,6645,12148,20148,-8000,-1121.106
2739,7684,15,29,-14,-10.489
2740,6487,2991,1902,1089,2198.089
2741,11453,54,69,-15,2.71
2742,14389,189,50,139,-204.642
2743,10029,2844,6124,-3280,-5373.302
2744,2099,318,2037,-1719,-4741.714
2745,4087,270,57,213,-55.156
2746,8987,223,757,-534,-214.294
2747,1512,7,526,-519,255.308
2748,13948,10431,7363,3068,9.686
2749,11238,6,69,-63,36.476
2750,3739,88,59,29,-9.942
2751,2936,224,347,-123,325.852
2752,8752,2041,517,1524,583.445
2753,5015,35,2847,-2812,-2193.35
2754,12848,269,5306,-5037,-4033.403
2755,13452,47280,42864,4416,-3930.382
2756,11669,46,60,-14,18.285
2757,9474,7177,4590,2587,69.388
2758,7441,17,7,10,-0.173
2759,4551,6677,19169,-12492,48.445
2760,14568,0,0,0,1.335
2761,10523,47,44,3,-1.928
2762,14057,3597,5687,-2090,3307.008
2763,13173,23,43,-20,11.358
2764,5053,129,3658,-3529,-6850.491
2765,1335,13374,6896,6478,1591.304
2766,7879,5457,3670,1787,205.594
2767,15589,16,16,0,113.83
2768,12880,893,6047,-5154,-4887.76
2769,3145,26,26,0,2.336
2770,5259,3810,7358,-3548,485.227
2771,4082,574,723,-149,-42.764
2772,7893,536,487,49,-54.296
2773,14930,12,12,0,0.856
2774,11212,1701,444,1257,384.411
2775,7871,4986,4499,487,-442.411
2776,13564,90,90,0,-3979.993
2777,5797,166,57,109,37.106
2778,7042,126,26,100,9.188
2779,11295,264,841,-577,-1021.929
2780,4933,429,683,-254,1336.519
2781,13122,5,5,0,3.393
2782,758,460,6033,-5573,-5704.846
2783,3114,8,35,-27,-5.687
2784,14632,121,209,-88,-12.694
2785,5685,24,24,0,35.083
2786,3473,239,635,-396,91.702
2787,3968,879,1735,-856,247.431
2788,5583,239,114,125,304.781
2789,4662,6824,6546,278,1817.193
2790,2982,394,322,72,-2545.653
2791,1177,10941,1257,9684,-747.002
2792,14924,7,7,0,2.131
2793,12265,1121,612,509,325.567
2794,4994,4355,12166,-7811,-1185.415
2795,3568,33,33,0,2.459
2796,9208,3141,9110,-5969,-8696.736
2797,5144,53,53,0,1538.283
2798,8819,1372,3919,-2547,-4738.436
2799,2658,65,457,-392,-419.014
2800,15440,58,212,-154,-21.88
2801,5158,1414,3670,-2256,89.315
2802,11344,31,33,-2,-88.182
2803,10106,1205,5261,-4056,189.606
2804,6839,8,17,-9,-52.444
2805,13832,29,8431,-8402,-11608.149
2806,14615,14,66,-52,-35.422
2807,2937,171,98,73,-1090.026
2808,2350,14,311,-297,-86.159
2809,770,0,0,0,-170.051
2810,8418,2034,6114,-4080,39.95
2811,14447,1148,3427,-2279,20.906
2812,10181,60,141,-81,-787.229
2813,7756,5371,519,4852,538.743
2814,2093,16912,10380,6532,1119.187
2815,11802,4778,2988,1790,-2239.663
2816,7070,29,36,-7,-4.593
2817,14278,1111,503,608,4098.634
2818,8497,6091,10883,-4792,-46.833
2819,3770,641,131,510,-169.228
2820,3209,1157,557,600,17.923
2821,12369,399,63,336,14.142
2822,2018,13909,15081,-1172,-3065.211
2823,6910,7,44,-37,-65.692
2824,14476,1141,3497,-2356,-31.433
2825,3317,16,52,-36,96.254
2826,8574,28,2193,-2165,-2246.825
2827,10677,100,29,71,-29.055
2828,11001,303,363,-60,773.016
2829,11647,63,41,22,-3.487
2830,12249,1961,1367,594,242.926
2831,2850,249,212,37,-297.495
2832,12744,611,136,475,181.03
2833,11331,28,28,0,23.514
2834,9770,35,35,0,-90.083
2835,7231,15,15,0,-108.777
2836,5430,11660,10983,677,-3037.202
2837,8015,419,834,-415,-17.269
2838,13899,22280,23948,-1668,-4308.876
2839,13056,1950,1433,517,387.493
2840,13745,2433,5099,-2666,-7569.96
2841,2612,31,31,0,15.907
2842,11926,5,19,-14,-6.043
2843,1661,76,76,0,108.802
2844,15540,186,1850,-1664,338.824
2845,10368,64,43,21,11.454
2846,10763,488,117,371,69.628
2847,14128,5790,9875,-4085,-2694.427
2848,12132,44,30,14,-7.567
2849,4843,159,2598,-2439,-1759.328
2850,11612,121,181,-60,-152.934
2851,5223,4008,5870,-1862,-1510.613
2852,12079,6,18,-12,-8.051
2853,1090,4038,3364,674,-131.51
2854,9889,39,39,0,653.891
2855,10598,19,38,-19,-77.347
2856,15172,96,84,12,139.863
2857,8584,5632,2566,3066,-2026.684
2858,13145,22,28,-6,51.2
2859,3728,28,71,-43,-79.013
2860,7629,2,4,-2,-1.536
2861,10048,4181,5622,-1441,-7290.27
2862,12606,486,560,-74,-384.571
2863,12130,66,52,14,0.588
2864,4139,137,179,-42,14.189
2865,12618,788,154,634,120.927
2866,10099,475,105,370,-1206.904
2867,3735,32,18,14,17.663
2868,7162,91,4,87,-3.066
2869,443,1428,2726,-1298,-1133.873
2870,6109,62,92,-30,-226.829
2871,8313,6421,8201,-1780,1645.362
2872,4952,2484,1029,1455,-2406.918
2873,1022,1792,449,1343,1206.571
2874,13779,734,889,-155,-8561.334
2875,13803,51601,77030,-25429,-12984.899
2876,10813,759,1056,-297,-55.203
2877,802,1244,2632,-1388,-3795.793
2878,5174,43,73,-30,204.648
2879,3013,43,24,19,11.729
2880,1268,27,1194,-1167,-680.109
2881,12031,14,13,1,-0.788
2882,6786,18,20,-2,2.865
2883,15586,30,69,-39,-184.348
2884,1333,7932,18502,-10570,-4554.875
2885,1474,26349,10663,15686,-1455.67
2886,15268,24,27,-3,44.832
2887,11749,36,12,24,-0.053
2888,6758,13,17,-4,4.365
2889,10527,191,253,-62,-21.526
2890,2212,13296,8369,4927,-450.797
2891,5479,1932,3048,-1116,-1291.943
2892,12424,9,9,0,-1.89
2893,6807,5,5,0,-5.925
2894,5018,6781,18271,-11490,-1445.0
2895,707,14613,22137,-7524,-667.943
2896,11417,64,105,-41,-20.139
2897,9242,4459,9565,-5106,-10170.714
2898,2954,275,346,-71,-238.491
2899,8029,107,107,0,120.116
2900,2283,24,2371,-2347,-5085.241
2901,140,169,3581,-3412,-37.116
2902,6385,34,34,0,-11.913
2903,1929,64,64,0,-447.173
2904,6222,5802,3337,2465,1047.632
2905,12229,42,101,-59,-27.434
2906,13218,37572,39230,-1658,-6206.283
2907,6841,2,13,-11,-7.545
2908,3613,38,133,-95,-0.464
2909,11260,322,3237,-2915,-110.056
2910,12482,17,14,3,8.615
2911,7852,3493,1748,1745,1018.209
2912,8382,21,413,-392,-146.728
2913,14298,0,0,0,-3824.54
2914,9473,1439,4847,-3408,-1640.789
2915,3987,686,1665,-979,-2284.769
2916,13842,64136,51226,12910,-9637.066
2917,3727,134,81,53,66.603
2918,4808,2099,2080,19,-44.398
2919,8954,17040,6693,10347,2226.405
2920,8785,2742,3037,-295,128.977
2921,745,106,128,-22,49.821
2922,12578,20350,41807,-21457,-3978.474
2923,3986,1984,1633,351,141.73
2924,14734,2466,9232,-6766,2642.893
2925,7504,40,54,-14,-3.756
2926,8804,9701,13879,-4178,292.401
2927,9090,113,257,-144,545.123
2928,2636,65,101,-36,2.669
2929,7253,31,54,-23,22.887
2930,7952,482,442,40,463.028
2931,5120,1627,5745,-4118,-2599.997
2932,12182,76,39,37,25.38
2933,2780,47,47,0,-39.751
2934,13910,21780,33839,-12059,-9444.314
2935,6359,28,132,-104,-45.904
2936,9140,3249,3664,-415,1293.99
2937,10808,141,306,-165,1256.274
2938,2746,37,128,-91,-21.804
2939,15420,710,873,-163,81.639
2940,1312,1335,18497,-17162,-6507.364
2941,12379,68,23,45,-1.021
2942,9074,143,143,0,555.262
2943,13133,14,14,0,-9.932
2944,7238,92,124,-32,310.203
2945,6292,151,47,104,538.625
2946,12889,8145,4358,3787,449.307
2947,8611,26,42,-16,-5.914
2948,7136,6,1,5,-27.12
2949,13129,30,500,-470,-224.744
2950,8662,24,26,-2,26.093
2951,8265,84,1103,-1019,-25.901
2952,10876,229,204,25,170.377
2953,6184,971,1379,-408,-803.483
2954,1424,1118,846,272,57.435
2955,8136,32,41,-9,-10.519
2956,6996,164,107,57,-4.402
2957,15526,24,24,0,285.775
2958,11639,52,48,4,37.307
2959,3072,14,14,0,2.524
2960,9582,13,13,0,-1139.445
2961,4302,14,128,-114,-53.725
2962,14845,29,37,-8,10.766
2963,15072,14653,8814,5839,5066.61
2964,11832,26269,24697,1572,1490.735
2965,15052,11523,3607,7916,-3221.249
2966,3742,29,156,-127,-2.487
2967,13260,29586,18960,10626,-6740.488
2968,4738,54,2066,-2012,-454.499
2969,4858,514,2941,-2427,-109.377
2970,10721,8033,987,7046,-140.035
2971,12775,29,252,-223,-16.203
2972,876,3520,3295,225,-141.115
2973,6670,66,5132,-5066,-4380.994
2974,4315,68,63,5,49.544
2975,5611,6,25,-19,-32.981
2976,8712,952,3314,-2362,-2034.27
2977,13607,29,29,0,55.621
2978,7880,7,84,-77,-920.342
2979,3093,26,30,-4,10.115
2980,1392,124,8132,-8008,-1200.41
2981,7210,165,199,-34,246.647
2982,10066,13556,7594,5962,-727.732
2983,9914,532,1725,-1193,-618.77
2984,14815,55,65,-10,-175.363
2985,8330,1582,4588,-3006,-2521.497
2986,9247,6003,5029,974,-999.8
2987,14015,1001,378,623,183.804
2988,1437,19682,18056,1626,-311.181
2989,6957,51,234,-183,-16.158
2990,3633,922,179,743,-26.376
2991,11930,8,8,0,6.876
2992,1874,45,45,0,29.139
2993,3647,55,52,3,11.591
2994,8076,45,47,-2,-1.786
2995,3813,549,963,-414,2121.909
2996,254,3456,1305,2151,-1164.508
2997,13454,19985,2633,17352,5415.536
2998,14437,1149,419,730,-145.423
2999,9360,507,1378,-871,-662.852
3000,13657,38,61,-23,7.89
3001,169,181,85,96,-1277.076
3002,13022,104,1696,-1592,48.679
3003,1035,114,95,19,-228.132
3004,15134,46,116,-70,-3.241
3005,1528,1223,9797,-8574,-3364.08
3006,1450,1458,1975,-517,32.299
3007,3061,22,25,-3,-21.148
3008,13100,48,48,0,42.688
3009,13043,55,167,-112,62.041
3010,11498,108,105,3,554.238
3011,9148,580,5272,-4692,-3265.901
3012,5163,876,220,656,-444.63
3013,10848,125,122,3,-11.521
3014,4552,8,8,0,593.478
3015,9456,857,6434,-5577,-1910.719
3016,12646,57,57,0,138.565
3017,3045,22,27,-5,8.171
3018,5008,63,63,0,2186.058
3019,8104,678,28,650,162.201
3020,15579,352,746,-394,-191.844
3021,6237,2952,6236,-3284,-3881.383
3022,3263,7,13,-6,-45.808
3023,6831,47,24,23,4.799
3024,8857,105,172,-67,481.724
3025,12481,19,21,-2,4.317
3026,6769,11,11,0,4.336
3027,6673,2010,10076,-8066,-6518.851
3028,11457,2062,140,1922,391.524
3029,3492,39,2344,-2305,-1386.196
3030,7969,19,1358,-1339,-1476.068
3031,869,20,39,-19,162.071
3032,3814,1666,502,1164,453.889
3033,11209,307,72,235,431.487
3034,9790,18,39,-21,-14.648
3035,886,3449,3273,176,-1112.887
3036,4422,12,21,-9,-9.312
3037,7380,5,27,-22,-28.484
3038,13061,9,9,0,-881.294
3039,11182,0,0,0,-18.205
3040,2932,1506,3425,-1919,379.271
3041,8069,772,1741,-969,-223.937
3042,807,4651,2430,2221,-377.445
3043,1517,2600,7235,-4635,-389.858
3044,11026,6612,9300,-2688,1254.02
3045,5381,13008,13011,-3,-1071.423
3046,8227,65,115,-50,146.464
3047,10750,47,193,-146,2014.367
3048,2071,67,67,0,1433.118
3049,5378,15,735,-720,-1841.37
3050,8529,5252,3973,1279,79.78
3051,10059,360,1097,-737,-2386.771
3052,7638,5,5,0,13.954
3053,12231,64,209,-145,-87.299
3054,8624,19,22,-3,-1.468
3055,12550,663,243,420,925.614
3056,10308,24,30,-6,-0.131
3057,10000,8284,1795,6489,4223.559
3058,2174,121,115,6,192.978
3059,6802,9,12,-3,-3.896
3060,6254,10820,6233,4587,-3097.509
3061,4807,1672,1611,61,-85.971
3062,12230,39,36,3,77.199
3063,9740,38,38,0,205.657
3064,15566,26,42,-16,89.463
3065,9256,6,3283,-3277,-6688.356
3066,10803,277,1050,-773,-652.129
3067,11900,11,42,-31,-14.05
3068,8670,32,65,-33,153.712
3069,3055,42,23,19,-2.673
3070,1792,20,135,-115,5.958
3071,14764,45968,59391,-13423,-8801.056
3072,10314,47,64,-17,-18.345
3073,12755,21,217,-196,52.21
3074,273,71,13406,-13335,-1456.127
3075,9840,412,617,-205,235.82
3076,2827,1250,379,871,-345.42
3077,6491,114,114,0,126.402
3078,7064,19,11,8,-5.595
3079,3691,232,112,120,182.202
3080,15331,287,645,-358,-137.456
3081,8333,3328,6100,-2772,-38.909
3082,12729,7,267,-260,-129.382
3083,5340,114,276,-162,-790.737
3084,4468,2,4,-2,-5.995
3085,71,55,55,0,92.784
3086,6173,4655,3650,1005,-1343.117
3087,8056,789,966,-177,85.088
3088,10282,67,67,0,57.076
3089,1763,1470,188,1282,50.414
3090,10088,11305,13826,-2521,3055.092
3091,12988,530,79,451,467.245
3092,9940,1374,6775,-5401,-74.817
3093,5620,2925,3442,-517,168.323
3094,13358,2212,6099,-3887,517.05
3095,4948,120,2942,-2822,434.219
3096,12142,13,17,-4,-1.548
3097,5781,170,75,95,41.368
3098,13524,21230,5602,15628,208.73
3099,3245,1152,959,193,-66.699
3100,11282,31,143,-112,-912.21
3101,3318,7,33,-26,-36.325
3102,6230,8093,6482,1611,-115.188
3103,61,14,14,0,0.048
3104,2539,2062,3378,-1316,241.468
3105,794,25669,23901,1768,1528.397
3106,1672,85,360,-275,703.179
3107,1796,38,38,0,27.028
3108,42,9,2,7,-1.822
3109,1300,12401,8630,3771,2230.781
3110,12826,1635,7397,-5762,-3272.309
3111,7227,19,23,-4,-2.317
3112,3223,7,382,-375,-245.05
3113,1658,105,126,-21,325.118
3114,10707,414,202,212,671.43
3115,6415,22818,12905,9913,2783.478
3116,13495,0,0,0,-567.043
3117,11293,40,40,0,123.922
3118,4523,134,127,7,450.938
3119,5922,19,357,-338,-53.493
3120,9480,2997,4602,-1605,-441.495
3121,7641,13,14,-1,-5.796
3122,4314,29,50,-21,15.227
3123,4763,53,105,-52,231.983
3124,11006,11428,2024,9404,-656.633
3125,14186,7207,4277,2930,5195.722
3126,1869,117,117,0,-768.036
3127,14749,77921,19310,58611,8926.089
3128,2908,65,1339,-1274,-748.672
3129,6077,22,22,0,2.002
3130,8176,16,22,-6,-24.27
3131,3610,205,974,-769,73.267
3132,5382,3398,1830,1568,269.835
3133,15184,53,698,-645,-869.307
3134,11775,20,17,3,2.679
3135,9093,68,329,-261,999.385
3136,318,18946,22342,-3396,921.903
3137,11262,619,638,-19,259.339
3138,6696,1317,4539,-3222,-179.005
3139,11309,53,53,0,254.045
3140,9361,9527,9163,364,-789.761
3141,386,2106,3728,-1622,304.841
3142,13368,7136,8643,-1507,441.784
3143,3600,19,72,-53,-31.034
3144,5041,180,7896,-7716,-5454.998
3145,15466,134,163,-29,57.899
3146,9359,4127,4224,-97,-183.496
3147,8293,22,30,-8,90.293
3148,7011,26,24,2,6.223
3149,2878,423,554,-131,86.884
3150,5334,5570,5248,322,-1399.934
3151,8210,378,171,207,455.865
3152,4430,3,14,-11,-1.527
3153,3428,259,689,-430,-326.746
3154,11738,8,21,-13,-7.677
3155,5995,1660,247,1413,1.184
3156,4095,171,491,-320,-156.298
3157,5935,84,84,0,-6.376
3158,7923,840,3788,-2948,171.005
3159,12397,1,1,0,-36.188
3160,10006,3277,3599,-322,1448.14
3161,1247,907,602,305,118.239
3162,12186,4,4,0,-20.302
3163,14780,2739,2856,-117,-264.204
3164,14959,90,18,72,18.756
3165,4384,68,143,-75,42.177
3166,8831,2975,698,2277,-1235.664
3167,13112,15,19,-4,8.496
3168,13453,26029,18248,7781,-12102.259
3169,2123,411,881,-470,50.955
3170,5745,157,54,103,16.505
3171,14633,36,36,0,40.166
3172,11422,150,79,71,-77.909
3173,12667,1293,218,1075,14.188
3174,1463,4391,6764,-2373,-2580.26
3175,4632,12364,7040,5324,-2947.556
3176,1441,1114,2291,-1177,-7324.628
3177,13780,19465,6884,12581,2997.839
3178,10925,1562,6293,-4731,-277.016
3179,1688,1672,2958,-1286,415.084
3180,6580,86,272,-186,144.545
3181,6130,4450,3095,1355,-206.354
3182,6687,5861,4500,1361,1376.361
3183,7910,361,89,272,653.104
3184,1548,287,16447,-16160,-3058.366
3185,845,2146,7274,-5128,-9013.472
3186,1621,1398,2451,-1053,-176.025
3187,7095,13,13,0,1.1
3188,2436,105,2547,-2442,-1690.639
3189,3067,15,26,-11,-2.39
3190,7557,67,28,39,14.488
3191,15411,986,562,424,141.149
3192,406,1626,1084,542,-3112.218
3193,1786,37,126,-89,42.059
3194,1645,138,107,31,349.144
3195,11164,6001,5087,914,6.56
3196,21,19,19,0,28.557
3197,12326,34,29,5,10.24
3198,4796,206,982,-776,629.359
3199,3692,69,69,0,-35.235
3200,13305,19269,17221,2048,1139.072
3201,15320,79,48,31,50.009
3202,11403,25,124,-99,-216.63
3203,7483,13,10,3,1.307
3204,14831,19,33,-14,22.223
3205,9040,2230,451,1779,-34.304
3206,221,211,443,-232,-44.048
3207,192,3454,2916,538,-117.583
3208,12643,33,150,-117,159.64
3209,3896,732,1602,-870,79.357
3210,14181,16631,6704,9927,-465.814
3211,13299,6102,1036,5066,-160.698
3212,4597,4170,4741,-571,-1305.154
3213,2663,111,614,-503,-112.562
3214,2203,8085,8406,-321,3245.612
3215,4825,2689,4749,-2060,556.118
3216,2734,27,34,-7,-113.904
3217,5896,23985,1655,22330,-3338.237
3218,7671,15,13,2,1.998
3219,5522,31,30,1,58.311
3220,7667,4,4,0,-0.286
3221,10513,30,54,-24,-60.541
3222,13838,16664,17110,-446,-3465.111
3223,5606,105,123,-18,613.368
3224,10522,32,80,-48,-78.789
3225,1464,12847,16335,-3488,582.775
3226,1204,280,289,-9,-185.966
3227,11554,94,5361,-5267,-5804.962
3228,1975,193,142,51,722.841
3229,12737,1975,2224,-249,-541.948
3230,13513,3699,349,3350,-1002.325
3231,5,63,41,22,3.915
3232,10063,6953,9944,-2991,984.027
3233,9558,261,668,-407,-27.861
3234,630,9892,16252,-6360,-792.084
3235,11189,11790,6761,5029,415.886
3236,1938,66,75,-9,97.767
3237,4333,20,20,0,-6.543
3238,5082,7628,19357,-11729,-3309.866
3239,923,2172,273,1899,1412.647
3240,8305,546,2135,-1589,-2602.224
3241,11069,8096,4656,3440,2989.528
3242,11697,26,63,-37,-143.681
3243,9207,24542,23240,1302,2204.8
3244,11638,162,62,100,59.653
3245,1051,1902,2380,-478,-32.93
3246,7047,61,57,4,69.034
3247,15468,160,202,-42,204.335
3248,7811,1305,4873,-3568,-105.957
3249,8641,43,43,0,10.752
3250,14620,27,26,1,40.432
3251,8108,26,26,0,19.129
3252,8268,41,44,-3,68.325
3253,1507,0,0,0,-324.819
3254,11866,13190,5246,7944,-4620.224
3255,4148,11,11,0,-0.421
3256,7636,8,8,0,-0.239
3257,3198,20,52,-32,3.147
3258,10104,920,2350,-1430,-174.23
3259,10905,677,236,441,455.838
3260,14616,7,30,-23,72.273
3261,7581,138,87,51,0.516
3262,3707,173,51,122,9.819
3263,8128,9,15,-6,140.612
3264,9438,902,982,-80,-955.742
3265,12020,27,27,0,6.609
3266,174,21,170,-149,-2081.443
3267,4958,7166,6784,382,1226.714
3268,5351,1714,1739,-25,-1813.262
3269,9939,2934,1176,1758,1015.912
3270,1060,33,41,-8,60.307
3271,14323,2108,1830,278,-799.558
3272,298,201,506,-305,-110.714
3273,6312,22,22,0,2.097
3274,14282,106,429,-323,-766.187
3275,15472,1420,851,569,-52.224
3276,11133,10056,5810,4246,-923.587
3277,11570,6061,42257,-36196,-21503.812
3278,12866,0,0,0,-444.171
3279,14921,16,16,0,8.434
3280,1664,53,53,0,34.37
3281,4011,275,335,-60,-144.872
3282,4950,112,257,-145,-319.556
3283,4906,3,669,-666,-1311.46
3284,3076,6,8,-2,-0.354
3285,12782,40,1369,-1329,-1235.51
3286,13998,2358,450,1908,1035.289
3287,13930,18768,18097,671,-2392.264
3288,3434,45,45,0,80.093
3289,11471,223,71,152,67.093
3290,139,58,72,-14,-454.297
3291,12790,1284,1110,174,-106.136
3292,12414,4,4,0,0.427
3293,14909,9,2,7,-2.381
3294,6226,2933,3841,-908,-1058.964
3295,11195,14822,10144,4678,1397.861
3296,1913,80,137,-57,110.701
3297,1759,116,74,42,285.11
3298,6450,18242,21385,-3143,-1481.502
3299,15215,28,28,0,-21.322
3300,11659,33,25,8,77.519
3301,1639,44,44,0,-150.56
3302,9465,1176,663,513,-302.637
3303,11064,10437,4681,5756,-275.098
3304,12533,1076,7583,-6507,-6443.82
3305,940,1502,4400,-2898,3426.157
3306,15599,20,29,-9,42.632
3307,13188,90,61,29,-15.089
3308,2531,3930,4968,-1038,-2813.905
3309,14672,2040,58,1982,24.548
3310,6799,7,7,0,3.625
3311,15121,36,36,0,-56.637
3312,9469,3999,2985,1014,-448.164
3313,2825,15,2751,-2736,-1565.316
3314,10280,77,25,52,61.751
3315,1746,40,85,-45,265.478
3316,6660,6328,14207,-7879,-8445.639
3317,11677,199,298,-99,52.555
3318,4974,1704,799,905,983.659
3319,4513,529,2367,-1838,74.238
3320,4103,21,123,-102,-14.691
3321,10078,8007,10981,-2974,-56.103
3322,9806,412,1339,-927,118.598
3323,13206,9949,14846,-4897,2763.51
3324,14240,1721,44119,-42398,-31565.675
3325,9911,1507,1065,442,-1500.799
3326,39,30,30,0,-5.69
3327,11540,85,85,0,327.175
3328,4964,2518,14175,-11657,-7147.868
3329,14152,4480,9798,-5318,-7715.224
3330,3822,194,1664,-1470,491.247
3331,14549,81,472,-391,-125.285
3332,2426,1337,2073,-736,308.686
3333,5582,442,105,337,231.232
3334,7561,9,18,-9,-37.681
3335,4379,66,25,41,-2.985
3336,6641,1348,232,1116,1145.592
3337,3232,335,892,-557,-262.332
3338,6675,1237,7352,-6115,-8543.977
3339,304,92,86,6,-2743.913
3340,5216,909,333,576,92.512
3341,5130,65,224,-159,1581.209
3342,1980,130,130,0,326.424
3343,5776,18,25,-7,-19.737
3344,10413,2130,3106,-976,17.586
3345,15328,85,358,-273,25.452
3346,12081,5,2,3,0.791
3347,14710,24,31706,-31682,-11702.92
3348,11217,34,47,-13,118.389
3349,8019,26,26,0,-38.206
3350,15494,27,1487,-1460,-234.497
3351,8682,42,42,0,36.006
3352,8252,903,170,733,517.071
3353,5011,386,768,-382,2251.427
3354,13568,54,323,-269,-5324.352
3355,11943,16,16,0,2.107
3356,3461,1358,349,1009,-346.071
3357,6734,11,1,10,4.338
3358,12080,13,16,-3,0.845
3359,11509,32639,52516,-19877,3109.917
3360,8285,2592,205,2387,754.41
3361,218,81,209,-128,-107.56
3362,13300,30311,24392,5919,-3638.547
3363,10976,280,334,-54,300.656
3364,4644,1274,4242,-2968,-2023.802
3365,6637,1463,3535,-2072,-618.241
3366,5489,20104,22725,-2621,446.483
3367,9760,46,46,0,-57.154
3368,3651,59,59,0,3.947
3369,14737,7326,30991,-23665,2580.354
3370,10617,21,21,0,0.622
3371,1853,100,188,-88,119.44
3372,4441,13,13,0,-0.797
3373,3234,0,0,0,-50.324
3374,1615,658,495,163,100.572
3375,1549,18,1844,-1826,-4498.59
3376,4203,13,13,0,-6.943
3377,76,68,68,0,7.879
3378,2251,7995,10240,-2245,3692.289
3379,13967,0,0,0,-830.974
3380,2721,36,48,-12,-180.7
3381,5599,49,110,-61,-29.196
3382,1176,112,4248,-4136,-838.831
3383,11658,440,75,365,16.407
3384,1027,2709,2398,311,-34.195
3385,182,5462,2574,2888,2341.975
3386,12768,1833,2778,-945,-155.092
3387,11673,136,505,-369,-20.914
3388,13006,71,2711,-2640,-347.25
3389,7715,68,46,22,115.606
3390,5543,2084,142,1942,-291.916
3391,11691,10,10,0,4.569
3392,13380,117,139,-22,-3849.681
3393,12146,13,44,-31,-72.894
3394,6285,836,4410,-3574,-1170.631
3395,12372,52,70,-18,-92.46
3396,5601,41,274,-233,53.457
3397,8878,10932,3202,7730,-864.415
3398,15187,60,58,2,70.537
3399,10571,34,37,-3,-32.484
3400,8059,288,94,194,-3.469
3401,5145,53,194,-141,1297.155
3402,4463,41,51,-10,-35.568
3403,15504,300,886,-586,84.73
3404,6969,374,177,197,8.003
3405,13482,5106,6444,-1338,440.738
3406,12345,27,27,0,-2.025
3407,6311,26,54,-28,2.922
3408,576,8881,7510,1371,106.413
3409,12904,941,960,-19,147.499
3410,13891,18623,37855,-19232,-22783.227
3411,6665,841,4693,-3852,-3850.072
3412,8258,107,331,-224,168.594
3413,15490,158,438,-280,184.912
3414,10289,40,101,-61,123.433
3415,13985,22913,23141,-228,-5407.535
3416,11448,85,587,-502,203.806
3417,2809,4234,5268,-1034,33.535
3418,5986,45,45,0,107.889
3419,8745,44,252,-208,-34.385
3420,5740,92,199,-107,-35.971
3421,4743,174,174,0,1002.09
3422,6321,56,56,0,5.341
3423,7646,6,12,-6,-0.498
3424,8253,110,102,8,37.715
3425,2180,38,86,-48,-207.146
3426,5698,649,1436,-787,46.288
3427,13609,63,70,-7,-30.173
3428,5161,882,3808,-2926,-14.803
3429,5942,29,38,-9,106.046
3430,6313,38,379,-341,-32.622
3431,972,935,1106,-171,1158.227
3432,14392,3545,1607,1938,331.027
3433,1091,1310,1522,-212,-964.742
3434,11316,13,13,0,13.309
3435,7624,5,6,-1,-3.351
3436,5724,37,42,-5,9.003
3437,1603,114,104,10,193.436
3438,14821,51,52,-1,118.22
3439,14888,140,55,85,-120.821
3440,8432,1543,1625,-82,243.515
3441,3912,471,1148,-677,-1035.527
3442,7604,10,11,-1,-4.784
3443,9070,4581,219,4362,1321.554
3444,10870,72,105,-33,-518.054
3445,2924,3983,5309,-1326,-945.017
3446,11820,4417,11837,-7420,-12288.774
3447,4388,49,46,3,2.571
3448,14374,4,210,-206,-783.737
3449,9722,28,112,-84,71.061
3450,9239,551,9357,-8806,-15193.017
3451,6939,370,95,275,13.219
3452,10167,6804,5825,979,545.99
3453,11955,20,20,0,-0.593
3454,10191,2895,988,1907,813.504
3455,14718,51195,55552,-4357,-4075.754
3456,9439,1698,815,883,185.825
3457,8400,817,3409,-2592,-1955.27
3458,3828,6499,1446,5053,680.653
3459,2024,11403,11134,269,7106.17
3460,3030,23,25,-2,17.977
3461,11958,15,15,0,1.323
3462,8139,17,17,0,-2.12
3463,5867,242,6070,-5828,-4346.236
3464,11790,22,18,4,3.622
3465,277,36,6747,-6711,-1261.505
3466,1099,2096,1939,157,-1203.251
3467,6165,1432,249,1183,1871.78
3468,3187,21,28,-7,-0.325
3469,10155,3622,1760,1862,587.155
3470,13877,73174,74415,-1241,-9882.881
3471,8825,891,2311,-1420,-2283.263
3472,8912,18106,9415,8691,635.471
3473,10328,19,30,-11,9.391
3474,778,8820,17896,-9076,-4214.274
3475,12845,254,1601,-1347,-1692.86
3476,284,478,118,360,996.039
3477,10310,8,46,-38,-89.996
3478,8196,23,45,-22,-242.529
3479,7375,11,11,0,0.276
3480,484,783,11413,-10630,-6706.299
3481,4157,64,24,40,5.812
3482,13584,11387,16614,-5227,726.871
3483,4243,22,21,1,24.544
3484,12830,1671,194,1477,443.45
3485,2199,895,1014,-119,-30.846
3486,9752,24,24,0,10.667
3487,12292,345,880,-535,120.386
3488,610,4288,3821,467,675.96
3489,12026,23,24,-1,5.49
3490,8700,4125,3272,853,-846.665
3491,3792,18,58,-40,-160.971
3492,5433,12077,15954,-3877,2308.646
3493,8429,0,0,0,-13.745
3494,4339,16,16,0,2.711
3495,2824,14,51,-37,-899.192
3496,9141,330,3330,-3000,-987.343
3497,4229,98,68,30,31.979
3498,13057,1000,1315,-315,111.787
3499,15553,249,91,158,31.576
3500,7493,22,23,-1,12.744
3501,6932,13,435,-422,-1377.0
3502,6935,23,350,-327,-241.302
3503,10628,141,202,-61,-11.612
3504,1896,30,30,0,596.465
3505,6233,63,2196,-2133,-1067.499
3506,11324,42,50,-8,25.412
3507,11294,9637,1122,8515,781.653
3508,11683,187,277,-90,29.688
3509,11145,2202,946,1256,967.152
3510,3578,19,25,-6,-0.597
3511,12417,16,15,1,22.114
3512,1843,87,212,-125,1727.202
3513,12687,29,1160,-1131,-7.165
3514,12897,5013,8143,-3130,-270.362
3515,5765,77,45,32,-4.077
3516,9708,58,58,0,17.367
3517,11002,15123,16192,-1069,173.625
3518,2563,5001,3588,1413,-829.638
3519,10824,128,2726,-2598,-1331.406
3520,1984,106,106,0,-221.201
3521,7461,8,11,-3,1.218
3522,4483,39,30,9,-0.122
3523,9237,1930,8169,-6239,-16905.943
3524,410,3505,1764,1741,-2888.683
3525,10293,41,59,-18,160.902
3526,5866,22033,4871,17162,-1344.66
3527,1562,2154,281,1873,361.58
3528,13652,95,62,33,38.988
3529,9434,6467,3954,2513,-88.865
3530,5769,30,45,-15,-67.599
3531,12683,137,193,-56,79.583
3532,12842,2604,541,2063,452.556
3533,4649,3138,9964,-6826,1856.354
3534,7520,86,124,-38,3.454
3535,8155,4,5,-1,16.138
3536,13572,7125,18124,-10999,-6082.183
3537,2351,646,344,302,88.02
3538,7762,260,4325,-4065,-181.478
3539,13116,30,91,-61,-12.423
3540,8089,351,401,-50,65.41
3541,12670,333,911,-578,-785.835
3542,7541,4,4,0,-3.798
3543,2918,5658,4414,1244,911.179
3544,10594,39,50,-11,-54.629
3545,11430,24,792,-768,-153.645
3546,677,10517,10164,353,-587.625
3547,11974,6,6,0,9.195
3548,3413,344,333,11,231.378
3549,13263,3314,12263,-8949,-2759.658
3550,1065,44,45,-1,39.639
3551,10316,54,66,-12,4.311
3552,11596,1748,4093,-2345,3064.996
3553,12077,39,40,-1,-0.418
3554,760,2460,3137,-677,883.715
3555,10367,32,32,0,15.377
3556,12192,8,8,0,-14.2
3557,14657,59,59,0,74.461
3558,4573,38,5578,-5540,-3442.805
3559,648,2467,2806,-339,696.788
3560,6648,29,6259,-6230,-4002.687
3561,9831,251,1673,-1422,136.674
3562,14691,40,45,-5,-79.293
3563,13078,204,589,-385,-935.647
3564,15077,5896,11673,-5777,-5288.98
3565,336,3817,3215,602,-38.238
3566,5095,1248,8782,-7534,-361.129
3567,4697,13100,5355,7745,-508.993
3568,180,250,563,-313,-637.638
3569,14316,2309,1498,811,283.692
3570,3933,86,323,-237,103.022
3571,1761,47,48,-1,-107.475
3572,9410,914,2283,-1369,-1262.395
3573,13317,18517,22117,-3600,-5181.573
3574,9781,27,27,0,28.795
3575,11755,13,13,0,-3.907
3576,5670,78,78,0,-576.905
3577,7030,10,81,-71,-14.387
3578,11797,16,16,0,-4.044
3579,12752,14,36,-22,-40.313
3580,6652,2633,6227,-3594,-1740.107
3581,3098,34,84,-50,-4.728
3582,1782,73,51,22,-37.949
3583,6590,13393,19826,-6433,-4534.92
3584,2087,4882,2482,2400,1800.347
3585,3852,41,12929,-12888,-510.677
3586,9429,5796,6011,-215,667.478
3587,4928,1454,1708,-254,-1530.647
3588,1992,162,162,0,571.362
3589,14659,44,41,3,-118.883
3590,9352,1163,456,707,241.442
3591,10022,8348,4268,4080,-291.71
3592,11076,8952,9201,-249,-1804.953
3593,9460,6148,4472,1676,91.716
3594,3777,72,32,40,10.608
3595,9540,0,0,0,-27.927
3596,3155,29,46,-17,-22.536
3597,4137,1,1,0,-24.13
3598,4519,7066,4039,3027,-842.661
3599,10158,527,2435,-1908,2052.116
3600,3921,2564,3281,-717,-171.33
3601,3914,1225,1008,217,989.435
3602,9528,9833,4468,5365,60.517
3603,9555,0,0,0,-61.972
3604,4660,6616,2205,4411,-616.249
3605,13167,159,83,76,-81.187
3606,9535,4698,10520,-5822,-703.142
3607,1337,3110,359,2751,773.307
3608,4232,91,213,-122,-158.967
3609,1996,109,109,0,264.066
3610,1683,1670,675,995,391.656
3611,5547,32,33,-1,15.624
3612,13265,445,10050,-9605,-5683.471
3613,8494,874,2818,-1944,-2581.194
3614,1036,876,334,542,1462.034
3615,178,1125,3258,-2133,-1301.717
3616,8027,137,168,-31,-53.03
3617,10632,49,24,25,-41.301
3618,12959,371,288,83,-329.677
3619,15044,3076,3009,67,-283.517
3620,4698,272,5850,-5578,-3097.374
3621,5331,498,2791,-2293,-778.368
3622,5278,539,172,367,-1396.016
3623,12953,17,70,-53,16.617
3624,14885,186,63,123,76.478
3625,4194,12,12,0,2.311
3626,126,8821,3229,5592,-1287.252
3627,875,613,444,169,1056.697
3628,14533,0,0,0,-14.824
3629,6610,24761,21880,2881,3276.575
3630,3524,39,38,1,-10.648
3631,10476,2226,4715,-2489,267.155
3632,9782,49,49,0,24.842
3633,11728,2,3,-1,2.919
3634,6997,8,39,-31,-35.707
3635,1659,106,89,17,352.304
3636,8270,1575,828,747,567.29
3637,12133,29,29,0,12.41
3638,11937,38,38,0,-6.882
3639,9170,2901,2695,206,775.01
3640,3239,138,77,61,32.375
3641,5693,19,37,-18,-267.22
3642,9002,338,177,161,-741.704
3643,1768,63,63,0,75.673
3644,14889,18,18,0,10.958
3645,9069,161,88,73,92.568
3646,8022,106,248,-142,29.007
3647,7192,2,2,0,-27.02
3648,223,114,104,10,150.032
3649,6319,376,443,-67,-39.209
3650,7995,572,229,343,-16.054
3651,144,9387,5795,3592,455.274
3652,8101,31,28,3,18.499
3653,8380,205,3383,-3178,-3085.054
3654,3338,84,105,-21,-1.217
3655,4429,7,20,-13,-12.095
3656,10983,113,126,-13,-371.41
3657,13674,29,29,0,-2.594
3658,544,1958,577,1381,17.013
3659,12086,9,14,-5,-1.51
3660,2166,127,2885,-2758,-1890.209
3661,3071,35,30,5,-1.359
3662,9162,59,97,-38,179.778
3663,995,4871,414,4457,693.059
3664,3369,42,42,0,25.406
3665,6550,10574,5143,5431,-6587.83
3666,9757,33,33,0,3.19
3667,15495,427,105,322,451.419
3668,5520,190,102,88,-54.573
3669,8339,1148,4415,-3267,-2856.4
3670,8591,763,1142,-379,-456.764
3671,8964,235,773,-538,869.691
3672,14414,2291,1976,315,-260.778
3673,6982,0,0,0,-48.464
3674,13156,51,51,0,35.981
3675,15183,20,25,-5,96.017
3676,9736,52,112,-60,37.364
3677,2094,5247,10036,-4789,-3462.754
3678,3714,637,107,530,93.418
3679,1957,94,123,-29,606.414
3680,9998,387,8481,-8094,-3430.948
3681,9451,1607,903,704,169.503
3682,1581,162,21770,-21608,-4410.257
3683,3538,54,49,5,27.067
3684,9013,212,171,41,550.084
3685,11112,0,0,0,-1275.197
3686,3956,1155,956,199,200.375
3687,7065,23,23,0,-3.266
3688,7352,12,12,0,-0.384
3689,420,1531,1192,339,248.288
3690,10122,2959,1955,1004,695.56
3691,3545,44,137,-93,-22.996
3692,5415,5935,5226,709,2787.19
3693,7097,10,23,-13,-14.094
3694,6125,97,1965,-1868,-766.5
3695,11967,11,25,-14,-1.774
3696,15567,65,1055,-990,-170.454
3697,5530,35,191,-156,-19.704
3698,2996,5669,1967,3702,26.014
3699,11992,9,12,-3,-1.802
3700,11646,89,86,3,141.661
3701,8771,1348,910,438,266.764
3702,10245,102,59,43,25.774
3703,10250,11,551,-540,-647.846
3704,11903,41,30,11,-3.079
3705,10090,274,2875,-2601,1504.912
3706,13363,13,6378,-6365,-3520.465
3707,12082,4,18,-14,-8.877
3708,14420,2357,5338,-2981,-1168.549
3709,2329,341,619,-278,-29.299
3710,11258,825,2634,-1809,-774.786
3711,13231,22147,20329,1818,-2323.199
3712,5452,10267,9175,1092,-3479.492
3713,1698,259,102,157,15.484
3714,6921,35,94,-59,-494.87
3715,8413,2706,1657,1049,-878.325
3716,3817,2638,302,2336,659.434
3717,12234,249,101,148,324.846
3718,3267,217,51,166,-8.71
3719,15274,26,36,-10,72.597
3720,9756,9,57,-48,-17.451
3721,1321,9051,6472,2579,934.581
3722,593,204,1405,-1201,-585.641
3723,8242,3169,4118,-949,815.02
3724,9748,40,56,-16,-136.639
3725,13851,20763,43728,-22965,-21072.564
3726,6346,38,38,0,-1.35
3727,9212,7434,7397,37,-13100.635
3728,489,310,4184,-3874,-3215.492
3729,6606,1621,2085,-464,-1936.085
3730,12946,90,48,42,-112.818
3731,12084,17,27,-10,-0.425
3732,10216,325,571,-246,-156.546
3733,12472,13,17,-4,9.776
3734,15232,23,31,-8,36.229
3735,9689,7045,8236,-1191,-420.821
3736,638,13883,14709,-826,1424.707
3737,15094,27,49,-22,902.726
3738,6844,23,35,-12,2.727
3739,8223,166,444,-278,104.378
3740,6582,2295,706,1589,634.037
3741,8706,1780,3020,-1240,-67.324
3742,14132,44876,56958,-12082,230.023
3743,3856,134,362,-228,559.118
3744,2764,33,33,0,76.713
3745,5961,1833,167,1666,131.004
3746,14004,15092,6169,8923,3762.719
3747,9886,60,960,-900,-771.953
3748,4057,47,111,-64,-43.19
3749,10320,23,30,-7,3.505
3750,6025,19,42,-23,-6.456
3751,15341,50,687,-637,-33.474
3752,5466,12156,14118,-1962,-2508.32
3753,2671,12,11,1,9.411
3754,10023,7,66,-59,-134.554
3755,8316,452,288,164,105.554
3756,5435,6327,8001,-1674,-8661.439
3757,12615,65,403,-338,-2.587
3758,7488,2,3,-1,-0.95
3759,11994,16,16,0,-5.475
3760,9771,67,44,23,-80.841
3761,9144,3340,2263,1077,1123.22
3762,13957,775,67,708,606.005
3763,11151,17197,9226,7971,933.769
3764,6743,12,16,-4,-1.298
3765,12791,2465,1848,617,379.46
3766,14409,14,44,-30,-561.27
3767,10966,285,431,-146,335.67
3768,13427,2018,22979,-20961,-14419.75
3769,11123,19245,14311,4934,87.641
3770,15239,15,15,0,6.147
3771,14546,4680,5346,-666,13.757
3772,14626,52,52,0,14.272
3773,4121,4,8,-4,-11.217
3774,7302,14,27,-13,6.559
3775,8165,53,245,-192,53.226
3776,8777,2497,3215,-718,1426.061
3777,6576,2028,1254,774,1280.439
3778,2156,1483,275,1208,78.159
3779,7991,2105,3188,-1083,-1147.897
3780,10359,18,30,-12,-14.702
3781,13792,564,2433,-1869,3281.39
3782,9988,457,163,294,2271.575
3783,4471,17,18,-1,-3.308
3784,12812,71,1830,-1759,450.927
3785,5211,2229,3145,-916,1061.041
3786,14232,10265,1242,9023,-1757.025
3787,4558,1043,895,148,-499.769
3788,2728,28,131,-103,-177.146
3789,5873,16461,40488,-24027,-21677.518
3790,11731,53,37,16,-42.274
3791,4790,93,93,0,93.336
3792,2793,158,71,87,29.59
3793,366,5634,4174,1460,1068.575
3794,9707,21,20,1,13.499
3795,14097,14013,576,13437,2538.834
3796,556,5187,4505,682,923.043
3797,11642,23,23,0,41.279
3798,529,1134,742,392,269.268
3799,15551,87,87,0,-72.442
3800,1044,1509,1348,161,-172.697
3801,15595,94,94,0,39.673
3802,66,60,38,22,0.633
3803,11816,12565,19739,-7174,-1046.852
3804,15419,79,778,-699,-205.802
3805,5544,80,80,0,259.037
3806,12043,16,16,0,1.883
3807,11138,100,2128,-2028,-3451.373
3808,7308,11,11,0,0.103
3809,13237,28770,21266,7504,5587.583
3810,12967,854,123,731,-426.91
3811,8734,30,60,-30,-14.221
3812,2947,3134,152,2982,460.526
3813,4834,0,0,0,-230.33
3814,7782,83,83,0,399.347
3815,5108,428,5259,-4831,-1255.592
3816,5271,5047,2720,2327,868.127
3817,11700,11,39,-28,-29.839
3818,3194,23,37,-14,24.727
3819,1800,81,81,0,-49.306
3820,9443,2793,7362,-4569,-1041.535
3821,3502,34,58,-24,-3.006
3822,14280,13172,11135,2037,14067.997
3823,6093,362,108,254,52.276
3824,1656,129,106,23,-58.76
3825,4966,1970,2318,-348,-1428.783
3826,10462,75,75,0,-19.839
3827,195,3285,1456,1829,-1833.176
3828,8559,1466,2621,-1155,358.293
3829,2680,25,34,-9,-1.969
3830,8929,171,1993,-1822,-2278.164
3831,11920,36,34,2,20.38
3832,7086,45,49,-4,-22.511
3833,6059,24,46,-22,-24.447
3834,10745,983,1420,-437,1396.325
3835,8962,7308,9284,-1976,5012.997
3836,23,52,52,0,-50.603
3837,13429,44,24831,-24787,-20051.711
3838,4612,3167,4272,-1105,-1250.967
3839,2867,301,132,169,-181.052
3840,813,3982,1051,2931,1078.584
3841,15261,26,26,0,38.427
3842,1258,79,82,-3,507.903
3843,13085,1355,4160,-2805,264.44
3844,15299,25,25,0,-6.843
3845,4822,4642,2298,2344,-869.902
3846,6138,654,573,81,372.472
3847,6444,10849,6207,4642,474.823
3848,11517,715,7038,-6323,2572.458
3849,10623,6,10,-4,-32.086
3850,7643,8,8,0,-0.777
3851,13480,31955,18915,13040,-633.4
3852,2620,700,893,-193,-1089.115
3853,477,282,4107,-3825,-4803.487
3854,15476,77,77,0,-3.074
3855,11459,45,46,-1,117.023
3856,8121,44,62,-18,140.49
3857,13373,22685,16464,6221,1254.343
3858,12564,10410,21470,-11060,-2432.286
3859,5671,23,640,-617,-206.205
3860,15423,22,41,-19,41.181
3861,14416,15,204,-189,-749.328
3862,4322,4,4,0,-1.671
3863,5139,3276,1957,1319,175.187
3864,13252,34936,33714,1222,6464.522
3865,9838,889,103,786,-494.174
3866,2547,257,1541,-1284,-3023.465
3867,11767,28,28,0,5.558
3868,13653,5,29,-24,-15.352
3869,6627,7708,10348,-2640,-2417.595
3870,5839,7012,1471,5541,1169.314
3871,8506,58,236,-178,-21.134
3872,3095,165,30,135,-3.279
3873,12188,6,10,-4,-2.449
3874,3077,10,23,-13,-0.465
3875,5096,799,1673,-874,-2011.092
3876,8930,3737,2514,1223,2929.711
3877,10590,16,16,0,-10.161
3878,9984,1502,1751,-249,21.621
3879,2915,114,126,-12,-692.776
3880,5939,84,103,-19,-43.072
3881,12333,8,8,0,-12.228
3882,11956,17,17,0,12.896
3883,3778,149,251,-102,25.23
3884,11358,17,52,-35,-23.243
3885,7459,166,23,143,9.72
3886,11269,78,101,-23,110.086
3887,10051,519,13809,-13290,-4658.283
3888,14882,42,42,0,24.791
3889,11283,365,1490,-1125,45.606
3890,2138,927,327,600,15.452
3891,1108,10423,10935,-512,85.176
3892,9025,10565,531,10034,2175.724
3893,12521,128,13194,-13066,-7834.186
3894,9514,4577,8486,-3909,-1363.854
3895,7420,5,2,3,1.768
3896,15532,18,27,-9,-119.009
3897,2122,214,335,-121,79.653
3898,2012,25239,34433,-9194,-160.47
3899,14848,94,80,14,-4.218
