i,map,width,height,start,start_up,start_right,start_down,start_left,goal,goal_up,goal_right,goal_down,goal_left,top,left,distance,forward,backward
0,arena.map,47,47,650,13,7,33,39,826,17,19,29,27,-4,12,16,17,17
1,arena.map,47,47,457,9,12,37,34,2014,42,6,4,40,-33,-6,39,40,40
2,arena.map,47,47,626,13,31,33,15,1351,28,11,18,35,-15,-20,35,36,36
3,arena.map,47,47,849,18,43,28,3,1793,38,39,8,7,-20,-4,24,25,25
4,arena.map,47,47,529,11,34,35,12,649,13,8,33,38,-2,-26,28,29,29
5,arena.map,47,47,1291,27,24,19,22,116,2,24,44,22,25,0,25,28,28
6,arena.map,47,47,762,16,36,30,10,1127,23,0,23,46,-7,-36,43,44,94
7,arena.map,47,47,355,7,20,39,26,2015,42,5,4,41,-35,-15,50,51,51
8,arena.map,47,47,1825,38,7,8,39,2199,46,9,0,37,-8,2,10,11,11
9,arena.map,47,47,1368,29,41,17,5,403,8,19,38,27,21,-22,43,61,44
10,arena.map,47,47,532,11,31,35,15,989,21,44,25,2,-10,13,23,24,24
11,arena.map,47,47,1914,40,12,6,34,1559,33,38,13,8,7,26,33,49,34
12,arena.map,47,47,1248,26,20,20,26,188,4,46,42,0,22,26,48,49,49
13,arena.map,47,47,770,16,28,30,18,252,5,29,41,17,11,1,12,13,13
14,arena.map,47,47,665,14,39,32,7,2143,45,18,1,28,-31,-21,52,53,98
15,arena.map,47,47,473,10,43,36,3,1574,33,23,13,23,-23,-20,43,44,44
16,arena.map,47,47,402,8,20,38,26,1155,24,19,22,27,-16,-1,17,18,18
17,arena.map,47,47,1657,35,34,11,12,1692,36,46,10,0,-1,12,13,14,14
18,arena.map,47,47,418,8,4,38,42,389,8,33,38,13,0,29,29,33,33
19,arena.map,47,47,344,7,31,39,15,899,19,40,27,6,-12,9,21,22,22
20,arena.map,47,47,1106,23,21,23,25,1948,41,25,5,21,-18,4,22,23,23
21,arena.map,47,47,838,17,7,29,39,1151,24,23,22,23,-7,16,23,24,31
22,arena.map,47,47,857,18,35,28,11,915,19,24,27,22,-1,-11,12,13,13
23,arena.map,47,47,1688,35,3,11,43,1005,21,28,25,18,14,25,39,40,40
24,arena.map,47,47,977,20,9,26,37,981,20,5,26,41,0,-4,4,5,5
25,arena.map,47,47,1657,35,34,11,12,110,2,30,44,16,33,-4,37,38,38
26,arena.map,47,47,1986,42,34,4,12,268,5,13,41,33,37,-21,58,59,59
27,arena.map,47,47,500,10,16,36,30,796,16,2,30,44,-6,-14,20,21,21
28,arena.map,47,47,1817,38,15,8,31,1901,40,25,6,21,-2,10,12,13,13
29,arena.map,47,47,216,4,18,42,28,1533,32,17,14,29,-28,-1,29,30,30
30,arena.map,47,47,2051,43,16,3,30,1875,39,4,7,42,4,-12,16,17,17
31,arena.map,47,47,1906,40,20,6,26,1772,37,13,9,33,3,-7,10,11,11
32,arena.map,47,47,1241,26,27,20,19,511,10,5,36,41,16,-22,38,39,39
33,arena.map,47,47,561,11,2,35,44,467,9,2,37,44,2,0,2,3,3
34,arena.map,47,47,1029,21,4,25,42,509,10,7,36,39,11,3,14,15,15
35,arena.map,47,47,436,9,33,37,13,2174,46,34,0,12,-37,1,38,39,39
36,arena.map,47,47,1208,25,13,21,33,1348,28,14,18,32,-3,1,4,5,5
37,arena.map,47,47,1024,21,9,25,37,982,20,4,26,42,1,-5,6,7,7
38,arena.map,47,47,920,19,19,27,27,1012,21,21,25,25,-2,2,4,5,5
39,arena.map,47,47,1160,24,14,22,32,2079,44,35,2,11,-20,21,41,42,42
40,arena.map,47,47,1338,28,24,18,22,525,11,38,35,8,17,14,31,32,32
41,arena.map,47,47,803,17,42,29,4,1823,38,9,8,37,-21,-33,54,55,73
42,arena.map,47,47,288,6,40,40,6,770,16,28,30,18,-10,-12,22,23,23
43,arena.map,47,47,664,14,40,32,6,2007,42,13,4,33,-28,-27,55,104,106
44,arena.map,47,47,1842,39,37,7,9,463,9,6,37,40,30,-31,61,62,62
45,arena.map,47,47,863,18,29,28,17,1199,25,22,21,24,-7,-7,14,15,15
46,arena.map,47,47,288,6,40,40,6,1238,26,30,20,16,-20,-10,30,55,31
47,arena.map,47,47,1318,28,44,18,2,1983,42,37,4,9,-14,-7,21,22,22
48,arena.map,47,47,496,10,20,36,26,1049,22,31,24,15,-12,11,23,36,24
49,arena.map,47,47,328,6,0,40,46,250,5,31,41,15,1,31,32,33,33
50,arena.map,47,47,1665,35,26,11,20,403,8,19,38,27,27,-7,34,37,35
51,arena.map,47,47,806,17,39,29,7,1654,35,37,11,9,-18,-2,20,21,21
52,arena.map,47,47,1803,38,29,8,17,294,6,34,40,12,32,5,37,39,118
53,arena.map,47,47,1388,29,21,17,25,1133,24,41,22,5,5,20,25,26,26
54,arena.map,47,47,1724,36,14,10,32,685,14,19,32,27,22,5,27,28,64
55,arena.map,47,47,156,3,31,43,15,797,16,1,30,45,-13,-30,43,44,44
56,arena.map,47,47,482,10,34,36,12,84,1,9,45,37,9,-25,34,47,35
57,arena.map,47,47,598,12,12,34,34,1455,30,1,16,45,-18,-11,29,30,30
58,arena.map,47,47,469,9,0,37,46,1805,38,27,8,19,-29,27,56,57,57
59,arena.map,47,47,475,10,41,36,5,164,3,23,43,23,7,-18,25,26,26
60,arena.map,47,47,821,17,24,29,22,1103,23,24,23,22,-6,0,6,7,7
61,arena.map,47,47,426,9,43,37,3,1668,35,23,11,23,-26,-20,46,47,47
62,arena.map,47,47,1073,22,7,24,39,1100,23,27,23,19,-1,20,21,22,22
63,arena.map,47,47,757,16,41,30,5,1862,39,17,7,29,-23,-24,47,48,73
64,arena.map,47,47,282,6,46,40,0,119,2,21,44,25,4,-25,29,30,30
65,arena.map,47,47,629,13,28,33,18,1774,37,11,9,35,-24,-17,41,42,42
66,arena.map,47,47,236,5,45,41,1,1070,22,10,24,36,-17,-35,52,53,53
67,arena.map,47,47,81,1,12,45,34,1466,31,37,15,9,-30,25,55,56,71
68,arena.map,47,47,507,10,9,36,37,1156,24,18,22,28,-14,9,23,24,24
69,arena.map,47,47,545,11,18,35,28,1795,38,37,8,9,-27,19,46,47,47
70,arena.map,47,47,605,12,5,34,41,1749,37,36,9,10,-25,31,56,57,57
71,arena.map,47,47,1986,42,34,4,12,806,17,39,29,7,25,5,30,31,31
72,arena.map,47,47,1584,33,13,13,33,1656,35,35,11,11,-2,22,24,25,41
73,arena.map,47,47,2023,43,44,3,2,1279,27,36,19,10,16,-8,24,25,25
74,arena.map,47,47,201,4,33,42,13,607,12,3,34,43,-8,-30,38,39,39
75,arena.map,47,47,1019,21,14,25,32,527,11,36,35,10,10,22,32,33,42
76,arena.map,47,47,138,2,2,44,44,975,20,11,26,35,-18,9,27,28,28
77,arena.map,47,47,729,15,22,31,24,762,16,36,30,10,-1,14,15,41,32
78,arena.map,47,47,1715,36,23,10,23,788,16,10,30,36,20,-13,33,48,34
79,arena.map,47,47,171,3,16,43,30,1254,26,14,20,32,-23,-2,25,53,44
80,arena.map,47,47,458,9,11,37,35,1287,27,28,19,18,-18,17,35,36,36
81,arena.map,47,47,1524,32,26,14,20,1157,24,17,22,29,8,-9,17,18,18
82,arena.map,47,47,1433,30,23,16,23,1439,30,17,16,29,0,-6,6,7,7
83,arena.map,47,47,973,20,13,26,33,470,10,46,36,0,10,33,43,45,60
84,arena.map,47,47,800,17,45,29,1,906,19,33,27,13,-2,-12,14,15,15
85,arena.map,47,47,699,14,5,32,41,2012,42,8,4,38,-28,3,31,32,32
86,arena.map,47,47,1210,25,11,21,35,508,10,8,36,38,15,-3,18,19,19
87,arena.map,47,47,162,3,25,43,21,1092,23,35,23,11,-20,10,30,31,31
88,arena.map,47,47,304,6,24,40,22,163,3,24,43,22,3,0,3,4,4
89,arena.map,47,47,1116,23,11,23,35,1005,21,28,25,18,2,17,19,20,20
90,arena.map,47,47,2116,45,45,1,1,389,8,33,38,13,37,-12,49,50,66
91,arena.map,47,47,1370,29,39,17,7,1172,24,2,22,44,5,-37,42,43,43
92,arena.map,47,47,1076,22,4,24,42,1804,38,28,8,18,-16,24,40,41,41
93,arena.map,47,47,1306,27,9,19,37,534,11,29,35,17,16,20,36,37,37
94,arena.map,47,47,362,7,13,39,33,2198,46,10,0,36,-39,-3,42,43,43
95,arena.map,47,47,289,6,39,40,7,1373,29,36,17,10,-23,-3,26,27,27
96,arena.map,47,47,970,20,16,26,30,611,13,46,33,0,7,30,37,38,39
97,arena.map,47,47,1624,34,20,12,26,1104,23,23,23,23,11,3,14,15,15
98,arena.map,47,47,2202,46,6,0,40,629,13,28,33,18,33,22,55,56,56
99,arena.map,47,47,832,17,13,29,33,866,18,26,28,20,-1,13,14,15,25
0,arena2.map,206,281,34754,123,89,82,191,41203,146,103,59,177,-23,14,37,72,51
1,arena2.map,206,281,32297,114,17,91,263,14227,50,103,155,177,64,86,150,1339,209
2,arena2.map,206,281,16675,59,184,146,96,26883,95,92,110,188,-36,-92,128,134,131
3,arena2.map,206,281,47363,168,125,37,155,14791,52,101,153,179,116,-24,140,1404,2469
4,arena2.map,206,281,22969,81,72,124,208,19299,68,89,137,191,13,17,30,38,142
5,arena2.map,206,281,33016,117,141,88,139,41818,148,50,57,230,-31,-91,122,6097,1770
6,arena2.map,206,281,17514,62,188,143,92,20767,73,26,132,254,-11,-162,173,5123,5425
7,arena2.map,206,281,27484,97,53,108,227,24583,87,144,118,136,10,91,101,104,104
8,arena2.map,206,281,44829,159,130,46,150,23951,85,214,120,66,74,84,158,209,2486
9,arena2.map,206,281,36974,131,117,74,163,29383,104,121,101,159,27,4,31,783,1785
10,arena2.map,206,281,24318,86,128,119,152,26575,94,119,111,161,-8,-9,17,18,18
11,arena2.map,206,281,11664,41,137,164,143,15622,55,113,150,167,-14,-24,38,44,39
12,arena2.map,206,281,18346,65,199,140,81,44292,157,105,48,175,-92,-94,186,3456,567
13,arena2.map,206,281,12514,44,130,161,150,32534,115,61,90,219,-71,-69,140,193,179
14,arena2.map,206,281,14721,52,171,153,109,22893,81,148,124,132,-29,-23,52,3809,2804
15,arena2.map,206,281,38689,137,88,68,192,41758,148,110,57,170,-11,22,33,43,34
16,arena2.map,206,281,32240,114,74,91,206,55342,196,14,9,266,-82,-60,142,2065,3084
17,arena2.map,206,281,37247,132,125,73,155,38479,136,17,69,263,-4,-108,112,2208,2428
18,arena2.map,206,281,40619,144,125,61,155,31380,111,91,94,189,33,-34,67,115,522
19,arena2.map,206,281,32650,116,226,89,54,36085,128,163,77,117,-12,-63,75,1090,473
20,arena2.map,206,281,35813,127,154,78,126,18719,66,107,139,173,61,-47,108,4248,1206
21,arena2.map,206,281,3200,11,171,194,109,44073,156,43,49,237,-145,-128,273,6139,1760
22,arena2.map,206,281,30892,109,17,96,263,15581,55,154,150,126,54,137,191,1240,231
23,arena2.map,206,281,45906,163,177,42,103,29082,103,141,102,139,60,-36,96,2435,2859
24,arena2.map,206,281,41115,146,191,59,89,20702,73,91,132,189,73,-100,173,650,4595
25,arena2.map,206,281,19784,70,166,135,114,51650,183,53,22,227,-113,-113,226,8396,2436
26,arena2.map,206,281,9138,32,134,173,146,55325,196,31,9,249,-164,-103,267,4173,2626
27,arena2.map,206,281,51362,182,60,23,220,29263,104,241,101,39,78,181,259,3464,13867
28,arena2.map,206,281,11670,41,131,164,149,13607,48,161,157,119,-7,30,37,219,40
29,arena2.map,206,281,39713,141,188,64,92,9382,33,171,172,109,108,-17,125,657,1384
30,arena2.map,206,281,24308,86,138,119,142,28631,101,30,104,250,-15,-108,123,126,207
31,arena2.map,206,281,116,0,164,205,116,15703,55,32,150,248,-55,-132,187,5577,2464
32,arena2.map,206,281,25486,90,84,115,196,26991,96,265,109,15,-6,181,187,4534,694
33,arena2.map,206,281,27928,99,171,106,109,26390,93,23,112,257,6,-148,154,2262,1404
34,arena2.map,206,281,18816,66,10,139,270,50558,179,21,26,259,-113,11,124,2261,559
35,arena2.map,206,281,54778,194,16,11,264,37075,131,16,74,264,63,0,63,949,1124
36,arena2.map,206,281,19816,70,134,135,146,17691,62,11,143,269,8,-123,131,2803,2830
37,arena2.map,206,281,47349,168,139,37,141,30783,109,126,96,154,59,-13,72,2517,3407
38,arena2.map,206,281,36411,129,118,76,162,47655,169,114,36,166,-40,-4,44,45,45
39,arena2.map,206,281,30874,109,35,96,245,12900,45,25,160,255,64,-10,74,78,258
40,arena2.map,206,281,53056,188,52,17,228,27129,96,127,109,153,92,75,167,3132,6039
41,arena2.map,206,281,23698,84,186,121,94,55070,195,5,10,275,-111,-181,292,11537,9183
42,arena2.map,206,281,37625,133,28,72,252,42098,149,51,56,229,-16,23,39,48,56
43,arena2.map,206,281,30474,108,154,97,126,29141,103,82,102,198,5,-72,77,697,469
44,arena2.map,206,281,35522,126,164,79,116,52236,185,29,20,251,-59,-135,194,4685,3422
45,arena2.map,206,281,23505,83,98,122,182,17002,60,138,145,142,23,40,63,786,811
46,arena2.map,206,281,26224,93,189,112,91,37933,134,1,71,279,-41,-188,229,4959,5444
47,arena2.map,206,281,27642,98,176,107,104,48500,172,112,33,168,-74,-64,138,4347,3475
48,arena2.map,206,281,17040,60,100,145,180,38091,135,124,70,156,-75,24,99,2093,521
49,arena2.map,206,281,28993,103,230,102,50,56476,200,4,5,276,-97,-226,323,11741,4435
50,arena2.map,206,281,18525,65,20,140,260,31621,112,131,93,149,-47,111,158,1635,2058
51,arena2.map,206,281,28426,101,235,104,45,16397,58,181,147,99,43,-54,97,121,132
52,arena2.map,206,281,33296,118,142,87,138,17315,61,106,144,174,57,-36,93,3014,1285
53,arena2.map,206,281,37632,133,21,72,259,40844,145,181,60,99,-12,160,172,4195,4828
54,arena2.map,206,281,39507,140,113,65,167,42415,150,15,55,265,-10,-98,108,2617,3020
55,arena2.map,206,281,48010,170,40,35,240,56463,200,17,5,263,-30,-23,53,61,67
56,arena2.map,206,281,56738,201,23,4,257,14307,50,23,155,257,151,0,151,744,2076
57,arena2.map,206,281,24091,85,74,120,206,41391,147,196,58,84,-62,122,184,202,381
58,arena2.map,206,281,47145,167,62,38,218,47174,167,33,38,247,0,-29,29,30,30
59,arena2.map,206,281,21780,77,137,128,143,21495,76,141,129,139,1,4,5,6,6
60,arena2.map,206,281,39156,139,183,66,97,47148,167,59,38,221,-28,-124,152,11644,7624
61,arena2.map,206,281,24280,86,166,119,114,36906,131,185,74,95,-45,19,64,1263,618
62,arena2.map,206,281,26025,92,107,113,173,44203,157,194,48,86,-65,87,152,156,199
63,arena2.map,206,281,24656,87,71,118,209,40708,144,36,61,244,-57,-35,92,1204,466
64,arena2.map,206,281,42376,150,54,55,226,25162,89,127,116,153,61,73,134,966,5932
65,arena2.map,206,281,27609,98,209,107,71,35770,127,197,78,83,-29,-12,41,42,42
66,arena2.map,206,281,29921,106,145,99,135,44772,159,187,46,93,-53,42,95,1674,1648
67,arena2.map,206,281,13883,49,166,156,114,20220,71,11,134,269,-22,-155,177,4601,2473
68,arena2.map,206,281,57582,204,22,1,258,42295,150,135,55,145,54,113,167,4647,5119
69,arena2.map,206,281,53666,190,4,15,276,12220,43,143,162,137,147,139,286,2976,5323
70,arena2.map,206,281,39608,140,12,65,268,26205,93,208,112,72,47,196,243,2887,5827
71,arena2.map,206,281,27466,97,71,108,209,18523,65,22,140,258,32,-49,81,391,802
72,arena2.map,206,281,37486,133,167,72,113,26527,94,167,111,113,39,0,39,40,40
73,arena2.map,206,281,19904,70,46,135,234,50522,179,57,26,223,-109,11,120,732,1502
74,arena2.map,206,281,53664,190,6,15,274,44922,159,37,46,243,31,31,62,84,89
75,arena2.map,206,281,41970,149,179,56,101,40839,145,186,60,94,4,7,11,12,12
76,arena2.map,206,281,27709,98,109,107,171,56166,199,33,6,247,-101,-76,177,2085,1879
77,arena2.map,206,281,43073,153,200,52,80,30915,110,275,95,5,43,75,118,1809,441
78,arena2.map,206,281,32484,115,111,90,169,29279,104,225,101,55,11,114,125,126,137
79,arena2.map,206,281,16985,60,155,145,125,47444,168,44,37,236,-108,-111,219,4698,1795
80,arena2.map,206,281,25064,89,225,116,55,37830,134,104,71,176,-45,-121,166,6445,662
81,arena2.map,206,281,46754,166,172,39,108,36348,129,181,76,99,37,9,46,49,60
82,arena2.map,206,281,3464,12,188,193,92,38637,137,140,68,140,-125,-48,173,4339,8869
83,arena2.map,206,281,28202,100,178,105,102,34149,121,132,84,148,-21,-46,67,68,68
84,arena2.map,206,281,42393,150,37,55,243,56741,201,20,4,260,-51,-17,68,204,79
85,arena2.map,206,281,24642,87,85,118,195,41563,147,24,58,256,-60,-61,121,124,295
86,arena2.map,206,281,13068,46,138,159,142,27205,96,51,109,229,-50,-87,137,1744,213
87,arena2.map,206,281,26232,93,181,112,99,52544,186,2,19,278,-93,-179,272,11369,9672
88,arena2.map,206,281,37238,132,134,73,146,43982,156,134,49,146,-24,0,24,2765,3087
89,arena2.map,206,281,28849,102,93,103,187,32123,114,191,91,89,-12,98,110,1656,1640
90,arena2.map,206,281,12216,43,147,162,133,24820,88,188,117,92,-45,41,86,87,87
91,arena2.map,206,281,43988,156,128,49,152,39478,140,142,65,138,16,14,30,3500,2782
92,arena2.map,206,281,29385,104,119,101,161,32162,114,152,91,128,-10,33,43,44,44
93,arena2.map,206,281,22858,81,183,124,97,19523,69,146,136,134,12,-37,49,2060,2083
94,arena2.map,206,281,10281,36,115,169,165,23145,82,177,123,103,-46,62,108,1767,111
95,arena2.map,206,281,27168,96,88,109,192,40573,144,171,61,109,-48,83,131,2689,207
96,arena2.map,206,281,42816,152,176,53,104,30212,107,135,98,145,45,-41,86,2313,2885
97,arena2.map,206,281,29264,104,240,101,40,42990,152,2,53,278,-48,-238,286,7688,3138
98,arena2.map,206,281,25941,92,191,113,89,25119,89,170,116,110,3,-21,24,322,240
99,arena2.map,206,281,109,0,171,205,109,36989,131,102,74,178,-131,-69,200,3344,642
0,brc000d.map,236,247,52019,210,97,25,149,40167,162,93,73,153,48,-4,52,53,53
1,brc000d.map,236,247,38437,155,94,80,152,28311,114,93,121,153,41,-1,42,236,307
2,brc000d.map,236,247,16900,68,142,167,104,49533,200,113,35,133,-132,-29,161,2586,1302
3,brc000d.map,236,247,3777,15,174,220,72,52947,214,157,21,89,-199,-17,216,27386,1577
4,brc000d.map,236,247,22870,92,100,143,146,32990,133,107,102,139,-41,7,48,67,49
5,brc000d.map,236,247,5792,23,135,212,111,36522,147,33,88,213,-124,-102,226,379,234
6,brc000d.map,236,247,7673,31,230,204,16,2062,8,160,227,86,23,-70,93,565,927
7,brc000d.map,236,247,31546,127,69,108,177,8534,34,110,201,136,93,41,134,342,474
8,brc000d.map,236,247,2550,10,166,225,80,24119,97,86,138,160,-87,-80,167,767,185
9,brc000d.map,236,247,32251,130,105,105,141,2070,8,152,227,94,122,47,169,170,317
10,brc000d.map,236,247,12507,50,89,185,157,33271,134,73,101,173,-84,-16,100,232,118
11,brc000d.map,236,247,35650,144,164,91,82,36207,146,101,89,145,-2,-63,65,1042,1770
12,brc000d.map,236,247,18844,76,174,159,72,28189,114,215,121,31,-38,41,79,80,106
13,brc000d.map,236,247,52472,212,138,23,108,43131,174,93,61,153,38,-45,83,1577,27386
14,brc000d.map,236,247,27697,112,213,123,33,43907,177,58,58,188,-65,-155,220,3723,7866
15,brc000d.map,236,247,18219,73,58,162,188,48829,197,76,38,170,-124,18,142,1669,279
16,brc000d.map,236,247,1817,7,158,228,88,27143,109,26,126,220,-102,-132,234,339,242
17,brc000d.map,236,247,3320,13,137,222,109,52516,212,94,23,152,-199,-43,242,966,243
18,brc000d.map,236,247,15950,64,104,171,142,44807,181,146,54,100,-117,42,159,2288,177
19,brc000d.map,236,247,44858,181,95,54,151,17876,72,154,163,92,109,59,168,388,474
20,brc000d.map,236,247,7059,28,103,207,143,43644,176,74,59,172,-148,-29,177,567,3395
21,brc000d.map,236,247,42896,173,81,62,165,24404,98,48,137,198,75,-33,108,267,118
22,brc000d.map,236,247,45306,183,141,52,105,6563,26,105,209,141,157,-36,193,804,3684
23,brc000d.map,236,247,17478,70,58,165,188,41830,169,159,66,87,-99,101,200,6889,533
24,brc000d.map,236,247,19176,77,89,158,157,23081,93,136,142,110,-16,47,63,64,89
25,brc000d.map,236,247,3241,13,216,222,30,13716,55,115,180,131,-42,-101,143,144,270
26,brc000d.map,236,247,12962,52,128,183,118,27207,110,209,125,37,-58,81,139,193,219
27,brc000d.map,236,247,32744,132,106,103,140,45522,184,172,51,74,-52,66,118,358,798
28,brc000d.map,236,247,42865,173,112,62,134,34033,137,52,98,194,36,-60,96,161,185
29,brc000d.map,236,247,21378,86,110,149,136,16173,65,128,170,118,21,18,39,40,45
30,brc000d.map,236,247,23337,94,127,141,119,37782,152,8,83,238,-58,-119,177,180,508
31,brc000d.map,236,247,44780,181,173,54,73,32653,132,197,103,49,49,24,73,107,74
32,brc000d.map,236,247,23744,96,214,139,32,11685,47,170,188,76,49,-44,93,183,256
33,brc000d.map,236,247,20139,81,114,154,132,12678,51,165,184,81,30,51,81,115,118
34,brc000d.map,236,247,34784,140,42,95,204,31236,126,132,109,114,14,90,104,734,467
35,brc000d.map,236,247,14241,57,84,178,162,10788,43,79,192,167,14,-5,19,20,40
36,brc000d.map,236,247,34410,139,169,96,77,3743,15,208,220,38,124,39,163,3487,15625
37,brc000d.map,236,247,28441,115,210,120,36,36780,148,22,87,224,-33,-188,221,400,5615
38,brc000d.map,236,247,34130,138,202,97,44,20365,82,135,153,111,56,-67,123,3145,11972
39,brc000d.map,236,247,29315,118,77,117,169,56909,230,147,5,99,-112,70,182,1412,200
40,brc000d.map,236,247,45016,182,184,53,62,31931,129,178,106,68,53,-6,59,60,79
41,brc000d.map,236,247,25891,104,43,131,203,5327,21,106,214,140,83,63,146,467,1180
42,brc000d.map,236,247,36954,149,95,86,151,38982,157,43,78,203,-8,-52,60,61,61
43,brc000d.map,236,247,19577,79,182,156,64,44019,178,193,57,53,-99,11,110,7821,3481
44,brc000d.map,236,247,29819,120,67,115,179,5783,23,144,212,102,97,77,174,385,750
45,brc000d.map,236,247,51762,209,107,26,139,22283,90,193,145,53,119,86,205,3256,2186
46,brc000d.map,236,247,45513,184,181,51,65,27099,109,70,126,176,75,-111,186,1312,755
47,brc000d.map,236,247,54658,221,175,14,71,11726,47,129,188,117,174,-46,220,1577,27386
48,brc000d.map,236,247,21322,86,166,149,80,19855,80,151,155,95,6,-15,21,22,22
49,brc000d.map,236,247,33418,135,173,100,73,30359,122,21,113,225,13,-152,165,1768,10094
50,brc000d.map,236,247,7969,32,181,203,65,40699,164,55,71,191,-132,-126,258,408,602
51,brc000d.map,236,247,7244,29,165,206,81,49765,201,128,34,118,-172,-37,209,7469,3413
52,brc000d.map,236,247,23626,95,85,140,161,8548,34,96,201,150,61,11,72,1140,1256
53,brc000d.map,236,247,20772,84,222,151,24,48495,196,163,39,83,-112,-59,171,27386,1577
54,brc000d.map,236,247,21019,85,222,150,24,22615,91,108,144,138,-6,-114,120,121,652
55,brc000d.map,236,247,13176,53,161,182,85,48287,195,124,40,122,-142,-37,179,5532,2666
56,brc000d.map,236,247,28120,113,37,122,209,18711,75,60,160,186,38,23,61,994,186
57,brc000d.map,236,247,50765,205,116,30,130,29087,117,58,118,188,88,-58,146,304,425
58,brc000d.map,236,247,4824,19,115,216,131,41683,168,59,67,187,-149,-56,205,978,424
59,brc000d.map,236,247,11024,44,90,191,156,38277,154,7,81,239,-110,-83,193,298,204
60,brc000d.map,236,247,41907,169,82,66,164,38684,156,94,79,152,13,12,25,26,26
61,brc000d.map,236,247,44891,181,62,54,184,38215,154,69,81,177,27,7,34,99,126
62,brc000d.map,236,247,53456,216,142,19,104,39973,161,40,74,206,55,-102,157,1577,27386
63,brc000d.map,236,247,4811,19,128,216,118,22919,92,51,143,195,-73,-77,150,1131,397
64,brc000d.map,236,247,48290,195,121,40,125,20058,81,195,154,51,114,74,188,3625,4691
65,brc000d.map,236,247,24349,98,103,137,143,12263,49,86,186,160,49,-17,66,84,67
66,brc000d.map,236,247,22418,90,58,145,188,36482,147,73,88,173,-57,15,72,73,73
67,brc000d.map,236,247,56681,229,128,6,118,3997,16,201,219,45,213,73,286,12425,8965
68,brc000d.map,236,247,18897,76,121,159,125,17246,69,43,166,203,7,-78,85,210,86
69,brc000d.map,236,247,28083,113,74,122,172,6677,27,238,208,8,86,164,250,7731,415
70,brc000d.map,236,247,49037,198,115,37,131,28815,116,83,119,163,82,-32,114,115,422
71,brc000d.map,236,247,41083,166,165,69,81,18439,74,85,161,161,92,-80,172,815,4818
72,brc000d.map,236,247,41652,168,90,67,156,52694,213,163,22,83,-45,73,118,27386,1577
73,brc000d.map,236,247,11546,46,62,189,184,51274,207,101,28,145,-161,39,200,201,228
74,brc000d.map,236,247,5321,21,112,214,134,52500,212,110,23,136,-191,-2,193,1112,529
75,brc000d.map,236,247,48230,195,181,40,65,2543,10,173,225,73,185,-8,193,3566,11836
76,brc000d.map,236,247,34988,141,85,94,161,43558,176,160,59,86,-35,75,110,207,345
77,brc000d.map,236,247,24377,98,75,137,171,17638,71,145,164,101,27,70,97,457,1015
78,brc000d.map,236,247,10040,40,86,195,160,22011,89,218,146,28,-49,132,181,236,5385
79,brc000d.map,236,247,30490,123,137,112,109,2540,10,176,225,70,113,39,152,153,303
80,brc000d.map,236,247,1010,4,224,231,22,6951,28,211,207,35,-24,-13,37,475,306
81,brc000d.map,236,247,5794,23,133,212,113,2524,10,192,225,54,13,59,72,73,73
82,brc000d.map,236,247,13496,54,88,181,158,52184,211,179,24,67,-157,91,248,27386,1577
83,brc000d.map,236,247,36792,148,10,87,236,48014,194,150,41,96,-46,140,186,27386,1577
84,brc000d.map,236,247,28073,113,84,122,162,33278,134,66,101,180,-21,-18,39,47,40
85,brc000d.map,236,247,42864,173,113,62,133,36719,148,83,87,163,25,-30,55,56,115
86,brc000d.map,236,247,12292,49,57,186,189,18357,74,167,161,79,-25,110,135,140,745
87,brc000d.map,236,247,13944,56,134,179,112,25523,103,164,132,82,-47,30,77,78,78
88,brc000d.map,236,247,35512,143,55,92,191,25654,103,33,132,213,40,-22,62,79,71
89,brc000d.map,236,247,96,0,150,235,96,3567,14,137,221,109,-14,-13,27,28,28
90,brc000d.map,236,247,11745,47,110,188,136,52259,211,104,24,142,-164,-6,170,301,171
91,brc000d.map,236,247,48069,194,95,41,151,9446,38,186,197,60,156,91,247,248,687
92,brc000d.map,236,247,32012,129,97,106,149,24076,97,129,138,117,32,32,64,65,65
93,brc000d.map,236,247,23355,94,109,141,137,26557,107,118,128,128,-13,9,22,53,24
94,brc000d.map,236,247,21267,86,221,149,25,54171,219,168,16,78,-133,-53,186,27386,1577
95,brc000d.map,236,247,53425,216,173,19,73,22783,92,187,143,59,124,14,138,1577,27386
96,brc000d.map,236,247,18444,74,80,161,166,19837,80,169,155,77,-6,89,95,96,262
97,brc000d.map,236,247,20826,84,168,151,78,22014,89,215,146,31,-5,47,52,53,63
98,brc000d.map,236,247,31913,129,196,106,50,22255,90,221,145,25,39,25,64,3459,14019
99,brc000d.map,236,247,4820,19,119,216,127,31925,129,184,106,62,-110,65,175,16150,2813
0,brc100d.map,269,392,67256,171,167,97,224,59834,152,141,116,250,19,-26,45,46,46
1,brc100d.map,269,392,51755,132,380,136,11,12805,32,130,236,261,100,-250,350,18868,19797
2,brc100d.map,269,392,54033,137,62,131,329,19443,49,156,219,235,88,94,182,183,289
3,brc100d.map,269,392,71033,181,310,87,81,22964,58,163,210,228,123,-147,270,8164,7946
4,brc100d.map,269,392,37874,96,149,172,242,30478,77,97,191,294,19,-52,71,5788,10035
5,brc100d.map,269,392,53108,135,203,133,188,41597,106,346,162,45,29,143,172,4346,7332
6,brc100d.map,269,392,21040,53,127,215,264,33233,84,86,184,305,-31,-41,72,73,106
7,brc100d.map,269,392,39306,100,285,168,106,27964,71,259,197,132,29,-26,55,257,361
8,brc100d.map,269,392,59848,152,127,116,264,91384,233,343,35,48,-81,216,297,3595,4709
9,brc100d.map,269,392,40481,103,286,165,105,24193,61,110,207,281,42,-176,218,17229,20860
10,brc100d.map,269,392,74920,191,343,77,48,43695,111,208,157,183,80,-135,215,6054,5117
11,brc100d.map,269,392,84033,214,246,54,145,74153,189,326,79,65,25,80,105,1266,649
12,brc100d.map,269,392,29013,74,386,194,5,44510,113,177,155,214,-39,-209,248,12269,13011
13,brc100d.map,269,392,57513,146,110,122,281,19782,50,209,218,182,96,99,195,7294,4277
14,brc100d.map,269,392,83152,212,343,56,48,61333,156,210,112,181,56,-133,189,4525,4866
15,brc100d.map,269,392,46708,119,331,149,60,54092,137,3,131,388,-18,-328,346,11530,14390
16,brc100d.map,269,392,28236,72,379,196,12,10045,25,146,243,245,47,-233,280,20340,22825
17,brc100d.map,269,392,23433,59,86,209,305,51194,130,157,138,234,-71,71,142,8221,4536
18,brc100d.map,269,392,18210,46,213,222,178,18667,47,148,221,243,-1,-65,66,816,840
19,brc100d.map,269,392,63985,163,302,105,89,44966,114,113,154,278,49,-189,238,7277,7945
20,brc100d.map,269,392,72633,185,278,83,113,71434,182,301,86,90,3,23,26,407,215
21,brc100d.map,269,392,52579,134,340,134,51,30037,76,146,192,245,58,-194,252,9420,9156
22,brc100d.map,269,392,64082,163,205,105,186,39068,99,131,169,260,64,-74,138,2272,4042
23,brc100d.map,269,392,42964,109,155,159,236,52044,132,91,136,300,-23,-64,87,4097,4876
24,brc100d.map,269,392,48544,123,63,145,328,71918,183,209,85,182,-60,146,206,208,2560
25,brc100d.map,269,392,46095,117,160,151,231,32471,82,64,186,327,35,-96,131,4540,8080
26,brc100d.map,269,392,31594,80,157,188,234,67867,173,340,95,51,-93,183,276,8955,9080
27,brc100d.map,269,392,96118,245,313,23,78,71079,181,264,87,127,64,-49,113,1108,433
28,brc100d.map,269,392,40681,103,86,165,305,31662,80,89,188,302,23,3,26,27,27
29,brc100d.map,269,392,62097,158,230,110,161,15469,39,210,229,181,119,-20,139,18900,9046
30,brc100d.map,269,392,10804,27,171,241,220,38110,97,305,171,86,-70,134,204,19313,22184
31,brc100d.map,269,392,54772,139,107,129,284,96693,246,130,22,261,-107,23,130,652,820
32,brc100d.map,269,392,46985,119,54,149,337,59849,152,126,116,265,-33,72,105,111,223
33,brc100d.map,269,392,50491,128,76,140,315,67500,172,315,96,76,-44,239,283,7019,7859
34,brc100d.map,269,392,53674,136,29,132,362,55708,142,347,126,44,-6,318,324,12955,11095
35,brc100d.map,269,392,56155,143,292,125,99,12743,32,192,236,199,111,-100,211,23299,17898
36,brc100d.map,269,392,24208,61,95,207,296,19396,49,203,219,188,12,108,120,3085,915
37,brc100d.map,269,392,51257,130,94,138,297,64076,163,211,105,180,-33,117,150,1806,3274
38,brc100d.map,269,392,29408,75,383,193,8,49645,126,138,142,253,-51,-245,296,12766,13212
39,brc100d.map,269,392,73769,188,318,80,73,11222,28,145,240,246,160,-173,333,18944,13583
40,brc100d.map,269,392,44312,113,375,155,16,96895,247,320,21,71,-134,-55,189,699,1495
41,brc100d.map,269,392,50577,129,382,139,9,51971,132,164,136,227,-3,-218,221,10285,12020
42,brc100d.map,269,392,33992,86,111,182,280,59762,152,213,116,178,-66,102,168,5222,8261
43,brc100d.map,269,392,73144,186,159,82,232,30452,77,123,191,268,109,-36,145,5713,1424
44,brc100d.map,269,392,74212,189,267,79,124,5310,13,177,255,214,176,-90,266,17163,9838
45,brc100d.map,269,392,54768,139,111,129,280,38442,98,365,170,26,41,254,295,20196,10761
46,brc100d.map,269,392,81008,206,135,62,256,59045,150,146,118,245,56,11,67,973,483
47,brc100d.map,269,392,47101,120,330,148,61,54975,140,296,128,95,-20,-34,54,55,55
48,brc100d.map,269,392,69427,177,348,91,43,6877,17,178,251,213,160,-170,330,20661,13680
49,brc100d.map,269,392,53569,136,134,132,257,21361,54,198,214,193,82,64,146,15332,10150
50,brc100d.map,269,392,94568,241,295,27,96,50899,129,60,139,331,112,-235,347,3670,454
51,brc100d.map,269,392,64081,163,206,105,185,73378,187,317,81,74,-24,111,135,4213,2678
52,brc100d.map,269,392,50632,129,327,139,64,39098,99,101,169,290,30,-226,256,11731,15517
53,brc100d.map,269,392,66332,169,307,99,84,93743,239,336,29,55,-70,29,99,853,775
54,brc100d.map,269,392,52052,132,83,136,308,15142,38,145,230,246,94,62,156,161,1388
55,brc100d.map,269,392,26520,67,135,201,256,22966,58,161,210,230,9,26,35,9590,5799
56,brc100d.map,269,392,47256,120,175,148,216,50225,128,342,140,49,-8,167,175,9046,10367
57,brc100d.map,269,392,3388,8,139,260,252,72662,185,249,83,142,-177,110,287,5668,10404
58,brc100d.map,269,392,58995,150,196,118,195,35758,91,305,177,86,59,109,168,5073,5567
59,brc100d.map,269,392,22148,56,195,212,196,34110,87,385,181,6,-31,190,221,22811,25770
60,brc100d.map,269,392,50533,128,34,140,357,41462,105,89,163,302,23,55,78,229,81
61,brc100d.map,269,392,15141,38,146,230,245,51831,132,304,136,87,-94,158,252,17302,18533
62,brc100d.map,269,392,49456,126,327,142,64,69825,178,342,90,49,-52,15,67,776,333
63,brc100d.map,269,392,24936,63,151,205,240,65543,167,312,101,79,-104,161,265,8097,8264
64,brc100d.map,269,392,54593,139,286,129,105,68662,175,329,93,62,-36,43,79,225,81
65,brc100d.map,269,392,94965,242,290,26,101,23381,59,138,209,253,183,-152,335,12348,4332
66,brc100d.map,269,392,41777,106,166,162,225,90037,229,122,39,269,-123,-44,167,1611,239
67,brc100d.map,269,392,82793,211,310,57,81,13579,34,140,234,251,177,-170,347,17054,14023
68,brc100d.map,269,392,13906,35,205,233,186,8491,21,132,247,259,14,-73,87,663,727
69,brc100d.map,269,392,48039,122,176,146,215,49183,125,208,143,183,-3,32,35,3818,3106
70,brc100d.map,269,392,49851,127,324,141,67,40206,102,169,166,222,25,-155,180,10460,9087
71,brc100d.map,269,392,38981,99,218,169,173,76871,196,352,72,39,-97,134,231,5093,7671
72,brc100d.map,269,392,70323,179,236,89,155,48885,124,114,144,277,55,-122,177,2906,1490
73,brc100d.map,269,392,68649,175,342,93,49,91454,233,273,35,118,-58,-69,127,1748,789
74,brc100d.map,269,392,98468,251,315,17,76,69436,177,339,91,52,74,24,98,552,516
75,brc100d.map,269,392,48016,122,199,146,192,68829,175,162,93,229,-53,-37,90,877,1430
76,brc100d.map,269,392,71137,181,206,87,185,58066,148,341,120,50,33,135,168,5451,3723
77,brc100d.map,269,392,9224,23,183,245,208,49277,125,114,143,277,-102,-69,171,10791,9677
78,brc100d.map,269,392,41868,106,75,162,316,19037,48,170,220,221,58,95,153,154,189
79,brc100d.map,269,392,29723,75,68,193,323,30980,79,379,189,12,-4,311,315,23280,14115
80,brc100d.map,269,392,98268,250,123,18,268,646,1,137,267,254,249,14,263,6559,6610
81,brc100d.map,269,392,72696,185,215,83,176,74555,190,316,78,75,-5,101,106,3150,1644
82,brc100d.map,269,392,15552,39,127,229,264,102591,261,112,7,279,-222,-15,237,6917,5749
83,brc100d.map,269,392,82796,211,307,57,84,35117,89,162,179,229,122,-145,267,3308,8608
84,brc100d.map,269,392,42036,107,299,161,92,19847,50,144,218,247,57,-155,212,18579,19433
85,brc100d.map,269,392,44964,114,115,154,276,72599,185,312,83,79,-71,197,268,8053,7499
86,brc100d.map,269,392,21458,54,101,214,290,46574,118,73,150,318,-64,-28,92,194,141
87,brc100d.map,269,392,40596,103,171,165,220,40471,103,296,165,95,0,125,125,10403,10616
88,brc100d.map,269,392,31185,79,174,189,217,46701,119,338,149,53,-40,164,204,9294,11734
89,brc100d.map,269,392,96883,247,332,21,59,43948,112,347,156,44,135,15,150,3156,2724
90,brc100d.map,269,392,48147,122,68,146,323,40470,103,297,165,94,19,229,248,19899,9924
91,brc100d.map,269,392,55560,141,103,127,288,53984,137,111,131,280,4,8,12,13,13
92,brc100d.map,269,392,64763,165,308,103,83,45887,117,368,151,23,48,60,108,2014,342
93,brc100d.map,269,392,96908,247,307,21,84,11567,29,192,239,199,218,-115,333,20876,5690
94,brc100d.map,269,392,56241,143,206,125,185,27758,70,73,198,318,73,-133,206,5798,8987
95,brc100d.map,269,392,36758,93,89,175,302,63662,162,233,106,158,-69,144,213,3738,5861
96,brc100d.map,269,392,31600,80,151,188,240,52994,135,317,133,74,-55,166,221,9119,9195
97,brc100d.map,269,392,87070,222,345,46,46,65719,167,136,101,255,55,-209,264,4153,4779
98,brc100d.map,269,392,36862,94,377,174,14,14686,37,209,231,182,57,-168,225,23759,22639
99,brc100d.map,269,392,88456,225,135,43,256,52903,134,16,134,375,91,-119,210,1210,1966
0,brc101d.map,498,315,95328,302,116,195,198,9943,31,136,466,178,271,20,291,8855,6661
1,brc101d.map,498,315,23200,73,109,424,205,92182,292,112,205,202,-219,3,222,6622,8281
2,brc101d.map,498,315,147581,468,153,29,161,20063,63,96,434,218,405,-57,462,17686,12288
3,brc101d.map,498,315,120059,381,270,116,44,66548,211,231,286,83,170,-39,209,4218,3626
4,brc101d.map,498,315,25408,80,106,417,208,120689,383,270,114,44,-303,164,467,4079,13721
5,brc101d.map,498,315,86536,274,88,223,226,60857,193,252,304,62,81,164,245,874,448
6,brc101d.map,498,315,66867,212,227,285,87,135606,430,158,67,156,-218,-69,287,5885,2132
7,brc101d.map,498,315,140106,444,68,53,246,59942,190,222,307,92,254,154,408,7397,13391
8,brc101d.map,498,315,93771,297,98,200,216,78878,250,186,247,128,47,88,135,145,136
9,brc101d.map,498,315,149195,473,114,24,200,58020,184,254,313,60,289,140,429,5092,10835
10,brc101d.map,498,315,98977,314,247,183,67,21939,69,110,428,204,245,-137,382,10175,4269
11,brc101d.map,498,315,51289,162,55,335,259,121013,384,261,113,53,-222,206,428,1016,555
12,brc101d.map,498,315,138522,439,77,58,237,123119,390,45,107,269,49,-32,81,459,240
13,brc101d.map,498,315,136658,433,51,64,263,136029,431,50,66,264,2,-1,3,4,4
14,brc101d.map,498,315,40872,129,77,368,237,50360,159,39,338,275,-30,-38,68,69,88
15,brc101d.map,498,315,100321,318,163,179,151,37092,117,77,380,237,201,-86,287,7376,4017
16,brc101d.map,498,315,114051,362,293,135,21,53886,171,293,326,21,191,0,191,4320,5623
17,brc101d.map,498,315,101924,323,135,174,179,95655,303,104,194,210,20,-31,51,380,67
18,brc101d.map,498,315,137904,437,65,60,249,154825,491,154,6,160,-54,89,143,180,271
19,brc101d.map,498,315,114020,361,9,136,305,57223,181,106,316,208,180,97,277,5270,3599
20,brc101d.map,498,315,152929,485,160,12,154,115959,368,275,129,39,117,115,232,6755,5900
21,brc101d.map,498,315,87467,277,102,220,212,46574,147,45,350,269,130,-57,187,2778,4257
22,brc101d.map,498,315,53809,170,55,327,259,149812,475,127,22,187,-305,72,377,11330,12748
23,brc101d.map,498,315,121152,384,122,113,192,151722,481,107,16,207,-97,-15,112,1197,2496
24,brc101d.map,498,315,41822,132,72,365,242,94647,300,167,197,147,-168,95,263,756,3901
25,brc101d.map,498,315,95545,303,214,194,100,145678,462,166,35,148,-159,-48,207,4492,3185
26,brc101d.map,498,315,152037,482,107,15,207,72943,231,136,266,178,251,29,280,6948,8486
27,brc101d.map,498,315,113784,361,245,136,69,117861,374,263,123,51,-13,18,31,32,32
28,brc101d.map,498,315,56466,179,233,318,81,59626,189,223,308,91,-10,-10,20,21,21
29,brc101d.map,498,315,100243,318,241,179,73,37077,117,92,380,222,201,-149,350,8841,2304
30,brc101d.map,498,315,105139,333,70,164,244,96604,306,100,191,214,27,30,57,58,58
31,brc101d.map,498,315,67811,215,228,282,86,75444,239,155,258,159,-24,-73,97,611,320
32,brc101d.map,498,315,68140,216,214,281,100,136334,432,60,65,254,-216,-154,370,12044,11153
33,brc101d.map,498,315,95882,304,192,193,122,96830,307,189,190,125,-3,-3,6,7,7
34,brc101d.map,498,315,62736,199,263,298,51,105472,334,52,163,262,-135,-211,346,1020,5461
35,brc101d.map,498,315,140736,446,68,51,246,51046,162,298,335,16,284,230,514,7664,14253
36,brc101d.map,498,315,80498,255,141,242,173,89276,283,183,214,131,-28,42,70,110,543
37,brc101d.map,498,315,70736,224,138,273,176,121970,387,249,110,65,-163,111,274,824,341
38,brc101d.map,498,315,102351,324,23,173,291,67895,215,144,282,170,109,121,230,594,3396
39,brc101d.map,498,315,105766,335,73,162,241,94062,298,122,199,192,37,49,86,87,87
40,brc101d.map,498,315,139804,443,55,54,259,144471,458,113,39,201,-15,58,73,78,74
41,brc101d.map,498,315,8065,25,124,472,190,89983,285,106,212,208,-260,-18,278,7022,7808
42,brc101d.map,498,315,106852,339,247,158,67,74197,235,142,262,172,104,-105,209,276,759
43,brc101d.map,498,315,144104,457,165,40,149,119445,379,254,118,60,78,89,167,6767,6003
44,brc101d.map,498,315,151082,479,117,18,197,19083,60,131,437,183,419,14,433,18426,14710
45,brc101d.map,498,315,43089,136,65,361,249,88115,279,84,218,230,-143,19,162,4570,4490
46,brc101d.map,498,315,146330,464,144,33,170,121652,386,252,111,62,78,108,186,7971,7032
47,brc101d.map,498,315,122731,389,118,108,196,144820,459,79,38,235,-70,-39,109,1923,3627
48,brc101d.map,498,315,103491,328,143,169,171,85827,272,167,225,147,56,24,80,81,82
49,brc101d.map,498,315,64354,204,220,293,94,81455,258,129,239,185,-54,-91,145,319,739
50,brc101d.map,498,315,138443,439,156,58,158,137619,436,35,61,279,3,-121,124,1109,2344
51,brc101d.map,498,315,26987,85,102,412,212,82439,261,90,236,224,-176,-12,188,6632,7778
52,brc101d.map,498,315,96917,307,102,190,212,59911,190,253,307,61,117,151,268,871,471
53,brc101d.map,498,315,134788,427,31,70,283,82444,261,85,236,229,166,54,220,4035,2779
54,brc101d.map,498,315,119752,380,262,117,52,153881,488,153,9,161,-108,-109,217,6870,7284
55,brc101d.map,498,315,100348,318,136,179,178,147286,467,133,30,181,-149,-3,152,2806,2993
56,brc101d.map,498,315,96227,305,162,192,152,152607,484,167,13,147,-179,5,184,2351,3608
57,brc101d.map,498,315,108531,344,143,153,171,120382,382,262,115,52,-38,119,157,2791,4250
58,brc101d.map,498,315,61312,194,112,303,202,149790,475,149,22,165,-281,37,318,6908,7775
59,brc101d.map,498,315,26658,84,116,413,198,38982,123,77,374,237,-39,-39,78,169,79
60,brc101d.map,498,315,93359,296,195,201,119,54551,173,258,324,56,123,63,186,1418,3216
61,brc101d.map,498,315,82051,260,163,237,151,127742,405,147,92,167,-145,-16,161,2906,2082
62,brc101d.map,498,315,84642,268,92,229,222,126606,401,23,96,291,-133,-69,202,2318,2079
63,brc101d.map,498,315,97753,310,211,187,103,103875,329,74,168,240,-19,-137,156,2105,1775
64,brc101d.map,498,315,59138,187,81,310,233,154502,490,162,7,152,-303,81,384,6329,9368
65,brc101d.map,498,315,126176,400,138,97,176,79897,253,112,244,202,147,-26,173,1003,2730
66,brc101d.map,498,315,94321,299,178,198,136,116627,370,237,127,77,-71,59,130,878,413
67,brc101d.map,498,315,110000,349,249,148,65,108438,344,236,153,78,5,-13,18,19,19
68,brc101d.map,498,315,149202,473,107,24,207,1763,5,126,492,188,468,19,487,17964,14850
69,brc101d.map,498,315,20043,63,116,434,198,82039,260,175,237,139,-197,59,256,3908,7659
70,brc101d.map,498,315,140386,445,103,52,211,102877,326,127,171,187,119,24,143,5121,5631
71,brc101d.map,498,315,120510,382,134,115,180,153583,487,136,10,178,-105,2,107,1188,1461
72,brc101d.map,498,315,146987,466,117,31,197,117550,373,259,124,55,93,142,235,8681,8045
73,brc101d.map,498,315,98186,311,93,186,221,74751,237,218,260,96,74,125,199,475,282
74,brc101d.map,498,315,42787,135,52,362,262,148221,470,143,27,171,-335,91,426,10912,11068
75,brc101d.map,498,315,136862,434,162,63,152,85270,270,94,227,220,164,-68,232,1651,3782
76,brc101d.map,498,315,42753,135,86,362,228,136977,434,47,63,267,-299,-39,338,14014,13479
77,brc101d.map,498,315,51731,164,243,333,71,117253,372,241,125,73,-208,-2,210,3916,4277
78,brc101d.map,498,315,93698,297,171,200,143,73803,234,221,263,93,63,50,113,202,114
79,brc101d.map,498,315,95532,303,227,194,87,41517,131,62,366,252,172,-165,337,403,4360
80,brc101d.map,498,315,133506,423,53,74,261,84003,266,101,231,213,157,48,205,3425,4761
81,brc101d.map,498,315,59744,189,105,308,209,97828,310,136,187,178,-121,31,152,1708,2551
82,brc101d.map,498,315,133211,422,33,75,281,117212,372,282,125,32,50,249,299,11545,9595
83,brc101d.map,498,315,116279,369,270,128,44,113431,360,283,137,31,9,13,22,23,23
84,brc101d.map,498,315,136645,433,64,64,250,128573,408,261,89,53,25,197,222,11560,12925
85,brc101d.map,498,315,58051,184,223,313,91,133507,423,52,74,262,-239,-171,410,12225,4311
86,brc101d.map,498,315,117569,373,240,124,74,64046,203,213,294,101,170,-27,197,4420,3855
87,brc101d.map,498,315,12793,40,121,457,193,145062,460,152,37,162,-420,31,451,12402,15030
88,brc101d.map,498,315,18465,58,119,439,195,95322,302,122,195,192,-244,3,247,6495,8104
89,brc101d.map,498,315,77019,244,155,253,159,150422,477,147,20,167,-233,-8,241,6544,5599
90,brc101d.map,498,315,49083,155,56,342,258,116086,368,148,129,166,-213,92,305,3705,4530
91,brc101d.map,498,315,2077,6,127,491,187,117246,372,248,125,66,-366,121,487,4771,13483
92,brc101d.map,498,315,120363,382,281,115,33,149772,475,167,22,147,-93,-114,207,6104,7116
93,brc101d.map,498,315,70730,224,144,273,170,136958,434,66,63,248,-210,-78,288,11431,5878
94,brc101d.map,498,315,53896,171,283,326,31,121470,385,119,112,195,-214,-164,378,7292,1325
95,brc101d.map,498,315,72223,229,226,268,88,64039,203,220,294,94,26,-6,32,33,33
96,brc101d.map,498,315,114650,363,9,134,305,143155,454,169,43,145,-91,160,251,3486,2384
97,brc101d.map,498,315,69706,221,223,276,91,5559,17,110,480,204,204,-113,317,12002,7163
98,brc101d.map,498,315,25385,80,129,417,185,130467,414,257,83,57,-334,128,462,4662,13509
99,brc101d.map,498,315,48776,154,48,343,266,56713,180,301,317,13,-26,253,279,7057,3645
0,brc200d.map,206,511,54723,107,464,98,46,23239,45,266,160,244,62,-198,260,3027,403
1,brc200d.map,206,511,45245,88,233,117,277,90191,176,255,29,255,-88,22,110,270,114
2,brc200d.map,206,511,80496,157,241,48,269,6412,12,230,193,280,145,-11,156,157,271
3,brc200d.map,206,511,50096,98,492,107,18,54745,107,442,98,68,-9,-50,59,60,60
4,brc200d.map,206,511,50292,98,296,107,214,45844,89,145,116,365,9,-151,160,7709,6441
5,brc200d.map,206,511,22737,44,257,161,253,50174,98,414,107,96,-54,157,211,1354,1923
6,brc200d.map,206,511,74385,145,220,60,290,54115,105,50,100,460,40,-170,210,1349,3250
7,brc200d.map,206,511,26289,51,282,154,228,48204,94,340,111,170,-43,58,101,880,379
8,brc200d.map,206,511,15589,30,251,175,259,51199,100,411,105,99,-70,160,230,1229,932
9,brc200d.map,206,511,92228,180,262,25,248,53686,105,479,100,31,75,217,292,1045,2121
10,brc200d.map,206,511,55722,109,487,96,23,50030,97,47,108,463,12,-440,452,8470,7954
11,brc200d.map,206,511,77936,152,246,53,264,94814,185,231,20,279,-33,-15,48,112,49
12,brc200d.map,206,511,48981,95,74,110,436,52861,103,282,102,228,-8,208,216,8320,7396
13,brc200d.map,206,511,52224,102,408,103,102,52655,103,488,102,22,-1,80,81,82,82
14,brc200d.map,206,511,5388,10,232,195,278,49789,97,288,108,222,-87,56,143,249,274
15,brc200d.map,206,511,12034,23,229,182,281,49419,96,147,109,363,-73,-82,155,2148,821
16,brc200d.map,206,511,2836,5,229,200,281,98894,193,239,12,271,-188,10,198,265,199
17,brc200d.map,206,511,95818,187,249,18,261,54819,107,368,98,142,80,119,199,1644,690
18,brc200d.map,206,511,6912,13,241,192,269,34597,67,150,138,360,-54,-91,145,4133,833
19,brc200d.map,206,511,50146,98,442,107,68,18135,35,260,170,250,63,-182,245,1063,1454
20,brc200d.map,206,511,88139,172,263,33,247,20159,39,280,166,230,133,17,150,784,870
21,brc200d.map,206,511,50193,98,395,107,115,17650,34,234,171,276,64,-161,225,1804,2486
22,brc200d.map,206,511,31949,62,243,143,267,53342,104,312,101,198,-42,69,111,1380,1652
23,brc200d.map,206,511,53849,105,316,100,194,9993,19,226,186,284,86,-90,176,441,273
24,brc200d.map,206,511,29951,58,197,147,313,22775,44,219,161,291,14,22,36,159,150
25,brc200d.map,206,511,75916,148,222,57,288,49724,97,353,108,157,51,131,182,2197,2183
26,brc200d.map,206,511,54379,106,297,99,213,55011,107,176,98,334,-1,-121,122,4067,4310
27,brc200d.map,206,511,76909,150,251,55,259,44173,86,283,119,227,64,32,96,1517,1118
28,brc200d.map,206,511,50200,98,388,107,122,32467,63,236,142,274,35,-152,187,2832,2651
29,brc200d.map,206,511,52489,102,143,103,367,86619,169,250,36,260,-67,107,174,246,1309
30,brc200d.map,206,511,88120,172,282,33,228,48717,95,338,110,172,77,56,133,283,263
31,brc200d.map,206,511,32506,63,197,142,313,51324,100,286,105,224,-37,89,126,2636,2405
32,brc200d.map,206,511,67212,131,239,74,271,84623,165,202,40,308,-34,-37,71,168,84
33,brc200d.map,206,511,760,1,261,204,249,80478,157,259,48,251,-156,-2,158,1233,1094
34,brc200d.map,206,511,53042,103,101,102,409,19149,37,268,168,242,66,167,233,2705,2816
35,brc200d.map,206,511,16642,32,220,173,290,54155,105,10,100,500,-73,-210,283,497,1943
36,brc200d.map,206,511,50800,99,299,106,211,91734,179,245,26,265,-80,-54,134,386,468
37,brc200d.map,206,511,18170,35,225,170,285,56054,109,155,96,355,-74,-70,144,361,374
38,brc200d.map,206,511,21267,41,194,164,316,63684,124,190,81,320,-83,-4,87,117,88
39,brc200d.map,206,511,55137,107,50,98,460,53306,104,348,101,162,3,298,301,6289,6108
40,brc200d.map,206,511,68756,134,228,71,282,59029,115,246,90,264,19,18,37,42,104
41,brc200d.map,206,511,24240,47,287,158,223,53629,104,25,101,485,-57,-262,319,3017,4222
42,brc200d.map,206,511,78440,153,253,52,257,53675,105,490,100,20,48,237,285,1273,3540
43,brc200d.map,206,511,84579,165,246,40,264,18700,36,206,169,304,129,-40,169,204,586
44,brc200d.map,206,511,25842,50,218,155,292,95815,187,252,18,258,-137,34,171,541,175
45,brc200d.map,206,511,49077,96,489,109,21,52678,103,465,102,45,-7,-24,31,32,32
46,brc200d.map,206,511,50226,98,362,107,148,53606,104,48,101,462,-6,-314,320,5204,7867
47,brc200d.map,206,511,55102,107,85,98,425,89214,174,210,31,300,-67,125,192,280,1089
48,brc200d.map,206,511,52861,103,282,102,228,94807,185,238,20,272,-82,-44,126,298,2358
49,brc200d.map,206,511,87164,170,216,35,294,51445,100,165,105,345,70,-51,121,198,193
50,brc200d.map,206,511,54746,107,441,98,69,54868,107,319,98,191,0,-122,122,235,408
51,brc200d.map,206,511,57503,112,239,93,271,18695,36,211,169,299,76,-28,104,139,105
52,brc200d.map,206,511,26790,52,292,153,218,49751,97,326,108,184,-45,34,79,486,311
53,brc200d.map,206,511,50224,98,364,107,146,18190,35,205,170,305,63,-159,222,2460,3146
54,brc200d.map,206,511,48504,94,40,111,470,5871,11,260,194,250,83,220,303,1537,4083
55,brc200d.map,206,511,54811,107,376,98,134,22278,43,205,162,305,64,-171,235,2805,1878
56,brc200d.map,206,511,47282,92,240,113,270,79527,155,188,50,322,-63,-52,115,1447,1027
57,brc200d.map,206,511,51209,100,401,105,109,56550,110,170,95,340,-10,-231,241,6071,4787
58,brc200d.map,206,511,50101,98,487,107,23,52143,102,489,103,21,-4,2,6,7,7
59,brc200d.map,206,511,50081,98,507,107,3,55365,108,333,97,177,-10,-174,184,185,354
60,brc200d.map,206,511,34604,67,143,138,367,49109,96,457,109,53,-29,314,343,7925,10490
61,brc200d.map,206,511,56578,110,142,95,368,43286,84,148,121,362,26,6,32,33,33
62,brc200d.map,206,511,22232,43,251,162,259,53102,103,41,102,469,-60,-210,270,2354,3143
63,brc200d.map,206,511,53195,104,459,101,51,43287,84,147,121,363,20,-312,332,9875,5051
64,brc200d.map,206,511,56989,111,242,94,268,52839,103,304,102,206,8,62,70,2179,2913
65,brc200d.map,206,511,66244,129,185,76,325,70775,138,253,67,257,-9,68,77,736,1696
66,brc200d.map,206,511,21784,42,188,163,322,68247,133,226,72,284,-91,38,129,2731,1276
67,brc200d.map,206,511,42736,83,187,122,323,74879,146,237,59,273,-63,50,113,1281,1874
68,brc200d.map,206,511,49032,95,23,110,487,49010,95,45,110,465,0,22,22,28,45
69,brc200d.map,206,511,86652,169,217,36,293,51061,99,38,106,472,70,-179,249,435,321
70,brc200d.map,206,511,99410,194,234,11,276,35483,69,286,136,224,125,52,177,2487,513
71,brc200d.map,206,511,50266,98,322,107,188,77990,152,192,53,318,-54,-130,184,2000,2771
72,brc200d.map,206,511,49418,96,148,109,362,54070,105,95,100,415,-9,-53,62,72,116
73,brc200d.map,206,511,53056,103,87,102,423,54091,105,74,100,436,-2,-13,15,16,16
74,brc200d.map,206,511,57166,111,65,94,445,50135,98,453,107,57,13,388,401,8080,8239
75,brc200d.map,206,511,1314,2,218,203,292,47383,92,139,113,371,-90,-79,169,2432,2393
76,brc200d.map,206,511,34598,67,149,138,361,20223,39,216,166,294,28,67,95,652,2557
77,brc200d.map,206,511,54513,106,163,99,347,76878,150,282,55,228,-44,119,163,2076,3228
78,brc200d.map,206,511,82049,160,221,45,289,84086,164,228,41,282,-4,7,11,12,12
79,brc200d.map,206,511,85592,167,255,38,255,22230,43,253,162,257,124,-2,126,1124,688
80,brc200d.map,206,511,19716,38,212,167,298,59503,116,283,89,227,-78,71,149,2280,1172
81,brc200d.map,206,511,68235,133,238,72,272,51142,100,468,105,42,33,230,263,2248,4118
82,brc200d.map,206,511,73298,143,285,62,225,84061,164,253,41,257,-21,-32,53,73,228
83,brc200d.map,206,511,63209,123,154,82,356,84567,165,258,40,252,-42,104,146,486,3510
84,brc200d.map,206,511,73331,143,252,62,258,60006,117,291,88,219,26,39,65,1006,790
85,brc200d.map,206,511,52976,103,167,102,343,54258,106,418,99,92,-3,251,254,5686,5898
86,brc200d.map,206,511,71353,139,186,66,324,56663,110,57,95,453,29,-129,158,662,362
87,brc200d.map,206,511,50290,98,298,107,212,41710,81,191,124,319,17,-107,124,3274,3364
88,brc200d.map,206,511,47176,92,346,113,164,10473,20,257,185,253,72,-89,161,2023,1798
89,brc200d.map,206,511,30366,59,293,146,217,74319,145,286,60,224,-86,-7,93,165,94
90,brc200d.map,206,511,55918,109,291,96,219,27303,53,290,152,220,56,-1,57,58,58
91,brc200d.map,206,511,16608,32,254,173,256,79474,155,241,50,269,-123,-13,136,396,552
92,brc200d.map,206,511,74414,145,191,60,319,10991,21,250,184,260,124,59,183,388,184
93,brc200d.map,206,511,53475,104,179,101,331,54791,107,396,98,114,-3,217,220,5659,5499
94,brc200d.map,206,511,41753,81,148,124,362,43661,85,284,120,226,-4,136,140,4550,5445
95,brc200d.map,206,511,51987,101,134,104,376,53211,104,443,101,67,-3,309,312,5182,6461
96,brc200d.map,206,511,48397,94,147,111,363,29415,57,222,148,288,37,75,112,2197,2453
97,brc200d.map,206,511,28906,56,220,149,290,52311,102,321,103,189,-46,101,147,1678,1608
98,brc200d.map,206,511,68281,133,192,72,318,39108,76,238,129,272,57,46,103,1688,2559
99,brc200d.map,206,511,50657,99,442,106,68,55050,107,137,98,373,-8,-305,313,7198,6582
0,brc201d.map,387,389,40600,104,244,282,144,134521,345,72,41,316,-241,-172,413,15336,10326
1,brc201d.map,387,389,86938,223,197,163,191,25078,64,206,322,182,159,9,168,5897,7561
2,brc201d.map,387,389,76688,197,333,189,55,52168,134,346,252,42,63,13,76,589,488
3,brc201d.map,387,389,70443,181,354,205,34,67717,174,357,212,31,7,3,10,11,11
4,brc201d.map,387,389,97746,251,281,135,107,100035,257,326,129,62,-6,45,51,52,84
5,brc201d.map,387,389,123241,316,71,70,317,128286,329,83,57,305,-13,12,25,26,26
6,brc201d.map,387,389,80189,206,333,180,55,39327,101,350,285,38,105,17,122,21066,233
7,brc201d.map,387,389,9137,23,198,363,190,125197,321,60,65,328,-298,-138,436,15329,10453
8,brc201d.map,387,389,54107,139,352,247,36,29638,76,314,310,74,63,-38,101,112,137
9,brc201d.map,387,389,9227,23,108,363,280,63422,163,373,223,15,-140,265,405,3883,6067
10,brc201d.map,387,389,133725,343,90,43,298,113903,292,73,94,315,51,-17,68,69,69
11,brc201d.map,387,389,106648,274,326,112,62,103483,266,379,120,9,8,53,61,21066,123
12,brc201d.map,387,389,102380,263,315,123,73,65045,167,306,219,82,96,-9,105,679,1353
13,brc201d.map,387,389,126338,324,86,62,302,97164,249,85,137,303,75,-1,76,120,97
14,brc201d.map,387,389,138753,356,119,30,269,57598,148,362,238,26,208,243,451,231,21066
15,brc201d.map,387,389,49892,128,288,258,100,45949,118,341,268,47,10,53,63,523,1013
16,brc201d.map,387,389,71873,184,91,202,297,94061,241,76,145,312,-57,-15,72,167,73
17,brc201d.map,387,389,41286,106,336,280,52,136431,350,107,36,281,-244,-229,473,14534,10869
18,brc201d.map,387,389,110901,285,352,101,36,143525,368,15,18,373,-83,-337,420,151,444
19,brc201d.map,387,389,76444,196,188,190,200,65821,169,308,217,80,27,120,147,4342,5589
20,brc201d.map,387,389,115061,295,82,91,306,110917,285,336,101,52,10,254,264,5385,7049
21,brc201d.map,387,389,63809,164,375,222,13,143130,367,21,19,367,-203,-354,557,21066,444
22,brc201d.map,387,389,118953,305,80,81,308,45958,118,332,268,56,187,252,439,10539,12464
23,brc201d.map,387,389,97400,250,238,136,150,45185,116,327,270,61,134,89,223,21066,155
24,brc201d.map,387,389,46330,119,349,267,39,66540,171,367,215,21,-52,18,70,233,21066
25,brc201d.map,387,389,71793,184,171,202,217,33508,86,334,300,54,98,163,261,5789,9042
26,brc201d.map,387,389,110107,283,368,103,20,70479,181,318,205,70,102,-50,152,123,21066
27,brc201d.map,387,389,148584,381,13,5,375,101959,262,347,124,41,119,334,453,444,21066
28,brc201d.map,387,389,77102,198,308,188,80,103126,265,347,121,41,-67,39,106,52,21066
29,brc201d.map,387,389,69716,179,303,207,85,52541,135,362,251,26,44,59,103,107,105
30,brc201d.map,387,389,42934,110,244,276,144,99318,255,265,131,123,-145,21,166,3289,3139
31,brc201d.map,387,389,30120,77,221,309,167,80590,207,321,179,67,-130,100,230,21066,250
32,brc201d.map,387,389,52389,134,125,252,263,119742,307,69,79,319,-173,-56,229,779,238
33,brc201d.map,387,389,132576,340,72,46,316,67381,173,304,213,84,167,232,399,10051,12130
34,brc201d.map,387,389,146250,375,13,11,375,66980,172,316,214,72,203,303,506,444,21066
35,brc201d.map,387,389,106332,273,253,113,135,127525,327,66,59,322,-54,-187,241,345,21066
36,brc201d.map,387,389,65808,169,321,217,67,38550,99,349,287,39,70,28,98,21066,233
37,brc201d.map,387,389,127910,328,70,58,318,84983,218,207,168,181,110,137,247,5117,3146
38,brc201d.map,387,389,90028,231,219,155,169,65590,168,150,218,238,63,-69,132,164,146
39,brc201d.map,387,389,102752,264,332,122,56,106899,274,75,112,313,-10,-257,267,6755,5183
40,brc201d.map,387,389,79274,203,81,183,307,94835,243,80,143,308,-40,-1,41,42,42
41,brc201d.map,387,389,16920,43,195,343,193,99349,255,234,131,154,-212,39,251,5174,5482
42,brc201d.map,387,389,57276,147,295,239,93,11068,28,212,358,176,119,-83,202,1622,258
43,brc201d.map,387,389,24577,63,318,323,70,16529,42,197,344,191,21,-121,142,117,21066
44,brc201d.map,387,389,132235,339,24,47,364,69670,179,349,207,39,160,325,485,60,21066
45,brc201d.map,387,389,112454,289,355,97,33,92743,238,227,148,161,51,-128,179,151,21066
46,brc201d.map,387,389,129435,332,101,54,287,130191,334,123,52,265,-2,22,24,25,25
47,brc201d.map,387,389,65251,167,100,219,288,64046,164,138,222,250,3,38,41,42,42
48,brc201d.map,387,389,30044,77,297,309,91,62093,159,146,227,242,-82,-151,233,8066,8496
49,brc201d.map,387,389,104176,267,75,119,313,105824,272,372,114,16,-5,297,302,21066,123
50,brc201d.map,387,389,28080,72,316,314,72,101502,260,26,126,362,-188,-290,478,21066,6
51,brc201d.map,387,389,125556,322,90,64,298,84871,218,319,168,69,104,229,333,21066,250
52,brc201d.map,387,389,31294,80,214,306,174,78398,201,179,185,209,-121,-35,156,9051,6246
53,brc201d.map,387,389,102994,264,90,122,298,86547,222,199,164,189,42,109,151,107,21066
54,brc201d.map,387,389,62120,159,119,227,269,42514,109,275,277,113,50,156,206,21066,84
55,brc201d.map,387,389,65362,168,378,218,10,112860,290,338,96,50,-122,-40,162,1114,192
56,brc201d.map,387,389,76560,196,72,190,316,6502,16,110,370,278,180,38,218,10548,13938
57,brc201d.map,387,389,94051,241,86,145,302,52165,134,349,252,39,107,263,370,7953,13016
58,brc201d.map,387,389,6885,17,116,369,272,19637,50,201,336,187,-33,85,118,153,520
59,brc201d.map,387,389,61939,159,300,227,88,79421,204,323,182,65,-45,23,68,21066,250
60,brc201d.map,387,389,116272,298,38,88,350,67176,172,120,214,268,126,82,208,1478,1395
61,brc201d.map,387,389,101827,261,90,125,298,40611,104,233,282,155,157,143,300,107,21066
62,brc201d.map,387,389,129858,333,67,53,321,57997,149,352,237,36,184,285,469,8886,12840
63,brc201d.map,387,389,67363,173,322,213,66,108175,278,355,108,33,-105,33,138,21066,151
64,brc201d.map,387,389,47136,121,321,265,67,62665,161,352,225,36,-40,31,71,8,21066
65,brc201d.map,387,389,103873,267,378,119,10,38964,100,324,286,64,167,-54,221,123,155
66,brc201d.map,387,389,69714,179,305,207,83,59916,154,378,232,10,25,73,98,647,99
67,brc201d.map,387,389,125920,323,115,63,273,138843,356,29,30,359,-33,-86,119,21066,444
68,brc201d.map,387,389,23130,59,209,327,179,46943,120,125,266,263,-61,-84,145,13291,8666
69,brc201d.map,387,389,96188,247,283,139,105,106332,273,253,113,135,-26,-30,56,21066,345
70,brc201d.map,387,389,58388,150,350,236,38,62903,161,114,225,274,-11,-236,247,7985,5679
71,brc201d.map,387,389,71666,184,298,202,90,103514,266,348,120,40,-82,50,132,261,133
72,brc201d.map,387,389,70480,181,317,205,71,46780,120,288,266,100,61,-29,90,125,95
73,brc201d.map,387,389,83035,213,210,173,178,45173,116,339,270,49,97,129,226,4211,7020
74,brc201d.map,387,389,54522,140,326,246,62,82507,212,349,174,39,-72,23,95,21066,144
75,brc201d.map,387,389,24604,63,291,323,97,9621,24,103,362,285,39,-188,227,44,21066
76,brc201d.map,387,389,103861,266,1,120,387,42463,109,326,277,62,157,325,482,66,155
77,brc201d.map,387,389,102237,262,69,124,319,49814,128,366,258,22,134,297,431,130,48
78,brc201d.map,387,389,106616,274,358,112,30,65221,167,130,219,258,107,-228,335,151,21066
79,brc201d.map,387,389,69284,178,346,208,42,61719,158,131,228,257,20,-215,235,6916,4247
80,brc201d.map,387,389,102461,263,234,123,154,69535,178,95,208,293,85,-139,224,2320,417
81,brc201d.map,387,389,103587,266,275,120,113,129446,332,90,54,298,-66,-185,251,6281,5305
82,brc201d.map,387,389,83945,215,78,171,310,73566,189,343,197,45,26,265,291,5383,10311
83,brc201d.map,387,389,50290,129,279,257,109,92751,238,219,148,169,-109,-60,169,4525,3676
84,brc201d.map,387,389,93417,240,331,146,57,51454,132,282,254,106,108,-49,157,235,254
85,brc201d.map,387,389,31178,80,330,306,58,51414,132,322,254,66,-52,-8,60,21066,60
86,brc201d.map,387,389,100816,259,323,127,65,37893,97,228,289,160,162,-95,257,1887,2916
87,brc201d.map,387,389,110596,284,268,102,120,101839,261,78,125,310,23,-190,213,345,21066
88,brc201d.map,387,389,27304,70,314,316,74,98126,252,290,134,98,-182,-24,206,3187,2785
89,brc201d.map,387,389,8414,21,143,365,245,75518,194,336,192,52,-173,193,366,2,21066
90,brc201d.map,387,389,100882,259,257,127,131,129437,332,99,54,289,-73,-158,231,6493,5280
91,brc201d.map,387,389,74208,190,90,196,298,58223,149,126,237,262,41,36,77,79,79
92,brc201d.map,387,389,67769,174,305,212,83,99283,255,300,131,88,-81,-5,86,1389,763
93,brc201d.map,387,389,91469,235,334,151,54,42135,108,265,278,123,127,-69,196,291,296
94,brc201d.map,387,389,92652,238,318,148,70,126719,325,94,61,294,-87,-224,311,157,21066
95,brc201d.map,387,389,62248,160,380,226,8,113510,291,77,95,311,-131,-303,434,12027,8804
96,brc201d.map,387,389,67345,173,340,213,48,107412,276,340,110,48,-103,0,103,104,104
97,brc201d.map,387,389,49886,128,294,258,94,6518,16,94,370,294,112,-200,312,24,21066
98,brc201d.map,387,389,63294,162,112,224,276,9534,24,190,362,198,138,78,216,10195,10240
99,brc201d.map,387,389,135328,347,43,39,345,57658,148,302,238,86,199,259,458,10092,13427
0,brc202d.map,472,503,218785,434,19,37,483,161182,320,280,151,222,114,261,375,8049,10030
1,brc202d.map,472,503,43150,85,107,386,395,119102,236,108,235,394,-151,1,152,4751,2303
2,brc202d.map,472,503,57736,114,108,357,394,191071,379,68,92,434,-265,-40,305,4087,2898
3,brc202d.map,472,503,68415,136,495,335,7,31007,61,178,410,324,75,-317,392,6384,4740
4,brc202d.map,472,503,44825,89,444,382,58,34562,68,144,403,358,21,-300,321,5642,6415
5,brc202d.map,472,503,90970,180,72,291,430,126602,251,153,220,349,-71,81,152,879,2211
6,brc202d.map,472,503,36284,72,434,399,68,217276,431,19,40,483,-359,-415,774,22705,26770
7,brc202d.map,472,503,176274,350,278,121,224,196894,391,281,80,221,-41,3,44,45,45
8,brc202d.map,472,503,163697,325,280,146,222,117437,233,264,238,238,92,-16,108,109,243
9,brc202d.map,472,503,118118,234,86,237,416,63022,125,355,346,147,109,269,378,17183,13307
10,brc202d.map,472,503,155356,308,70,163,432,46124,91,151,380,351,217,81,298,4595,4797
11,brc202d.map,472,503,64945,129,444,342,58,28204,56,466,415,36,73,22,95,1249,525
12,brc202d.map,472,503,141299,280,43,191,459,4935,9,94,462,408,271,51,322,4172,1988
13,brc202d.map,472,503,104960,208,166,263,336,149085,296,305,175,197,-88,139,227,3660,628
14,brc202d.map,472,503,122168,242,60,229,442,113767,226,413,245,89,16,353,369,30275,15711
15,brc202d.map,472,503,141075,280,267,191,235,189859,377,274,94,228,-97,7,104,270,505
16,brc202d.map,472,503,116278,231,417,240,85,70519,140,403,331,99,91,-14,105,832,2000
17,brc202d.map,472,503,93984,186,76,285,426,115639,229,50,242,452,-43,-26,69,70,70
18,brc202d.map,472,503,152098,302,310,169,192,140260,278,76,193,426,24,-234,258,8592,3601
19,brc202d.map,472,503,218755,434,49,37,453,36822,73,399,398,103,361,350,711,32835,29428
20,brc202d.map,472,503,159400,316,50,155,452,67504,134,400,337,102,182,350,532,20431,17347
21,brc202d.map,472,503,69120,137,293,334,209,116491,231,204,240,298,-94,-89,183,19108,15069
22,brc202d.map,472,503,116495,231,200,240,302,84087,167,416,304,86,64,216,280,21179,22423
23,brc202d.map,472,503,100155,199,444,272,58,178509,354,55,117,447,-155,-389,544,19253,21026
24,brc202d.map,472,503,149829,297,64,174,438,146303,290,69,181,433,7,5,12,13,13
25,brc202d.map,472,503,133224,264,70,207,432,91101,181,444,290,58,83,374,457,16603,18533
26,brc202d.map,472,503,117528,233,173,238,329,171238,340,284,131,218,-107,111,218,551,219
27,brc202d.map,472,503,70859,140,63,331,439,112925,224,249,247,253,-84,186,270,3114,3366
28,brc202d.map,472,503,222249,441,76,30,426,223290,443,41,28,461,-2,-35,37,38,58
29,brc202d.map,472,503,198666,394,18,77,484,81047,161,438,310,64,233,420,653,19936,20237
30,brc202d.map,472,503,170243,338,273,133,229,44699,88,67,383,435,250,-206,456,11378,14234
31,brc202d.map,472,503,29707,59,472,412,30,43710,86,50,385,452,-27,-422,449,5835,9444
32,brc202d.map,472,503,21018,41,107,430,395,87075,173,446,298,56,-132,339,471,728,10155
33,brc202d.map,472,503,65457,130,435,341,67,11959,23,112,448,390,107,-323,430,10751,7465
34,brc202d.map,472,503,94400,187,163,284,339,79927,158,49,313,453,29,-114,143,1489,3940
35,brc202d.map,472,503,61698,122,170,349,332,54900,109,429,362,73,13,259,272,4912,8247
36,brc202d.map,472,503,146833,291,42,180,460,140157,278,179,193,323,13,137,150,3578,2015
37,brc202d.map,472,503,220265,437,48,34,454,158406,314,38,157,464,123,-10,133,2586,3144
38,brc202d.map,472,503,143116,284,238,187,264,139053,276,277,195,225,8,39,47,78,48
39,brc202d.map,472,503,77016,153,445,318,57,70979,141,446,330,56,12,1,13,14,14
40,brc202d.map,472,503,40550,80,192,391,310,182031,361,54,110,448,-281,-138,419,8069,2890
41,brc202d.map,472,503,113004,224,170,247,332,215255,427,28,44,474,-203,-142,345,5439,3758
42,brc202d.map,472,503,105958,210,174,261,328,132758,263,33,208,469,-53,-141,194,347,672
43,brc202d.map,472,503,121668,241,57,230,445,211239,419,20,52,482,-178,-37,215,1772,2522
44,brc202d.map,472,503,122571,243,160,228,342,72191,143,240,328,262,100,80,180,14509,11806
45,brc202d.map,472,503,46116,91,159,380,343,58182,115,165,356,337,-24,6,30,31,31
46,brc202d.map,472,503,42513,84,241,387,261,117059,232,139,239,363,-148,-102,250,9899,8075
47,brc202d.map,472,503,116496,231,199,240,303,151874,301,31,170,471,-70,-168,238,402,247
48,brc202d.map,472,503,70073,139,346,332,156,207180,411,55,60,447,-272,-291,563,25776,18034
49,brc202d.map,472,503,95049,188,17,283,485,184321,366,279,105,223,-178,262,440,1111,6761
50,brc202d.map,472,503,205705,408,21,63,481,88978,176,52,295,450,232,31,263,2052,2732
51,brc202d.map,472,503,114284,227,399,244,103,109215,217,438,254,64,10,39,49,129,162
52,brc202d.map,472,503,53241,105,76,366,426,119569,237,144,234,358,-132,68,200,6405,8076
53,brc202d.map,472,503,49554,98,242,373,260,209167,415,80,56,422,-317,-162,479,12741,11523
54,brc202d.map,472,503,102432,203,179,268,323,74573,148,373,323,129,55,194,249,15690,25602
55,brc202d.map,472,503,207208,411,27,60,475,115590,229,99,242,403,182,72,254,3230,2953
56,brc202d.map,472,503,70664,140,258,331,244,209166,415,81,56,421,-275,-177,452,12916,16505
57,brc202d.map,472,503,177282,352,276,119,226,187843,373,278,98,224,-21,2,23,24,24
58,brc202d.map,472,503,122452,243,279,228,223,69358,137,55,334,447,106,-224,330,2212,1168
59,brc202d.map,472,503,150662,299,237,172,265,96406,191,169,280,333,108,-68,176,2798,5129
60,brc202d.map,472,503,49132,97,161,374,341,140661,279,178,192,324,-182,17,199,9673,8976
61,brc202d.map,472,503,202189,401,16,70,486,49701,98,95,373,407,303,79,382,6344,4570
62,brc202d.map,472,503,43580,86,180,385,322,83021,165,476,306,26,-79,296,375,602,4533
63,brc202d.map,472,503,65921,131,474,340,28,120549,239,170,232,332,-108,-304,412,22401,20604
64,brc202d.map,472,503,93468,185,89,286,413,105573,209,56,262,446,-24,-33,57,58,58
65,brc202d.map,472,503,50194,99,105,372,397,118428,235,279,236,223,-136,174,310,9494,7192
66,brc202d.map,472,503,120787,240,435,231,67,68526,136,384,335,118,104,-51,155,950,1540
67,brc202d.map,472,503,34778,69,431,402,71,224262,445,75,26,427,-376,-356,732,26846,27754
68,brc202d.map,472,503,83528,166,472,305,30,73557,146,383,325,119,20,-89,109,143,112
69,brc202d.map,472,503,120313,239,406,232,96,59476,118,380,353,122,121,-26,147,937,3824
70,brc202d.map,472,503,66096,131,299,340,203,40080,79,159,392,343,52,-140,192,597,2600
71,brc202d.map,472,503,99419,197,174,274,328,53659,106,161,365,341,91,-13,104,9435,12375
72,brc202d.map,472,503,118659,235,48,236,454,144589,287,274,184,228,-52,226,278,1363,1094
73,brc202d.map,472,503,68073,135,334,336,168,100938,200,164,271,338,-65,-170,235,23739,14674
74,brc202d.map,472,503,208187,413,54,58,448,51231,101,74,370,428,312,20,332,11455,13093
75,brc202d.map,472,503,144635,287,228,184,274,38293,76,437,395,65,211,209,420,22317,33831
76,brc202d.map,472,503,137578,273,243,198,259,174765,347,278,124,224,-74,35,109,110,231
77,brc202d.map,472,503,70838,140,84,331,418,79039,157,434,314,68,-17,350,367,2406,9271
78,brc202d.map,472,503,119497,237,216,234,286,117951,234,253,237,249,3,37,40,41,41
79,brc202d.map,472,503,162912,323,59,148,443,141079,280,263,191,239,43,204,247,8775,8621
80,brc202d.map,472,503,75093,149,356,322,146,65445,130,447,341,55,19,91,110,122,210
81,brc202d.map,472,503,133378,265,419,206,83,206167,409,62,62,440,-144,-357,501,31201,33931
82,brc202d.map,472,503,75506,150,446,321,56,109469,217,184,254,318,-67,-262,329,24233,15857
83,brc202d.map,472,503,38329,76,401,395,101,62921,125,456,346,46,-49,55,104,319,1743
84,brc202d.map,472,503,216201,429,88,42,414,1395,2,113,469,389,427,25,452,3809,8001
85,brc202d.map,472,503,144052,286,308,185,194,141277,280,65,191,437,6,-243,249,7565,3381
86,brc202d.map,472,503,136652,271,163,200,339,110982,220,180,251,322,51,17,68,69,104
87,brc202d.map,472,503,211204,419,55,52,447,177279,352,279,119,223,67,224,291,7998,16728
88,brc202d.map,472,503,141153,280,189,191,313,222301,441,24,30,478,-161,-165,326,4781,8261
89,brc202d.map,472,503,220292,437,21,34,481,89101,177,432,294,70,260,411,671,26759,20159
90,brc202d.map,472,503,132235,262,53,209,449,116254,231,441,240,61,31,388,419,18996,11987
91,brc202d.map,472,503,125066,248,180,223,322,160685,319,274,152,228,-71,94,165,1932,2399
92,brc202d.map,472,503,7945,15,102,456,400,138082,274,242,197,260,-259,140,399,20437,8586
93,brc202d.map,472,503,69633,138,283,333,219,126850,252,408,219,94,-114,125,239,8165,3776
94,brc202d.map,472,503,31533,62,155,409,347,109725,218,431,253,71,-156,276,432,7712,3728
95,brc202d.map,472,503,68105,135,302,336,200,53118,105,199,366,303,30,-103,133,1697,780
96,brc202d.map,472,503,218234,433,67,38,435,111518,221,147,250,355,212,80,292,4564,7878
97,brc202d.map,472,503,116273,231,422,240,80,21021,41,104,430,398,190,-318,508,6018,11418
98,brc202d.map,472,503,115081,228,105,243,397,143572,285,285,186,217,-57,180,237,321,530
99,brc202d.map,472,503,65115,129,274,342,228,71525,142,403,329,99,-13,129,142,1443,980
0,brc203d.map,365,270,15217,56,172,308,97,64381,238,148,126,121,-182,-24,206,3425,494
1,brc203d.map,365,270,13584,50,185,314,84,38744,143,135,221,134,-93,-50,143,576,197
2,brc203d.map,365,270,5169,19,230,345,39,30802,114,247,250,22,-95,17,112,4911,3275
3,brc203d.map,365,270,87051,322,158,42,111,35206,130,163,234,106,192,5,197,3571,5709
4,brc203d.map,365,270,6244,23,235,341,34,39263,145,156,219,113,-122,-79,201,906,2146
5,brc203d.map,365,270,66066,244,83,120,186,34998,129,101,235,168,115,18,133,3031,3752
6,brc203d.map,365,270,4945,18,184,346,85,2025,7,134,357,135,11,-50,61,400,193
7,brc203d.map,365,270,66017,244,132,120,137,28261,104,88,260,181,140,-44,184,3229,3654
8,brc203d.map,365,270,1435,5,184,359,85,81958,303,121,61,148,-298,-63,361,3631,380
9,brc203d.map,365,270,52553,194,96,170,173,13871,51,168,313,101,143,72,215,722,709
10,brc203d.map,365,270,3057,11,182,353,87,42453,157,206,207,63,-146,24,170,1994,1407
11,brc203d.map,365,270,57646,213,133,151,136,41743,154,106,210,163,59,-27,86,2201,2823
12,brc203d.map,365,270,58177,215,142,149,127,7089,26,200,338,69,189,58,247,3181,3264
13,brc203d.map,365,270,78496,290,73,74,196,26557,98,172,266,97,192,99,291,322,3690
14,brc203d.map,365,270,36610,135,109,229,160,45766,169,133,195,136,-34,24,58,526,212
15,brc203d.map,365,270,30684,113,95,251,174,86807,321,132,43,137,-208,37,245,5790,6757
16,brc203d.map,365,270,35481,131,158,233,111,14958,55,161,309,108,76,3,79,166,453
17,brc203d.map,365,270,5569,20,100,344,169,23591,87,168,277,101,-67,68,135,136,136
18,brc203d.map,365,270,66598,246,91,118,178,48351,179,248,185,21,67,157,224,4237,1925
19,brc203d.map,365,270,13606,50,163,314,106,41126,152,183,212,86,-102,20,122,595,124
20,brc203d.map,365,270,34356,127,203,237,66,88150,326,139,38,130,-199,-64,263,5019,2346
21,brc203d.map,365,270,47160,174,89,190,180,37889,140,180,224,89,34,91,125,265,1932
22,brc203d.map,365,270,1424,5,195,359,74,6377,23,102,341,167,-18,-93,111,135,534
23,brc203d.map,365,270,40100,148,129,216,140,45695,169,204,195,65,-21,75,96,106,192
24,brc203d.map,365,270,87340,323,139,41,130,78109,289,190,75,79,34,51,85,199,738
25,brc203d.map,365,270,93548,346,141,18,128,48092,178,237,186,32,168,96,264,7713,5783
26,brc203d.map,365,270,82471,305,148,59,121,32439,120,230,244,39,185,82,267,5136,6648
27,brc203d.map,365,270,87321,323,158,41,111,51667,191,172,173,97,132,14,146,1823,2825
28,brc203d.map,365,270,57648,213,131,151,138,39765,147,194,217,75,66,63,129,167,705
29,brc203d.map,365,270,45162,167,197,197,72,28181,104,168,260,101,63,-29,92,115,186
30,brc203d.map,365,270,66332,245,87,119,182,27710,102,99,262,170,143,12,155,3262,3749
31,brc203d.map,365,270,51592,191,247,173,22,39485,146,204,218,65,45,-43,88,118,164
32,brc203d.map,365,270,9272,34,177,330,92,98130,363,149,1,120,-329,-28,357,7527,2770
33,brc203d.map,365,270,11730,43,149,321,120,42492,157,167,207,102,-114,18,132,133,133
34,brc203d.map,365,270,86513,320,156,44,113,46886,173,93,191,176,147,-63,210,8456,6645
35,brc203d.map,365,270,70865,262,144,102,125,1198,4,151,360,118,258,7,265,2011,3357
36,brc203d.map,365,270,79003,292,106,72,163,65511,242,98,122,171,50,-8,58,1175,810
37,brc203d.map,365,270,6409,23,70,341,199,68186,252,123,112,146,-229,53,282,4556,5986
38,brc203d.map,365,270,7186,26,103,338,166,27583,102,226,262,43,-76,123,199,6938,4950
39,brc203d.map,365,270,2523,9,176,355,93,24941,92,168,272,101,-83,-8,91,92,92
40,brc203d.map,365,270,84640,313,139,51,130,53641,198,88,166,181,115,-51,166,8317,5158
41,brc203d.map,365,270,77952,288,77,76,192,67108,248,121,116,148,40,44,84,1058,799
42,brc203d.map,365,270,42225,156,164,208,105,14393,53,186,311,83,103,22,125,126,309
43,brc203d.map,365,270,79745,295,174,69,95,65187,241,152,123,117,54,-22,76,1165,1426
44,brc203d.map,365,270,11697,43,182,321,87,7898,29,201,335,68,14,19,33,410,372
45,brc203d.map,365,270,78660,291,179,73,90,40357,149,142,215,127,142,-37,179,4111,6358
46,brc203d.map,365,270,45129,167,230,197,39,9551,35,168,329,101,132,-62,194,402,1001
47,brc203d.map,365,270,52751,195,168,169,101,26087,96,102,268,167,99,-66,165,1048,267
48,brc203d.map,365,270,39225,145,194,219,75,78962,292,147,72,122,-147,-47,194,4997,1355
49,brc203d.map,365,270,38436,142,173,222,96,49975,185,244,179,25,-43,71,114,190,231
50,brc203d.map,365,270,40314,149,185,215,84,67069,248,160,116,109,-99,-25,124,2798,991
51,brc203d.map,365,270,41188,152,121,212,148,66246,245,173,119,96,-93,52,145,4263,3318
52,brc203d.map,365,270,17638,65,181,299,88,3102,11,137,353,132,54,-44,98,230,148
53,brc203d.map,365,270,95990,355,129,9,140,39823,147,136,217,133,208,7,215,5610,5018
54,brc203d.map,365,270,30418,112,91,252,178,49325,182,84,182,185,-70,-7,77,533,373
55,brc203d.map,365,270,50133,185,86,179,183,7967,29,132,335,137,156,46,202,5006,2674
56,brc203d.map,365,270,9565,35,154,329,115,38958,144,191,220,78,-109,37,146,901,164
57,brc203d.map,365,270,55484,205,135,159,134,45159,167,200,197,69,38,65,103,121,280
58,brc203d.map,365,270,27834,103,245,261,24,78918,292,191,72,78,-189,-54,243,7827,2321
59,brc203d.map,365,270,5136,19,263,345,6,7548,27,11,337,258,-8,-252,260,261,748
60,brc203d.map,365,270,51609,191,230,173,39,23317,86,172,278,97,105,-58,163,1421,1873
61,brc203d.map,365,270,47288,175,231,189,38,56019,207,140,157,129,-32,-91,123,1596,2102
62,brc203d.map,365,270,45760,169,139,195,130,44923,166,166,198,103,3,27,30,31,31
63,brc203d.map,365,270,90848,336,141,28,128,15238,56,151,308,118,280,10,290,5023,5503
64,brc203d.map,365,270,64708,239,91,125,178,6789,25,230,339,39,214,139,353,5471,6747
65,brc203d.map,365,270,36016,133,163,231,106,79516,294,133,70,136,-161,-30,191,3366,2447
66,brc203d.map,365,270,4546,16,43,348,226,16283,60,186,304,83,-44,143,187,300,356
67,brc203d.map,365,270,32697,121,242,243,27,11683,43,196,321,73,78,-46,124,3598,4154
68,brc203d.map,365,270,88695,328,134,36,135,51751,191,88,173,181,137,-46,183,8278,5112
69,brc203d.map,365,270,53209,197,250,167,19,50932,188,97,176,172,9,-153,162,2876,3141
70,brc203d.map,365,270,13882,51,157,313,112,39851,147,108,217,161,-96,-49,145,689,1850
71,brc203d.map,365,270,96545,357,114,7,155,4922,18,207,346,62,339,93,432,3424,8630
72,brc203d.map,365,270,6779,25,240,339,29,80071,296,118,68,151,-271,-122,393,3663,7551
73,brc203d.map,365,270,42500,157,159,207,110,43509,161,230,203,39,-4,71,75,988,311
74,brc203d.map,365,270,48624,180,245,184,24,83575,309,124,55,145,-129,-121,250,2239,6795
75,brc203d.map,365,270,6313,23,166,341,103,45174,167,185,197,84,-144,19,163,976,179
76,brc203d.map,365,270,52416,194,233,170,36,41637,154,212,210,57,40,-21,61,62,62
77,brc203d.map,365,270,42217,156,172,208,97,40126,148,103,216,166,8,-69,77,86,80
78,brc203d.map,365,270,78928,292,181,72,88,40594,150,175,214,94,142,-6,148,1339,5777
79,brc203d.map,365,270,34057,126,232,238,37,64983,240,86,124,183,-114,-146,260,4501,1065
80,brc203d.map,365,270,8440,31,199,333,70,80329,297,130,67,139,-266,-69,335,5319,7081
81,brc203d.map,365,270,55114,204,235,160,34,66023,244,126,120,143,-40,-109,149,1888,4986
82,brc203d.map,365,270,25665,95,254,269,15,10903,40,166,324,103,55,-88,143,1184,5132
83,brc203d.map,365,270,76282,282,127,82,142,8503,31,136,333,133,251,9,260,7248,3865
84,brc203d.map,365,270,16035,59,164,305,105,71141,263,138,101,131,-204,-26,230,1765,1543
85,brc203d.map,365,270,54442,201,97,163,172,87347,323,132,41,137,-122,35,157,5258,8313
86,brc203d.map,365,270,65756,243,123,121,146,49972,185,247,179,22,58,124,182,4153,1890
87,brc203d.map,365,270,80561,298,168,66,101,30141,111,98,253,171,187,-70,257,6352,7592
88,brc203d.map,365,270,36563,135,156,229,113,80588,298,141,66,128,-163,-15,178,4059,3251
89,brc203d.map,365,270,31688,117,171,247,98,54718,202,91,162,178,-85,-80,165,321,509
90,brc203d.map,365,270,47284,175,235,189,34,7501,27,58,337,211,148,-177,325,5793,1887
91,brc203d.map,365,270,54941,203,138,161,131,40334,149,165,215,104,54,27,81,472,809
92,brc203d.map,365,270,10336,38,193,326,76,41395,153,184,211,85,-115,-9,124,940,1203
93,brc203d.map,365,270,38730,143,149,221,120,89789,332,120,32,149,-189,-29,218,5278,4889
94,brc203d.map,365,270,9320,34,129,330,140,40869,151,170,213,99,-117,41,158,334,3420
95,brc203d.map,365,270,44105,163,174,201,95,1959,7,200,357,69,156,26,182,1357,1307
96,brc203d.map,365,270,6721,24,28,340,241,11178,41,161,323,108,-17,133,150,446,398
97,brc203d.map,365,270,27850,103,229,261,40,51127,189,172,175,97,-86,-57,143,1787,2261
98,brc203d.map,365,270,5104,18,25,346,244,66510,246,179,118,90,-228,154,382,8502,3124
99,brc203d.map,365,270,57368,212,141,152,128,80915,299,84,65,185,-87,-57,144,862,157
0,brc204d.map,428,418,118346,283,365,144,52,31395,75,372,352,45,208,7,215,3371,5592
1,brc204d.map,428,418,128523,307,220,120,197,115228,275,139,152,278,32,-81,113,115,224
2,brc204d.map,428,418,114968,275,399,152,18,113380,271,315,156,102,4,-84,88,166,89
3,brc204d.map,428,418,55208,132,385,295,32,108477,259,202,168,215,-127,-183,310,4026,3021
4,brc204d.map,428,418,112234,268,207,159,210,123077,294,232,133,185,-26,25,51,52,52
5,brc204d.map,428,418,135716,324,133,103,284,127613,305,294,122,123,19,161,180,2567,3378
6,brc204d.map,428,418,116017,277,186,150,231,149737,358,324,69,93,-81,138,219,4886,1213
7,brc204d.map,428,418,120096,287,287,140,130,67769,162,364,265,53,125,77,202,4409,848
8,brc204d.map,428,418,120224,287,159,140,258,131540,314,129,113,288,-27,-30,57,203,728
9,brc204d.map,428,418,109953,263,398,164,19,116062,277,141,150,276,-14,-257,271,275,1645
10,brc204d.map,428,418,108457,259,222,168,195,96325,230,232,197,185,29,10,39,40,44
11,brc204d.map,428,418,119409,285,138,142,279,110855,265,332,162,85,20,194,214,2317,2986
12,brc204d.map,428,418,141365,338,336,89,81,116463,278,158,149,259,60,-178,238,978,2052
13,brc204d.map,428,418,66889,160,408,267,9,116602,278,19,149,398,-118,-389,507,1056,4633
14,brc204d.map,428,418,133016,318,325,109,92,112823,269,36,158,381,49,-289,338,1448,7487
15,brc204d.map,428,418,138875,332,318,95,99,92844,222,369,205,48,110,51,161,183,652
16,brc204d.map,428,418,68155,163,396,264,21,78199,187,384,240,33,-24,-12,36,37,37
17,brc204d.map,428,418,94756,226,129,201,288,134047,320,130,107,287,-94,1,95,96,96
18,brc204d.map,428,418,108730,260,367,167,50,20515,49,384,378,33,211,17,228,2022,6799
19,brc204d.map,428,418,109720,262,213,165,204,27617,66,388,361,29,196,175,371,2939,5606
20,brc204d.map,428,418,44738,107,405,320,12,21763,52,390,375,27,55,-15,70,266,647
21,brc204d.map,428,418,120980,289,239,138,178,36806,88,395,339,22,201,156,357,1244,1649
22,brc204d.map,428,418,138489,331,286,96,131,71907,172,406,255,11,159,120,279,823,717
23,brc204d.map,428,418,113433,271,262,156,155,121351,290,286,137,131,-19,24,43,44,82
24,brc204d.map,428,418,118121,282,172,145,245,163626,391,229,36,188,-109,57,166,362,1684
25,brc204d.map,428,418,115946,277,257,150,160,107603,257,240,170,177,20,-17,37,38,42
26,brc204d.map,428,418,110140,263,211,164,206,53527,128,394,299,23,135,183,318,2913,4338
27,brc204d.map,428,418,145234,347,229,80,188,93818,224,231,203,186,123,2,125,569,338
28,brc204d.map,428,418,138490,331,285,96,132,129031,308,130,119,287,23,-155,178,1100,3581
29,brc204d.map,428,418,52688,126,397,301,20,130208,311,207,116,210,-185,-190,375,1542,2630
30,brc204d.map,428,418,120507,288,294,139,123,176582,422,231,5,186,-134,-63,197,1898,2382
31,brc204d.map,428,418,75706,181,369,246,48,66503,159,376,268,41,22,7,29,30,66
32,brc204d.map,428,418,116224,278,397,149,20,111401,266,204,161,213,12,-193,205,829,206
33,brc204d.map,428,418,93342,223,289,204,128,74023,177,380,250,37,46,91,137,2781,3746
34,brc204d.map,428,418,146817,351,318,76,99,117534,281,341,146,76,70,23,93,112,179
35,brc204d.map,428,418,93339,223,292,204,125,112828,269,31,158,386,-46,-261,307,1547,3227
36,brc204d.map,428,418,62713,150,404,277,13,150676,360,221,67,196,-210,-183,393,1250,2280
37,brc204d.map,428,418,97050,232,343,195,74,101285,242,288,185,129,-10,-55,65,1063,925
38,brc204d.map,428,418,111011,265,176,162,241,32220,77,383,350,34,188,207,395,4934,5236
39,brc204d.map,428,418,115035,275,332,152,85,106245,254,344,173,73,21,12,33,34,46
40,brc204d.map,428,418,143082,342,291,85,126,117362,280,95,147,322,62,-196,258,1495,2984
41,brc204d.map,428,418,147205,352,348,75,69,118311,283,400,144,17,69,52,121,1637,1734
42,brc204d.map,428,418,108386,259,293,168,124,85460,204,229,223,188,55,-64,119,1691,1745
43,brc204d.map,428,418,97267,232,126,195,291,117652,281,223,146,194,-49,97,146,451,1040
44,brc204d.map,428,418,113132,270,145,157,272,87109,208,252,219,165,62,107,169,485,320
45,brc204d.map,428,418,114596,274,353,153,64,89628,214,241,213,176,60,-112,172,4003,658
46,brc204d.map,428,418,23432,56,393,371,24,111224,266,381,161,36,-210,-12,222,6655,2266
47,brc204d.map,428,418,108870,260,227,167,190,132599,317,324,110,93,-57,97,154,3835,783
48,brc204d.map,428,418,97257,232,136,195,281,73610,176,375,251,42,56,239,295,8289,7535
49,brc204d.map,428,418,121394,290,243,137,174,125604,300,213,127,204,-10,-30,40,41,41
50,brc204d.map,428,418,105608,252,145,175,272,116003,277,200,150,217,-25,55,80,306,1625
51,brc204d.map,428,418,111314,266,291,161,126,102914,246,331,181,86,20,40,60,502,250
52,brc204d.map,428,418,121828,291,227,136,190,76518,183,393,244,24,108,166,274,1482,463
53,brc204d.map,428,418,85466,204,223,223,194,94950,227,353,200,64,-23,130,153,2442,2721
54,brc204d.map,428,418,114900,274,49,153,368,92877,222,336,205,81,52,287,339,3772,401
55,brc204d.map,428,418,133020,318,321,109,96,108135,258,126,169,291,60,-195,255,1781,7324
56,brc204d.map,428,418,112608,269,251,158,166,27207,65,380,362,37,204,129,333,3403,3982
57,brc204d.map,428,418,118740,284,389,143,28,97262,232,131,195,286,52,-258,310,3345,615
58,brc204d.map,428,418,111789,267,234,160,183,31374,75,393,352,24,192,159,351,1451,4726
59,brc204d.map,428,418,29288,70,389,357,28,85724,205,383,222,34,-135,-6,141,271,142
60,brc204d.map,428,418,84048,201,387,226,30,118765,284,364,143,53,-83,-23,106,1611,2113
61,brc204d.map,428,418,109538,262,395,165,22,113164,270,113,157,304,-8,-282,290,1327,1960
62,brc204d.map,428,418,116304,278,317,149,100,30134,72,379,355,38,206,62,268,2453,1793
63,brc204d.map,428,418,139323,333,288,94,129,105525,252,228,175,189,81,-60,141,327,146
64,brc204d.map,428,418,7977,19,382,408,35,113394,271,301,156,116,-252,-81,333,2395,1578
65,brc204d.map,428,418,107920,258,341,169,76,108851,260,246,167,171,-2,-95,97,751,541
66,brc204d.map,428,418,124433,297,130,130,287,118417,283,294,144,123,14,164,178,1365,570
67,brc204d.map,428,418,116462,278,159,149,258,113615,271,80,156,337,7,-79,86,159,87
68,brc204d.map,428,418,173654,415,233,12,184,116574,278,47,149,370,137,-186,323,2419,735
69,brc204d.map,428,418,66502,159,377,268,40,102542,245,285,182,132,-86,-92,178,3621,3143
70,brc204d.map,428,418,72329,173,402,254,15,51854,124,395,303,22,49,-7,56,57,64
71,brc204d.map,428,418,148061,354,328,73,89,105349,252,404,175,13,102,76,178,3165,487
72,brc204d.map,428,418,96213,230,344,197,73,79863,191,392,236,25,39,48,87,109,134
73,brc204d.map,428,418,118748,284,381,143,36,103022,246,223,181,194,38,-158,196,1386,212
74,brc204d.map,428,418,72353,173,378,254,39,115031,275,336,152,81,-102,-42,144,481,2087
75,brc204d.map,428,418,139288,333,323,94,94,115226,275,141,152,276,58,-182,240,705,6147
76,brc204d.map,428,418,115697,276,88,151,329,101650,243,341,184,76,33,253,286,2992,324
77,brc204d.map,428,418,126104,301,131,126,286,134681,322,332,105,85,-21,201,222,4594,2145
78,brc204d.map,428,418,26786,64,383,363,34,116571,278,50,149,367,-214,-333,547,2112,7014
79,brc204d.map,428,418,110150,263,201,164,216,124223,297,340,130,77,-34,139,173,174,577
80,brc204d.map,428,418,26801,64,368,363,49,138130,330,227,97,190,-266,-141,407,2149,7535
81,brc204d.map,428,418,44740,107,403,320,14,91159,218,382,209,35,-111,-21,132,333,1894
82,brc204d.map,428,418,113171,270,106,157,311,60631,145,396,282,21,125,290,415,4169,3792
83,brc204d.map,428,418,115776,276,9,151,408,93253,223,378,204,39,53,369,422,3985,484
84,brc204d.map,428,418,5444,13,407,414,10,140532,336,333,91,84,-323,-74,397,2669,422
85,brc204d.map,428,418,20506,49,393,378,24,113723,272,390,155,27,-223,-3,226,6414,2273
86,brc204d.map,428,418,115577,276,208,151,209,116566,278,55,149,362,-2,-153,155,156,156
87,brc204d.map,428,418,155693,372,220,55,197,177006,423,225,4,192,-51,5,56,57,57
88,brc204d.map,428,418,105106,251,229,176,188,30957,74,392,353,25,177,163,340,2625,6678
89,brc204d.map,428,418,66929,160,368,267,49,28017,67,406,360,11,93,38,131,136,627
90,brc204d.map,428,418,150554,360,343,67,74,65237,156,388,271,29,204,45,249,1107,2311
91,brc204d.map,428,418,126363,302,290,125,127,145957,349,342,78,75,-47,52,99,1087,2296
92,brc204d.map,428,418,7552,18,389,409,28,143076,342,297,85,120,-324,-92,416,6203,797
93,brc204d.map,428,418,113688,271,7,156,410,21755,52,398,375,19,219,391,610,4767,5489
94,brc204d.map,428,418,139322,333,289,94,128,20086,48,395,379,22,285,106,391,904,2362
95,brc204d.map,428,418,44346,106,379,321,38,49359,118,382,309,35,-12,3,15,16,16
96,brc204d.map,428,418,114106,272,7,155,410,140114,335,333,92,84,-63,326,389,6263,1063
97,brc204d.map,428,418,107891,258,370,169,47,136347,326,338,101,79,-68,-32,100,109,258
98,brc204d.map,428,418,106038,253,133,174,284,107639,257,204,170,213,-4,71,75,766,650
99,brc204d.map,428,418,118314,283,397,144,20,172412,412,221,15,196,-129,-176,305,1135,2361
0,brc300d.map,205,255,35601,139,98,65,156,39175,153,94,51,160,-14,-4,18,19,19
1,brc300d.map,205,255,42841,168,253,36,1,6783,26,101,178,153,142,-152,294,3531,4843
2,brc300d.map,205,255,10665,41,44,163,210,50125,196,109,8,145,-155,65,220,3131,2307
3,brc300d.map,205,255,29723,116,111,88,143,40326,158,218,46,36,-42,107,149,1601,1500
4,brc300d.map,205,255,18858,73,11,131,243,40869,160,185,44,69,-87,174,261,2872,1526
5,brc300d.map,205,255,41892,164,182,40,72,9390,36,44,168,210,128,-138,266,3290,4059
6,brc300d.map,205,255,28971,113,98,91,156,39830,156,204,48,50,-43,106,149,1612,1391
7,brc300d.map,205,255,23657,92,57,112,197,18857,73,12,131,242,19,-45,64,78,65
8,brc300d.map,205,255,42142,165,187,39,67,26167,102,97,102,157,63,-90,153,1214,1594
9,brc300d.map,205,255,25416,99,83,105,171,23166,90,38,114,216,9,-45,54,55,55
10,brc300d.map,205,255,3478,13,91,191,163,13751,53,18,151,236,-40,-73,113,114,211
11,brc300d.map,205,255,22386,87,53,117,201,29227,114,97,90,157,-27,44,71,72,81
12,brc300d.map,205,255,39434,154,90,50,164,46830,183,89,21,165,-29,-1,30,31,31
13,brc300d.map,205,255,41057,161,252,43,2,7050,27,89,177,165,134,-163,297,3507,4810
14,brc300d.map,205,255,27701,108,93,96,161,11693,45,36,159,218,63,-57,120,1176,1292
15,brc300d.map,205,255,39322,154,202,50,52,5005,19,94,185,160,135,-108,243,3541,4089
16,brc300d.map,205,255,18858,73,11,131,243,28210,110,94,94,160,-37,83,120,121,160
17,brc300d.map,205,255,12976,50,28,154,226,33056,129,93,75,161,-79,65,144,1356,1428
18,brc300d.map,205,255,35088,137,101,67,153,7037,27,102,177,152,110,1,111,2306,1882
19,brc300d.map,205,255,45232,177,157,27,97,27953,109,96,95,158,68,-61,129,763,1476
20,brc300d.map,205,255,39051,153,218,51,36,19878,77,11,127,243,76,-207,283,1740,3077
21,brc300d.map,205,255,8889,34,35,170,219,39798,156,236,48,18,-122,201,323,4121,3367
22,brc300d.map,205,255,28457,111,102,93,152,28191,110,113,94,141,1,11,12,13,13
23,brc300d.map,205,255,33305,130,99,74,155,7546,29,103,175,151,101,4,105,3016,1873
24,brc300d.map,205,255,27187,106,97,98,157,25669,100,85,104,169,6,-12,18,19,19
25,brc300d.map,205,255,40200,157,89,47,165,39329,154,195,50,59,3,106,109,1164,1048
26,brc300d.map,205,255,12464,48,30,156,224,3461,13,108,191,146,35,78,113,210,114
27,brc300d.map,205,255,44280,173,89,31,165,48045,188,149,16,105,-15,60,75,390,254
28,brc300d.map,205,255,44720,175,159,29,95,26428,103,91,101,163,72,-68,140,821,1521
29,brc300d.map,205,255,49579,194,145,10,109,9885,38,59,166,195,156,-86,242,2879,3745
30,brc300d.map,205,255,11950,46,34,158,220,38918,152,96,52,158,-106,62,168,1277,1803
31,brc300d.map,205,255,22418,87,21,117,233,8109,31,50,173,204,56,29,85,461,756
32,brc300d.map,205,255,41376,162,188,42,66,9102,35,77,169,177,127,-111,238,3411,4067
33,brc300d.map,205,255,46248,181,161,23,93,43947,172,167,32,87,9,6,15,16,16
34,brc300d.map,205,255,40450,158,94,46,160,47020,184,154,20,100,-26,60,86,718,522
35,brc300d.map,205,255,40437,158,107,46,147,42151,165,178,39,76,-7,71,78,1022,1181
36,brc300d.map,205,255,49857,195,122,9,132,29981,117,108,87,146,78,-14,92,387,780
37,brc300d.map,205,255,36624,143,95,61,159,40692,159,107,45,147,-16,12,28,29,29
38,brc300d.map,205,255,49325,193,144,11,110,41206,161,103,43,151,32,-41,73,581,503
39,brc300d.map,205,255,48849,191,110,13,144,39559,155,220,49,34,36,110,146,252,883
40,brc300d.map,205,255,19624,76,10,128,244,47850,187,89,17,165,-111,79,190,860,469
41,brc300d.map,205,255,11962,46,22,158,232,2701,10,103,194,151,36,81,117,215,118
42,brc300d.map,205,255,7547,29,102,175,152,7823,30,81,174,173,-1,-21,22,33,35
43,brc300d.map,205,255,8121,31,38,173,216,48818,191,141,13,113,-160,103,263,3901,2633
44,brc300d.map,205,255,10912,42,52,162,202,19868,77,21,127,233,-35,-31,66,511,228
45,brc300d.map,205,255,46242,181,167,23,87,37388,146,96,58,158,35,-71,106,799,899
46,brc300d.map,205,255,39833,156,201,48,53,51642,202,122,2,132,-46,-79,125,130,131
47,brc300d.map,205,255,9884,38,60,166,194,40084,157,205,47,49,-119,145,264,4089,3391
48,brc300d.map,205,255,26683,104,91,100,163,39060,153,209,51,45,-49,118,167,1734,1392
49,brc300d.map,205,255,20879,81,30,123,224,4231,16,103,188,151,65,73,138,891,1755
50,brc300d.map,205,255,44969,176,165,28,89,31015,121,94,83,160,55,-71,126,777,1420
51,brc300d.map,205,255,2450,9,99,195,155,40084,157,205,47,49,-148,106,254,4089,3556
52,brc300d.map,205,255,8596,33,73,171,181,20894,81,15,123,239,-48,-58,106,736,230
53,brc300d.map,205,255,38665,151,94,53,160,10147,39,52,165,202,112,-42,154,1969,1823
54,brc300d.map,205,255,14523,56,11,148,243,41364,162,200,42,54,-106,189,295,3665,1636
55,brc300d.map,205,255,8130,31,29,173,225,25666,100,88,104,166,-69,59,128,1367,837
56,brc300d.map,205,255,26675,104,99,100,155,2709,10,95,194,159,94,-4,98,2061,1847
57,brc300d.map,205,255,41574,163,245,41,9,51639,202,125,2,129,-39,-120,159,265,842
58,brc300d.map,205,255,4992,19,107,185,147,39557,155,222,49,32,-136,115,251,4108,3554
59,brc300d.map,205,255,42917,168,177,36,77,7870,30,34,174,220,138,-143,281,3159,4050
60,brc300d.map,205,255,13501,52,13,152,241,17326,67,13,137,241,-15,0,15,16,16
61,brc300d.map,205,255,22148,86,36,118,218,3463,13,106,191,148,73,70,143,1122,1766
62,brc300d.map,205,255,29217,114,107,90,147,24406,95,73,109,181,19,-34,53,59,54
63,brc300d.map,205,255,50880,199,119,5,135,1950,7,89,197,165,192,-30,222,3046,3357
64,brc300d.map,205,255,6776,26,108,178,146,9149,35,30,169,224,-9,-78,87,88,174
65,brc300d.map,205,255,42915,168,179,36,75,24156,94,68,110,186,74,-111,185,1283,1860
66,brc300d.map,205,255,48097,188,97,16,157,24166,94,58,110,196,94,-39,133,370,459
67,brc300d.map,205,255,48096,188,98,16,156,8861,34,63,170,191,154,-35,189,2333,2783
68,brc300d.map,205,255,43170,169,179,35,75,21127,82,37,122,217,87,-142,229,1354,2143
69,brc300d.map,205,255,8592,33,77,171,177,21653,84,21,120,233,-51,-56,107,973,578
70,brc300d.map,205,255,39068,153,201,51,53,42150,165,179,39,75,-12,-22,34,35,35
71,brc300d.map,205,255,20385,79,14,125,240,30746,120,108,84,146,-41,94,135,136,177
72,brc300d.map,205,255,8608,33,61,171,193,33567,131,92,73,162,-98,31,129,2501,1893
73,brc300d.map,205,255,43680,171,179,33,75,27697,108,97,96,157,63,-82,145,1079,1529
74,brc300d.map,205,255,7848,30,56,174,198,8087,31,72,173,182,-1,16,17,18,18
75,brc300d.map,205,255,9395,36,39,168,215,4229,16,105,188,149,20,66,86,158,87
76,brc300d.map,205,255,32537,127,102,77,152,27948,109,101,95,153,18,-1,19,20,20
77,brc300d.map,205,255,9660,37,29,167,225,45999,180,155,24,99,-143,126,269,3982,2721
78,brc300d.map,205,255,24680,96,54,108,200,26157,102,107,102,147,-6,53,59,75,190
79,brc300d.map,205,255,21388,83,31,121,223,6781,26,103,178,151,57,72,129,937,1623
80,brc300d.map,205,255,23402,91,57,113,197,7051,27,88,177,166,64,31,95,1324,1792
81,brc300d.map,205,255,39537,155,242,49,12,8595,33,74,171,180,122,-168,290,3410,4128
82,brc300d.map,205,255,10161,39,38,165,216,5252,20,102,184,152,19,64,83,159,84
83,brc300d.map,205,255,50092,196,142,8,112,39556,155,223,49,31,41,81,122,123,127
84,brc300d.map,205,255,5757,22,107,182,147,5527,21,82,183,172,1,-25,26,27,27
85,brc300d.map,205,255,25906,101,103,103,151,43439,170,165,34,89,-69,62,131,1550,1064
86,brc300d.map,205,255,13242,51,17,153,237,8100,31,59,173,195,20,42,62,63,63
87,brc300d.map,205,255,22155,86,29,118,225,48606,190,98,14,156,-104,69,173,804,466
88,brc300d.map,205,255,18606,72,8,132,246,11695,45,34,159,220,27,26,53,54,54
89,brc300d.map,205,255,6027,23,92,181,162,24902,97,87,107,167,-74,-5,79,1828,1897
90,brc300d.map,205,255,41130,161,179,43,75,9615,37,74,167,180,124,-105,229,3813,4059
91,brc300d.map,205,255,39172,153,97,51,157,40054,157,235,47,19,-4,138,142,1892,1407
92,brc300d.map,205,255,7056,27,83,177,171,41821,164,253,40,1,-137,170,307,4839,3501
93,brc300d.map,205,255,5004,19,95,185,159,41575,163,244,41,10,-144,149,293,4828,3542
94,brc300d.map,205,255,16569,64,5,140,249,45220,177,169,27,85,-113,164,277,2514,1230
95,brc300d.map,205,255,49098,192,116,12,138,39317,154,207,50,47,38,91,129,169,767
96,brc300d.map,205,255,26409,103,110,101,144,24158,94,66,110,188,9,-44,53,59,54
97,brc300d.map,205,255,22376,87,63,117,191,39063,153,206,51,48,-66,143,209,2071,1589
98,brc300d.map,205,255,9883,38,61,166,193,46758,183,161,21,93,-145,100,245,4019,3155
99,brc300d.map,205,255,38542,151,217,53,37,38790,152,224,52,30,-1,7,8,9,9
0,brc501d.map,288,225,31084,138,190,149,34,54639,242,35,45,189,-104,-155,259,10159,9029
1,brc501d.map,288,225,4345,19,154,268,70,35663,158,111,129,113,-139,-43,182,4150,4613
2,brc501d.map,288,225,29569,131,130,156,94,30731,136,93,151,131,-5,-37,42,43,43
3,brc501d.map,288,225,49643,220,81,67,143,26223,116,101,171,123,104,20,124,19960,14822
4,brc501d.map,288,225,42533,189,216,98,8,32606,144,18,143,206,45,-198,243,12861,14536
5,brc501d.map,288,225,372,1,77,286,147,18388,81,61,206,163,-80,-16,96,356,98
6,brc501d.map,288,225,21664,96,160,191,64,45845,203,54,84,170,-107,-106,213,13973,40337
7,brc501d.map,288,225,62368,277,181,10,43,19365,86,209,201,15,191,28,219,3989,1078
8,brc501d.map,288,225,3262,14,112,273,112,5007,22,167,265,57,-8,55,63,64,64
9,brc501d.map,288,225,39348,174,26,113,198,60500,268,24,19,200,-94,-2,96,467,501
10,brc501d.map,288,225,2234,9,15,278,209,14442,64,182,223,42,-55,167,222,8168,1108
11,brc501d.map,288,225,47267,210,207,77,17,36132,160,92,127,132,50,-115,165,24922,14932
12,brc501d.map,288,225,25931,115,168,172,56,42916,190,58,97,166,-75,-110,185,12072,23344
13,brc501d.map,288,225,31217,138,57,149,167,54749,243,150,44,74,-105,93,198,5784,5567
14,brc501d.map,288,225,54538,242,136,45,88,28916,128,108,159,116,114,-28,142,37388,29326
15,brc501d.map,288,225,55102,244,22,43,202,62399,277,150,10,74,-33,128,161,384,2369
16,brc501d.map,288,225,10658,47,141,240,83,52292,232,132,55,92,-185,-9,194,20742,13260
17,brc501d.map,288,225,57467,255,132,32,92,34076,151,123,136,101,104,-9,113,37547,24103
18,brc501d.map,288,225,57857,257,192,30,32,43996,195,103,92,121,62,-89,151,40140,16057
19,brc501d.map,288,225,20016,88,8,199,216,40716,180,8,107,216,-92,0,92,93,93
20,brc501d.map,288,225,16578,73,71,214,153,39500,175,99,112,125,-102,28,130,16220,9593
21,brc501d.map,288,225,44748,198,26,89,198,35716,158,58,129,166,40,32,72,73,89
22,brc501d.map,288,225,35609,158,165,129,59,28891,128,133,159,91,30,-32,62,22365,20459
23,brc501d.map,288,225,10458,46,116,241,108,7542,33,107,254,117,13,-9,22,23,23
24,brc501d.map,288,225,50072,222,102,65,122,22380,99,119,188,105,123,17,140,955,1321
25,brc501d.map,288,225,40856,181,93,106,131,28631,127,168,160,56,54,75,129,130,1253
26,brc501d.map,288,225,26462,117,87,170,137,16959,75,140,212,84,42,53,95,96,96
27,brc501d.map,288,225,6813,30,161,257,63,41350,183,49,104,175,-153,-112,265,413,286
28,brc501d.map,288,225,58676,260,48,27,176,23357,103,42,184,182,157,-6,163,304,920
29,brc501d.map,288,225,10233,45,116,242,108,11732,52,192,235,32,-7,76,83,1258,236
30,brc501d.map,288,225,51371,228,153,59,71,1205,5,144,282,80,223,-9,232,8806,15157
31,brc501d.map,288,225,11649,51,50,236,174,11047,49,202,238,22,2,152,154,2846,590
32,brc501d.map,288,225,50139,222,35,65,189,2629,11,70,276,154,211,35,246,248,1720
33,brc501d.map,288,225,17001,75,98,212,126,46610,207,189,80,35,-132,91,223,16127,12453
34,brc501d.map,288,225,6964,30,10,257,214,64710,287,89,0,135,-257,79,336,5157,765
35,brc501d.map,288,225,9384,41,65,246,159,6044,26,30,261,194,15,-35,50,99,51
36,brc501d.map,288,225,48648,216,176,71,48,3644,16,180,271,44,200,4,204,4458,3620
37,brc501d.map,288,225,1052,4,72,283,152,36878,163,21,124,203,-159,-51,210,421,211
38,brc501d.map,288,225,18401,81,48,206,176,33036,146,38,141,186,-65,-10,75,76,76
39,brc501d.map,288,225,49632,220,92,67,132,19343,85,6,202,218,135,-86,221,10750,29459
40,brc501d.map,288,225,4169,18,105,269,119,62283,276,41,11,183,-258,-64,322,749,323
41,brc501d.map,288,225,33562,149,187,138,37,29669,131,30,156,194,18,-157,175,12165,29901
42,brc501d.map,288,225,47080,209,169,78,55,15167,67,132,220,92,142,-37,179,15569,19350
43,brc501d.map,288,225,39997,177,52,110,172,14847,65,2,222,222,112,-50,162,277,261
44,brc501d.map,288,225,16547,73,102,214,122,54917,244,207,43,17,-171,105,276,14741,15577
45,brc501d.map,288,225,47366,210,108,77,116,56783,252,141,35,83,-42,33,75,26081,42196
46,brc501d.map,288,225,32371,143,28,144,196,36789,163,110,124,114,-20,82,102,19346,11420
47,brc501d.map,288,225,63291,281,158,6,66,41651,185,198,102,26,96,40,136,137,167
48,brc501d.map,288,225,32603,144,21,143,203,11119,49,130,238,94,95,109,204,349,283
49,brc501d.map,288,225,63313,281,136,6,88,25851,114,23,173,201,167,-113,280,3120,2842
50,brc501d.map,288,225,38553,171,146,116,78,41379,183,20,104,204,-12,-126,138,11468,32855
51,brc501d.map,288,225,53162,236,162,51,62,28026,124,98,163,126,112,-64,176,31449,21119
52,brc501d.map,288,225,33944,150,30,137,194,4368,19,131,268,93,131,101,232,251,540
53,brc501d.map,288,225,62729,278,45,9,179,2561,11,138,276,86,267,93,360,377,5116
54,brc501d.map,288,225,56077,249,172,38,52,20094,89,155,198,69,160,-17,177,7499,1474
55,brc501d.map,288,225,63449,281,0,6,224,7491,33,158,254,66,248,158,406,770,6715
56,brc501d.map,288,225,38302,170,172,117,52,36967,164,157,123,67,6,-15,21,22,22
57,brc501d.map,288,225,39021,173,128,114,96,49301,219,198,68,26,-46,70,116,15011,31932
58,brc501d.map,288,225,14359,63,40,224,184,18703,83,196,204,28,-20,156,176,8843,2233
59,brc501d.map,288,225,9344,41,105,246,119,51355,228,169,59,55,-187,64,251,18172,10541
60,brc501d.map,288,225,7368,32,56,255,168,64647,287,152,0,72,-255,96,351,8588,6872
61,brc501d.map,288,225,45946,204,178,83,46,45347,201,102,86,122,3,-76,79,37344,18369
62,brc501d.map,288,225,10403,46,171,241,53,33517,148,7,139,217,-102,-164,266,267,669
63,brc501d.map,288,225,32898,146,176,141,48,58597,260,127,27,97,-114,-49,163,22264,40773
64,brc501d.map,288,225,2057,9,192,278,32,29615,131,84,156,140,-122,-108,230,2356,249
65,brc501d.map,288,225,15294,67,5,220,219,310,1,139,286,85,66,134,200,201,201
66,brc501d.map,288,225,31523,140,201,147,23,53383,237,166,50,58,-97,-35,132,133,142
67,brc501d.map,288,225,58480,259,19,28,205,39484,175,115,112,109,84,96,180,37095,12061
68,brc501d.map,288,225,25819,114,55,173,169,6159,27,140,260,84,87,85,172,228,173
69,brc501d.map,288,225,47380,210,94,77,130,41207,183,192,104,32,27,98,125,15983,36683
70,brc501d.map,288,225,16344,72,80,215,144,62514,277,35,10,189,-205,-45,250,874,252
71,brc501d.map,288,225,46937,208,87,79,137,43716,194,158,93,66,14,71,85,6557,12639
72,brc501d.map,288,225,29953,133,196,154,28,7820,34,54,253,170,99,-142,241,2435,9519
73,brc501d.map,288,225,64584,287,215,0,9,33101,147,198,140,26,140,-17,157,158,215
74,brc501d.map,288,225,43292,192,132,95,92,33670,149,79,138,145,43,-53,96,97,97
75,brc501d.map,288,225,62745,278,29,9,195,61620,273,29,14,195,5,0,5,6,6
76,brc501d.map,288,225,25290,112,134,175,90,36543,162,131,125,93,-50,-3,53,54,54
77,brc501d.map,288,225,30445,135,154,152,70,49085,218,189,69,35,-83,35,118,16498,30088
78,brc501d.map,288,225,14115,62,59,225,165,55655,247,144,40,80,-185,85,270,12164,6689
79,brc501d.map,288,225,50332,223,67,64,157,45029,200,195,87,29,23,128,151,5175,11706
80,brc501d.map,288,225,45320,201,129,86,95,7973,35,126,252,98,166,-3,169,9588,25207
81,brc501d.map,288,225,14670,65,179,222,45,6910,30,64,257,160,35,-115,150,446,3606
82,brc501d.map,288,225,16734,74,140,213,84,19150,85,199,202,25,-11,59,70,4063,5541
83,brc501d.map,288,225,30872,137,177,150,47,18076,80,148,207,76,57,-29,86,4878,2403
84,brc501d.map,288,225,28240,125,109,162,115,19783,87,16,200,208,38,-93,131,6620,11720
85,brc501d.map,288,225,28403,126,171,161,53,11740,52,184,235,40,74,13,87,4669,3229
86,brc501d.map,288,225,44282,196,42,91,182,10627,47,172,240,52,149,130,279,411,7967
87,brc501d.map,288,225,21593,95,6,192,218,15091,67,208,220,16,28,202,230,10410,2974
88,brc501d.map,288,225,12266,54,108,233,116,43804,194,70,93,154,-140,-38,178,2256,1228
89,brc501d.map,288,225,10517,46,57,241,167,2791,12,133,275,91,34,76,110,111,111
90,brc501d.map,288,225,55929,248,95,39,129,59799,265,50,22,174,-17,-45,62,438,535
91,brc501d.map,288,225,9140,40,84,247,140,44492,197,57,90,167,-157,-27,184,1333,1804
92,brc501d.map,288,225,52969,235,130,52,94,45563,202,111,85,113,33,-19,52,42024,31200
93,brc501d.map,288,225,11312,50,162,237,62,45578,202,96,85,128,-152,-66,218,7548,7425
94,brc501d.map,288,225,39565,175,34,112,190,47119,209,130,78,94,-34,96,130,9696,5375
95,brc501d.map,288,225,36313,161,136,126,88,35670,158,104,129,120,3,-32,35,36,36
96,brc501d.map,288,225,3717,16,107,271,117,52630,233,19,54,205,-217,-88,305,1025,306
97,brc501d.map,288,225,62657,278,117,9,107,32654,145,195,142,29,133,78,211,222,338
98,brc501d.map,288,225,54657,242,17,45,207,39478,175,121,112,103,67,104,171,34705,12365
99,brc501d.map,288,225,16452,73,197,214,27,50916,226,158,61,66,-153,-39,192,1578,4147
0,brc502d.map,129,149,7982,53,63,75,85,4222,28,98,100,50,25,35,60,144,75
1,brc502d.map,129,149,8707,58,83,70,65,5430,36,82,92,66,22,-1,23,24,24
2,brc502d.map,129,149,14482,97,119,31,29,17901,120,127,8,21,-23,8,31,32,32
3,brc502d.map,129,149,6944,46,58,82,90,4479,30,139,98,9,16,81,97,184,99
4,brc502d.map,129,149,8240,55,103,73,45,7228,48,72,80,76,7,-31,38,39,39
5,brc502d.map,129,149,7630,51,117,77,31,7471,50,127,78,21,1,10,11,12,12
6,brc502d.map,129,149,6346,42,60,86,88,6565,44,139,84,9,-2,79,81,82,82
7,brc502d.map,129,149,8256,55,87,73,61,13098,87,13,41,135,-32,-74,106,107,144
8,brc502d.map,129,149,7626,51,121,77,27,6463,43,92,85,56,8,-29,37,38,38
9,brc502d.map,129,149,8692,58,98,70,50,935,6,107,122,41,52,9,61,2277,398
10,brc502d.map,129,149,8362,56,130,72,18,7034,47,117,81,31,9,-13,22,23,23
11,brc502d.map,129,149,4337,29,132,99,16,7350,49,99,79,49,-20,-33,53,54,72
12,brc502d.map,129,149,3826,25,47,103,101,6191,41,66,87,82,-16,19,35,36,36
13,brc502d.map,129,149,8394,56,98,72,50,8850,59,89,69,59,-3,-9,12,13,13
14,brc502d.map,129,149,13889,93,116,35,32,5407,36,105,92,43,57,-11,68,69,152
15,brc502d.map,129,149,8208,55,135,73,13,10491,70,87,58,61,-15,-48,63,64,64
16,brc502d.map,129,149,5734,38,76,90,72,9567,64,117,64,31,-26,41,67,68,68
17,brc502d.map,129,149,7507,50,91,78,57,3291,22,135,106,13,28,44,72,235,73
18,brc502d.map,129,149,6353,42,53,86,95,15076,101,121,27,27,-59,68,127,365,128
19,brc502d.map,129,149,1808,12,128,116,20,11190,75,133,53,15,-63,5,68,154,69
20,brc502d.map,129,149,13105,87,6,41,142,9772,65,61,63,87,22,55,77,134,78
21,brc502d.map,129,149,3074,20,54,108,94,1091,7,100,121,48,13,46,59,2468,1010
22,brc502d.map,129,149,7968,53,77,75,71,9112,61,125,67,23,-8,48,56,57,57
23,brc502d.map,129,149,794,5,99,123,49,12330,82,36,46,112,-77,-63,140,663,3970
24,brc502d.map,129,149,1089,7,102,121,46,7356,49,93,79,55,-42,-9,51,394,2457
25,brc502d.map,129,149,2451,16,81,112,67,4271,28,49,100,99,-12,-32,44,137,151
26,brc502d.map,129,149,2601,17,80,111,68,4939,33,126,95,22,-16,46,62,63,85
27,brc502d.map,129,149,8998,60,90,68,58,6495,43,60,85,88,17,-30,47,113,48
28,brc502d.map,129,149,3302,22,124,106,24,13551,90,7,38,141,-68,-117,185,411,3193
29,brc502d.map,129,149,6427,43,128,85,20,11429,76,43,52,105,-33,-85,118,144,144
30,brc502d.map,129,149,8352,56,140,72,8,7239,48,61,80,87,8,-79,87,89,98
31,brc502d.map,129,149,8397,56,95,72,53,3502,23,73,105,75,33,-22,55,95,56
32,brc502d.map,129,149,8523,57,118,71,30,5148,34,66,94,82,23,-52,75,76,76
33,brc502d.map,129,149,4710,31,57,97,91,4566,30,52,98,96,1,-5,6,7,7
34,brc502d.map,129,149,7816,52,80,76,68,10983,73,42,55,106,-21,-38,59,65,60
35,brc502d.map,129,149,2747,18,83,110,65,2774,18,56,110,92,0,-27,27,189,109
36,brc502d.map,129,149,3770,25,103,103,45,8575,57,66,71,82,-32,-37,69,70,179
37,brc502d.map,129,149,12256,82,110,46,38,2847,19,132,109,16,63,22,85,135,122
38,brc502d.map,129,149,6008,40,100,88,48,5434,36,78,92,70,4,-22,26,27,27
39,brc502d.map,129,149,8556,57,85,71,63,5455,36,57,92,91,21,-28,49,71,50
40,brc502d.map,129,149,6181,41,76,87,72,11039,74,135,54,13,-33,59,92,93,93
41,brc502d.map,129,149,9245,62,141,66,7,8726,58,64,70,84,4,-77,81,82,82
42,brc502d.map,129,149,10513,70,65,58,83,2254,15,129,113,19,55,64,119,617,191
43,brc502d.map,129,149,6322,42,84,86,64,3029,20,99,108,49,22,15,37,41,40
44,brc502d.map,129,149,793,5,100,123,48,6175,41,82,87,66,-36,-18,54,397,2550
45,brc502d.map,129,149,7012,47,139,81,9,5605,37,56,91,92,10,-83,93,94,94
46,brc502d.map,129,149,11216,75,107,53,41,7206,48,94,80,54,27,-13,40,41,41
47,brc502d.map,129,149,2712,18,118,110,30,6628,44,76,84,72,-26,-42,68,168,1790
48,brc502d.map,129,149,9874,66,108,62,40,8828,59,111,69,37,7,3,10,11,11
49,brc502d.map,129,149,13400,89,9,39,139,4116,27,55,101,93,62,46,108,743,502
50,brc502d.map,129,149,3744,25,129,103,19,9107,61,130,67,18,-36,1,37,38,38
51,brc502d.map,129,149,15077,101,120,27,28,4967,33,98,95,50,68,-22,90,91,349
52,brc502d.map,129,149,4064,27,107,101,41,15969,107,122,21,26,-80,15,95,468,96
53,brc502d.map,129,149,5739,38,71,90,77,2559,17,122,111,26,21,51,72,1274,158
54,brc502d.map,129,149,10040,67,91,61,57,5013,33,52,95,96,34,-39,73,181,74
55,brc502d.map,129,149,3345,22,81,106,67,6186,41,71,87,77,-19,-10,29,32,56
56,brc502d.map,129,149,8537,57,104,71,44,3201,21,76,107,72,36,-28,64,926,69
57,brc502d.map,129,149,7755,52,141,76,7,4990,33,75,95,73,19,-66,85,86,89
58,brc502d.map,129,149,6036,40,72,88,76,5164,34,50,94,98,6,-22,28,52,29
59,brc502d.map,129,149,9925,66,57,62,91,11957,80,111,48,37,-14,54,68,229,429
60,brc502d.map,129,149,7821,52,75,76,73,7199,48,101,80,47,4,26,30,31,31
61,brc502d.map,129,149,6634,44,70,84,78,12788,85,25,43,123,-41,-45,86,142,87
62,brc502d.map,129,149,7201,48,99,80,49,8523,57,118,71,30,-9,19,28,29,29
63,brc502d.map,129,149,6288,42,118,86,30,3468,23,107,105,41,19,-11,30,31,31
64,brc502d.map,129,149,11360,76,112,52,36,6284,42,122,86,26,34,10,44,45,45
65,brc502d.map,129,149,7475,50,123,78,25,8855,59,84,69,64,-9,-39,48,49,49
66,brc502d.map,129,149,2729,18,101,110,47,7529,50,69,78,79,-32,-32,64,75,218
67,brc502d.map,129,149,14630,98,120,30,28,17159,115,124,13,24,-17,4,21,22,22
68,brc502d.map,129,149,2746,18,84,110,64,6442,43,113,85,35,-25,29,54,57,623
69,brc502d.map,129,149,6176,41,81,87,67,18054,121,123,7,25,-80,42,122,434,123
70,brc502d.map,129,149,6267,42,139,86,9,340,2,106,126,42,40,-33,73,74,92
71,brc502d.map,129,149,8516,57,125,71,23,7622,51,125,77,23,6,0,6,7,7
72,brc502d.map,129,149,11360,76,112,52,36,12256,82,110,46,38,-6,-2,8,9,9
73,brc502d.map,129,149,6332,42,74,86,74,6438,43,117,85,31,-1,43,44,45,45
74,brc502d.map,129,149,6574,44,130,84,18,4647,31,120,97,28,13,-10,23,24,24
75,brc502d.map,129,149,7050,47,101,81,47,13591,91,116,37,32,-44,15,59,121,60
76,brc502d.map,129,149,9860,66,122,62,26,6030,40,78,88,70,26,-44,70,71,71
77,brc502d.map,129,149,345,2,101,126,47,11807,79,112,49,36,-77,11,88,405,2235
78,brc502d.map,129,149,7240,48,60,80,88,4357,29,112,99,36,19,52,71,151,73
79,brc502d.map,129,149,5160,34,54,94,94,13999,93,6,35,142,-59,-48,107,440,773
80,brc502d.map,129,149,5019,33,46,95,102,1374,9,115,119,33,24,69,93,1897,690
81,brc502d.map,129,149,13539,90,19,38,129,12358,82,8,46,140,8,-11,19,28,20
82,brc502d.map,129,149,7205,48,95,80,53,18351,123,124,5,24,-75,29,104,378,105
83,brc502d.map,129,149,4261,28,59,100,89,11574,77,47,51,101,-49,-12,61,437,416
84,brc502d.map,129,149,9464,63,71,65,77,10135,68,145,60,3,-5,74,79,85,432
85,brc502d.map,129,149,8277,55,66,73,82,8815,59,124,69,24,-4,58,62,63,63
86,brc502d.map,129,149,9736,65,97,63,51,11807,79,112,49,36,-14,15,29,30,30
87,brc502d.map,129,149,9125,61,112,67,36,8527,57,114,71,34,4,2,6,7,7
88,brc502d.map,129,149,8225,55,118,73,30,7630,51,117,77,31,4,-1,5,6,6
89,brc502d.map,129,149,351,2,95,126,53,7343,49,106,79,42,-47,11,58,381,2191
90,brc502d.map,129,149,4537,30,81,98,67,10379,69,50,59,98,-39,-31,70,309,71
91,brc502d.map,129,149,8712,58,78,70,70,2708,18,122,110,26,40,44,84,2117,160
92,brc502d.map,129,149,18494,124,130,4,18,8678,58,112,70,36,66,-18,84,85,370
93,brc502d.map,129,149,1083,7,108,121,40,8069,54,125,74,23,-47,17,64,244,701
94,brc502d.map,129,149,12631,84,33,44,115,2927,19,52,109,96,65,19,84,491,478
95,brc502d.map,129,149,3496,23,79,105,69,9585,64,99,64,49,-41,20,61,63,120
96,brc502d.map,129,149,9841,66,141,62,7,6922,46,80,82,68,20,-61,81,82,82
97,brc502d.map,129,149,6456,43,99,85,49,6500,43,55,85,93,0,-44,44,47,47
98,brc502d.map,129,149,11360,76,112,52,36,7981,53,64,75,84,23,-48,71,72,72
99,brc502d.map,129,149,10513,70,65,58,83,3155,21,122,107,26,49,57,106,2705,165
0,brc503d.map,257,320,66458,207,101,49,218,49908,155,11,101,308,52,-90,142,4338,4968
1,brc503d.map,257,320,4898,15,221,241,98,4039,12,120,244,199,3,-101,104,152,355
2,brc503d.map,257,320,64994,203,285,53,34,78934,246,105,10,214,-43,-180,223,224,474
3,brc503d.map,257,320,67616,211,223,45,96,52523,164,276,92,43,47,53,100,102,102
4,brc503d.map,257,320,46838,146,201,110,118,15503,48,176,208,143,98,-25,123,5721,2588
5,brc503d.map,257,320,1904,5,15,251,304,36183,113,296,143,23,-108,281,389,19758,2090
6,brc503d.map,257,320,47937,149,62,107,257,12187,38,292,218,27,111,230,341,5843,36210
7,brc503d.map,257,320,16123,50,196,206,123,35999,112,160,144,159,-62,-36,98,1144,3483
8,brc503d.map,257,320,73339,229,260,27,59,2143,6,96,250,223,223,-164,387,16631,18923
9,brc503d.map,257,320,77278,241,161,15,158,26750,83,129,173,190,158,-32,190,36271,26101
10,brc503d.map,257,320,17847,55,72,201,247,23231,72,128,184,191,-17,56,73,2172,2493
11,brc503d.map,257,320,69651,217,108,39,211,27190,84,9,172,310,133,-99,232,4174,7492
12,brc503d.map,257,320,27384,85,135,171,184,9526,29,73,227,246,56,-62,118,1495,2750
13,brc503d.map,257,320,65336,204,263,52,56,2260,7,299,249,20,197,36,233,258,1370
14,brc503d.map,257,320,6408,20,311,236,8,56780,177,179,79,140,-157,-132,289,23080,9130
15,brc503d.map,257,320,69805,218,274,38,45,55911,174,88,82,231,44,-186,230,29974,6124
16,brc503d.map,257,320,19018,59,181,197,138,70189,219,210,37,109,-160,29,189,23082,31956
17,brc503d.map,257,320,29507,92,252,164,67,13795,43,284,213,35,49,32,81,156,1257
18,brc503d.map,257,320,37443,117,316,139,3,73806,230,113,26,206,-113,-203,316,337,2923
19,brc503d.map,257,320,2630,8,249,248,70,3095,9,104,247,215,-1,-145,146,1257,4754
20,brc503d.map,257,320,18330,57,229,199,90,9765,30,154,226,165,27,-75,102,210,111
21,brc503d.map,257,320,24591,76,48,180,271,79967,249,32,7,287,-173,-16,189,4380,3228
22,brc503d.map,257,320,8507,26,132,230,187,78774,246,265,10,54,-220,133,353,15097,14316
23,brc503d.map,257,320,66401,207,158,49,161,14766,46,273,210,46,161,115,276,7615,3076
24,brc503d.map,257,320,61765,193,314,63,5,75583,236,256,20,63,-43,-58,101,110,313
25,brc503d.map,257,320,34297,107,262,149,57,14477,45,242,211,77,62,-20,82,1229,1974
26,brc503d.map,257,320,24392,76,247,180,72,58899,184,300,72,19,-108,53,161,9994,28721
27,brc503d.map,257,320,14473,45,246,211,73,44844,140,275,116,44,-95,29,124,1174,2032
28,brc503d.map,257,320,45394,141,45,115,274,26430,82,129,174,190,59,84,143,13106,18327
29,brc503d.map,257,320,18992,59,207,197,112,58694,183,185,73,134,-124,-22,146,1847,1998
30,brc503d.map,257,320,48749,152,210,104,109,22749,71,290,185,29,81,80,161,8886,25079
31,brc503d.map,257,320,21346,66,93,190,226,67519,210,0,46,319,-144,-93,237,16039,23631
32,brc503d.map,257,320,39272,122,87,134,232,70796,221,243,35,76,-99,156,255,20669,34786
33,brc503d.map,257,320,37096,115,23,141,296,76682,239,117,17,202,-124,94,218,4217,6940
34,brc503d.map,257,320,29440,92,319,164,0,45884,143,195,113,124,-51,-124,175,28563,9882
35,brc503d.map,257,320,14729,46,310,210,9,31375,98,304,158,15,-52,-6,58,59,59
36,brc503d.map,257,320,17453,54,146,202,173,46663,145,56,111,263,-91,-90,181,18519,7111
37,brc503d.map,257,320,14496,45,223,211,96,7305,22,54,234,265,23,-169,192,193,193
38,brc503d.map,257,320,70315,219,84,37,235,80487,251,152,5,167,-32,68,100,101,273
39,brc503d.map,257,320,34292,107,267,149,52,80317,250,2,6,317,-143,-265,408,565,2097
40,brc503d.map,257,320,63395,198,284,58,35,35527,111,312,145,7,87,28,115,252,118
41,brc503d.map,257,320,13657,42,102,214,217,76943,240,176,16,143,-198,74,272,31185,27621
42,brc503d.map,257,320,72793,227,166,29,153,25221,78,58,178,261,149,-108,257,33549,34383
43,brc503d.map,257,320,59189,184,10,72,309,44773,139,26,117,293,45,16,61,90,276
44,brc503d.map,257,320,2568,8,311,248,8,12409,38,70,218,249,-30,-241,271,489,4441
45,brc503d.map,257,320,18437,57,122,199,197,28766,89,33,167,286,-32,-89,121,11271,11585
46,brc503d.map,257,320,78964,246,75,10,244,19630,61,209,195,110,185,134,319,45997,31008
47,brc503d.map,257,320,34523,107,36,149,283,19535,61,304,195,15,46,268,314,5636,24628
48,brc503d.map,257,320,488,1,151,255,168,67877,212,282,44,37,-211,131,342,6906,8247
49,brc503d.map,257,320,38579,120,140,136,179,59891,187,268,69,51,-67,128,195,16326,27188
50,brc503d.map,257,320,72512,226,127,30,192,53861,168,218,88,101,58,91,149,45279,31494
51,brc503d.map,257,320,22690,70,29,186,290,64866,202,93,54,226,-132,64,196,11452,6469
52,brc503d.map,257,320,33008,103,271,153,48,270,0,49,256,270,103,-222,325,2557,15809
53,brc503d.map,257,320,72381,226,258,30,61,67998,212,161,44,158,14,-97,111,359,112
54,brc503d.map,257,320,31520,98,159,158,160,1936,6,303,250,16,92,144,236,5733,10578
55,brc503d.map,257,320,37033,115,86,141,233,9575,29,24,227,295,86,-62,148,7810,13959
56,brc503d.map,257,320,8835,27,124,229,195,25303,79,296,177,23,-52,172,224,225,459
57,brc503d.map,257,320,35548,111,291,145,28,20989,65,130,191,189,46,-161,207,4705,7065
58,brc503d.map,257,320,56402,176,237,80,82,14790,46,249,210,70,130,12,142,5350,2676
59,brc503d.map,257,320,559,1,80,255,239,42359,132,200,124,119,-131,120,251,3208,409
60,brc503d.map,257,320,52985,165,134,91,185,11453,35,66,221,253,130,-68,198,6005,8577
61,brc503d.map,257,320,13872,43,207,213,112,1300,4,299,252,20,39,92,131,790,438
62,brc503d.map,257,320,67680,211,159,45,160,72190,225,129,31,190,-14,-30,44,45,45
63,brc503d.map,257,320,44218,138,261,118,58,36436,113,43,143,276,25,-218,243,47214,28411
64,brc503d.map,257,320,13186,41,253,215,66,18332,57,227,199,92,-16,-26,42,43,49
65,brc503d.map,257,320,7580,23,99,233,220,2212,6,27,250,292,17,-72,89,90,90
66,brc503d.map,257,320,24137,75,182,181,137,3209,10,310,246,9,65,128,193,5646,11980
67,brc503d.map,257,320,28449,88,30,168,289,37993,118,86,138,233,-30,56,86,15449,14051
68,brc503d.map,257,320,35169,109,30,147,289,42498,132,61,124,258,-23,31,54,440,126
69,brc503d.map,257,320,10121,31,118,225,201,28566,89,233,167,86,-58,115,173,2078,553
70,brc503d.map,257,320,64035,200,284,56,35,70214,219,185,37,134,-19,-99,118,119,422
71,brc503d.map,257,320,32635,101,4,155,315,46517,145,202,111,117,-44,198,242,11175,19487
72,brc503d.map,257,320,35177,109,22,147,297,5514,17,245,239,74,92,223,315,11612,13052
73,brc503d.map,257,320,38873,121,166,135,153,10993,34,206,222,113,87,40,127,3687,2757
74,brc503d.map,257,320,58810,183,69,73,250,63419,198,260,58,59,-15,191,206,1440,2549
75,brc503d.map,257,320,75776,236,63,20,256,36171,113,308,143,11,123,245,368,3497,392
76,brc503d.map,257,320,17596,54,3,202,316,14429,45,290,211,29,9,287,296,2265,11953
77,brc503d.map,257,320,58689,183,190,73,129,10084,31,155,225,164,152,-35,187,4748,3235
78,brc503d.map,257,320,2925,9,274,247,45,80998,253,281,3,38,-244,7,251,1882,1730
79,brc503d.map,257,320,50436,157,123,99,196,26167,81,72,175,247,76,-51,127,337,195
80,brc503d.map,257,320,2948,9,251,247,68,41487,129,112,127,207,-120,-139,259,1186,2316
81,brc503d.map,257,320,42717,133,162,123,157,49870,155,49,101,270,-22,-113,135,21177,13501
82,brc503d.map,257,320,40010,125,309,131,10,48575,151,64,105,255,-26,-245,271,56098,9005
83,brc503d.map,257,320,15026,46,13,210,306,51622,161,217,95,102,-115,204,319,10617,17141
84,brc503d.map,257,320,10661,33,218,223,101,16990,53,289,203,30,-20,71,91,92,92
85,brc503d.map,257,320,72900,227,59,29,260,13071,40,48,216,271,187,-11,198,13467,12988
86,brc503d.map,257,320,6825,21,214,235,105,58053,181,186,75,133,-160,-28,188,6535,7765
87,brc503d.map,257,320,7417,23,262,233,57,32411,101,228,155,91,-78,-34,112,16135,5889
88,brc503d.map,257,320,66665,208,214,48,105,17554,54,45,202,274,154,-169,323,22403,8807
89,brc503d.map,257,320,46515,145,204,111,115,16767,52,192,204,127,93,-12,105,705,470
90,brc503d.map,257,320,9724,30,195,226,124,2463,7,96,249,223,23,-99,122,448,123
91,brc503d.map,257,320,60080,187,79,69,240,47980,149,19,107,300,38,-60,98,25554,29563
92,brc503d.map,257,320,26253,82,306,174,13,12983,40,136,216,183,42,-170,212,213,213
93,brc503d.map,257,320,9394,29,205,227,114,40197,125,122,131,197,-96,-83,179,654,471
94,brc503d.map,257,320,44195,138,284,118,35,50255,157,304,99,15,-19,20,39,40,265
95,brc503d.map,257,320,23081,72,278,184,41,20894,65,225,191,94,7,-53,60,15701,5573
96,brc503d.map,257,320,50625,158,254,98,65,51526,161,313,95,6,-3,59,62,183,119
97,brc503d.map,257,320,24042,75,277,181,42,73547,229,52,27,267,-154,-225,379,764,14135
98,brc503d.map,257,320,56809,177,150,79,169,39850,124,149,132,170,53,-1,54,370,594
99,brc503d.map,257,320,46168,144,231,112,88,77659,242,100,14,219,-98,-131,229,323,6495
0,brc504d.map,256,259,8249,31,38,224,220,42099,162,117,93,141,-131,79,210,8387,7703
1,brc504d.map,256,259,26925,103,10,152,248,52142,201,175,54,83,-98,165,263,19128,6230
2,brc504d.map,256,259,61449,237,192,18,66,39295,151,72,104,186,86,-120,206,12201,17693
3,brc504d.map,256,259,59089,228,221,27,37,40049,154,95,101,163,74,-126,200,15839,21159
4,brc504d.map,256,259,56218,217,243,38,15,7026,27,225,228,33,190,-18,208,2654,1614
5,brc504d.map,256,259,56017,216,185,39,73,30051,116,251,139,7,100,66,166,244,773
6,brc504d.map,256,259,18714,72,192,183,66,22413,86,119,169,139,-14,-73,87,1913,4983
7,brc504d.map,256,259,20001,77,200,178,58,7959,30,69,225,189,47,-131,178,15263,18206
8,brc504d.map,256,259,16802,64,32,191,226,12349,47,82,208,176,17,50,67,449,519
9,brc504d.map,256,259,28755,111,252,144,6,14470,55,33,200,225,56,-219,275,6373,12984
10,brc504d.map,256,259,57698,222,58,33,200,36828,142,208,113,50,80,150,230,6123,12279
11,brc504d.map,256,259,21651,83,104,172,154,25749,99,150,156,108,-16,46,62,16380,20332
12,brc504d.map,256,259,6299,24,175,231,83,47571,183,84,72,174,-159,-91,250,11727,14746
13,brc504d.map,256,259,41992,162,224,93,34,15602,60,196,195,62,102,-28,130,2505,2396
14,brc504d.map,256,259,10480,40,138,215,120,33571,129,98,126,160,-89,-40,129,13533,22554
15,brc504d.map,256,259,30448,117,113,138,145,14249,55,254,200,4,62,141,203,26053,26706
16,brc504d.map,256,259,53274,205,79,50,179,58747,226,45,29,213,-21,-34,55,1826,2316
17,brc504d.map,256,259,9809,37,32,218,226,53597,206,15,49,243,-169,-17,186,2824,1622
18,brc504d.map,256,259,63216,244,238,11,20,41393,159,46,96,212,85,-192,277,15295,27311
19,brc504d.map,256,259,54913,212,253,43,5,34038,131,149,124,109,81,-104,185,24678,26951
20,brc504d.map,256,259,24569,94,35,161,223,23555,90,13,165,245,4,-22,26,61,218
21,brc504d.map,256,259,53899,208,231,47,27,48614,187,77,68,181,21,-154,175,11143,5988
22,brc504d.map,256,259,31803,122,53,133,205,20142,77,59,178,199,45,6,51,52,52
23,brc504d.map,256,259,64288,248,202,7,56,29547,114,237,141,21,134,35,169,657,3329
24,brc504d.map,256,259,63828,246,144,9,114,4718,18,202,237,56,228,58,286,13628,10202
25,brc504d.map,256,259,47602,183,53,72,205,47263,182,133,73,125,1,80,81,15314,5402
26,brc504d.map,256,259,29933,115,110,140,148,43871,169,158,86,100,-54,48,102,14922,25161
27,brc504d.map,256,259,20141,77,60,178,198,46894,181,243,74,15,-104,183,287,22924,25369
28,brc504d.map,256,259,3737,14,147,241,111,57515,222,241,33,17,-208,94,302,4097,6797
29,brc504d.map,256,259,50427,194,77,61,181,46151,178,209,77,49,16,132,148,3756,11318
30,brc504d.map,256,259,40571,156,91,99,167,16606,64,228,191,30,92,137,229,26821,25814
31,brc504d.map,256,259,43564,168,206,87,52,55270,213,155,42,103,-45,-51,96,21188,20205
32,brc504d.map,256,259,2892,11,215,244,43,40549,156,113,99,145,-145,-102,247,17228,21046
33,brc504d.map,256,259,35065,135,158,120,100,45877,177,224,78,34,-42,66,108,23168,24019
34,brc504d.map,256,259,11552,44,102,211,156,47227,182,169,73,89,-138,67,205,26158,17320
35,brc504d.map,256,259,53443,206,169,49,89,43366,167,145,88,113,39,-24,63,17135,21512
36,brc504d.map,256,259,46866,180,12,75,246,17654,68,216,187,42,112,204,316,28358,12740
37,brc504d.map,256,259,7472,28,38,227,220,30170,116,132,139,126,-88,94,182,10416,9658
38,brc504d.map,256,259,18466,71,181,184,77,2083,8,247,247,11,63,66,129,135,2412
39,brc504d.map,256,259,18295,70,93,185,165,15295,59,244,196,14,11,151,162,5174,4891
40,brc504d.map,256,259,63706,245,7,10,251,49526,191,201,64,57,54,194,248,12382,7329
41,brc504d.map,256,259,39204,151,163,104,95,44493,171,54,84,204,-20,-109,129,130,130
42,brc504d.map,256,259,59545,229,24,26,234,60198,232,148,23,110,-3,124,127,1665,1328
43,brc504d.map,256,259,19003,73,162,182,96,26606,102,70,153,188,-29,-92,121,6431,1841
44,brc504d.map,256,259,42388,163,87,92,171,21903,84,111,171,147,79,24,103,20295,9324
45,brc504d.map,256,259,19784,76,158,179,100,5665,21,32,234,226,55,-126,181,10775,14450
46,brc504d.map,256,259,65077,251,190,4,68,1653,6,159,249,99,245,-31,276,8287,12842
47,brc504d.map,256,259,37971,146,101,109,157,52927,204,167,51,91,-58,66,124,21573,12762
48,brc504d.map,256,259,38729,149,120,106,138,47461,183,194,72,64,-34,74,108,109,114
49,brc504d.map,256,259,48849,188,101,67,157,42747,165,246,90,12,23,145,168,23625,27001
50,brc504d.map,256,259,54414,210,234,45,24,44047,170,241,85,17,40,7,47,88,430
51,brc504d.map,256,259,18467,71,180,184,78,4004,15,139,240,119,56,-41,97,710,1275
52,brc504d.map,256,259,10214,39,145,216,113,13079,50,129,205,129,-11,-16,27,35,28
53,brc504d.map,256,259,64400,248,90,7,168,21825,84,189,171,69,164,99,263,13980,16838
54,brc504d.map,256,259,59408,229,161,26,97,14486,55,17,200,241,174,-144,318,4998,18434
55,brc504d.map,256,259,43970,169,59,86,199,35747,138,253,117,5,31,194,225,24410,26547
56,brc504d.map,256,259,38280,147,51,108,207,25072,96,50,159,208,51,-1,52,79,73
57,brc504d.map,256,259,46688,180,190,75,68,14333,55,170,200,88,125,-20,145,25585,26394
58,brc504d.map,256,259,19249,74,175,181,83,37350,144,204,111,54,-70,29,99,100,114
59,brc504d.map,256,259,6562,25,171,230,87,59357,229,212,26,46,-204,41,245,6297,9901
60,brc504d.map,256,259,47385,182,11,73,247,11444,44,210,211,48,138,199,337,27326,12970
61,brc504d.map,256,259,26705,103,230,152,28,44129,170,159,85,99,-67,-71,138,31066,39191
62,brc504d.map,256,259,38306,147,25,108,233,11735,45,178,210,80,102,153,255,24076,9388
63,brc504d.map,256,259,31363,121,234,134,24,32501,125,132,130,126,-4,-102,106,28415,33587
64,brc504d.map,256,259,15265,58,15,197,243,39516,152,110,103,148,-94,95,189,2408,4086
65,brc504d.map,256,259,46074,177,27,78,231,61863,238,37,17,221,-61,10,71,538,208
66,brc504d.map,256,259,60065,231,22,24,236,49668,191,59,64,199,40,37,77,564,269
67,brc504d.map,256,259,1912,7,159,248,99,63191,243,4,12,254,-236,-155,391,9617,13540
68,brc504d.map,256,259,47973,185,200,70,58,59285,228,25,27,233,-43,-175,218,7076,11680
69,brc504d.map,256,259,45557,175,26,80,232,41886,161,71,94,187,14,45,59,2245,1425
70,brc504d.map,256,259,8256,31,31,224,227,28286,109,203,146,55,-78,172,250,14147,11702
71,brc504d.map,256,259,11994,46,178,209,80,48726,188,224,67,34,-142,46,188,3164,2650
72,brc504d.map,256,259,13379,51,88,204,170,42798,165,195,90,63,-114,107,221,15167,18028
73,brc504d.map,256,259,14582,56,180,199,78,16158,62,158,193,100,-6,-22,28,26345,25823
74,brc504d.map,256,259,30635,118,185,137,73,7022,27,229,228,29,91,44,135,27356,26592
75,brc504d.map,256,259,3385,13,240,242,18,56635,218,85,37,173,-205,-155,360,34207,27381
76,brc504d.map,256,259,7840,30,188,225,70,11943,46,229,209,29,-16,41,57,1320,2887
77,brc504d.map,256,259,44664,172,142,83,116,6337,24,137,231,121,148,-5,153,16221,17379
78,brc504d.map,256,259,55433,214,251,41,7,18754,72,152,183,106,142,-99,241,27838,26954
79,brc504d.map,256,259,11675,45,238,210,20,60156,232,190,23,68,-187,-48,235,2659,3119
80,brc504d.map,256,259,5526,21,171,234,87,18279,70,109,185,149,-49,-62,111,127,114
81,brc504d.map,256,259,7417,28,93,227,165,22079,85,194,170,64,-57,101,158,18820,15891
82,brc504d.map,256,259,16442,63,133,192,125,27658,106,54,149,204,-43,-79,122,10822,17245
83,brc504d.map,256,259,37273,143,22,112,236,13818,53,167,202,91,90,145,235,21585,8243
84,brc504d.map,256,259,36896,142,140,113,118,27570,106,142,149,116,36,2,38,39,39
85,brc504d.map,256,259,56566,218,154,37,104,20087,77,114,178,144,141,-40,181,29111,24664
86,brc504d.map,256,259,45217,174,107,81,151,59095,228,215,27,43,-54,108,162,21303,16864
87,brc504d.map,256,259,46169,178,191,77,67,10839,41,38,214,220,137,-153,290,14921,10910
88,brc504d.map,256,259,38688,149,161,106,97,14299,55,204,200,54,94,43,137,25989,25171
89,brc504d.map,256,259,39136,151,231,104,27,7377,28,133,227,125,123,-98,221,5817,6770
90,brc504d.map,256,259,45561,175,22,80,236,18221,70,167,185,91,105,145,250,2533,7366
91,brc504d.map,256,259,24761,95,102,160,156,40586,156,76,99,182,-61,-26,87,8773,20357
92,brc504d.map,256,259,23672,91,155,164,103,19890,76,52,179,206,15,-103,118,5026,1923
93,brc504d.map,256,259,32968,127,183,128,75,37250,143,45,112,213,-16,-138,154,221,2663
94,brc504d.map,256,259,63162,243,33,12,225,37147,143,148,112,110,100,115,215,5726,6489
95,brc504d.map,256,259,54571,210,77,45,181,38638,149,211,106,47,61,134,195,4242,12751
96,brc504d.map,256,259,43621,168,149,87,109,36967,142,69,113,189,26,-80,106,222,108
97,brc504d.map,256,259,21906,84,108,171,150,39381,152,245,103,13,-68,137,205,7493,10500
98,brc504d.map,256,259,30243,116,59,139,199,33291,128,119,127,139,-12,60,72,625,1065
99,brc504d.map,256,259,56666,218,54,37,204,22038,85,235,170,23,133,181,314,27054,17717
0,brc505d.map,193,260,35586,136,33,56,226,48710,187,169,5,90,-51,136,187,22627,35384
1,brc505d.map,193,260,28056,107,23,85,236,23895,91,24,101,235,16,1,17,18,18
2,brc505d.map,193,260,24552,94,147,98,112,15160,58,179,134,80,36,32,68,69,222
3,brc505d.map,193,260,36460,140,199,52,60,39788,153,251,39,8,-13,52,65,632,1459
4,brc505d.map,193,260,5834,22,145,170,114,25398,97,81,95,178,-75,-64,139,25125,5265
5,brc505d.map,193,260,3066,11,53,181,206,2443,9,156,183,103,2,103,105,227,827
6,brc505d.map,193,260,14554,55,5,137,254,10364,39,35,153,224,16,30,46,47,47
7,brc505d.map,193,260,24226,93,213,99,46,34679,133,160,59,99,-40,-53,93,1522,142
8,brc505d.map,193,260,6772,26,247,166,12,3366,12,13,180,246,14,-234,248,993,249
9,brc505d.map,193,260,38954,149,45,43,214,23229,89,170,103,89,60,125,185,11284,29619
10,brc505d.map,193,260,40179,154,120,38,139,47604,183,235,9,24,-29,115,144,4447,7785
11,brc505d.map,193,260,1199,4,100,188,159,7223,27,56,165,203,-23,-44,67,68,106
12,brc505d.map,193,260,21792,83,47,109,212,4796,18,143,174,116,65,96,161,735,11262
13,brc505d.map,193,260,20792,79,7,113,252,43811,168,128,24,131,-89,121,210,27902,15840
14,brc505d.map,193,260,1608,6,211,186,48,12076,46,143,146,116,-40,-68,108,109,109
15,brc505d.map,193,260,15796,60,63,132,196,12911,49,88,143,171,11,25,36,190,844
16,brc505d.map,193,260,49096,188,43,4,216,19658,75,101,117,158,113,58,171,6322,11495
17,brc505d.map,193,260,35939,138,200,54,59,3805,14,94,178,165,124,-106,230,1250,11416
18,brc505d.map,193,260,38939,149,60,43,199,48972,188,167,4,92,-39,107,146,23033,31701
19,brc505d.map,193,260,40578,156,241,36,18,20359,78,180,114,79,78,-61,139,545,2870
20,brc505d.map,193,260,47824,183,15,9,244,16554,63,85,129,174,120,70,190,6531,11760
21,brc505d.map,193,260,11977,46,242,146,17,49414,190,245,2,14,-144,3,147,2275,1145
22,brc505d.map,193,260,34467,132,112,60,147,12150,46,69,146,190,86,-43,129,6040,20292
23,brc505d.map,193,260,9298,35,61,157,198,44605,171,114,21,145,-136,53,189,25768,7250
24,brc505d.map,193,260,3737,14,162,178,97,47028,180,31,12,228,-166,-131,297,20253,4958
25,brc505d.map,193,260,40890,157,189,35,70,10244,39,155,153,104,118,-34,152,2770,11636
26,brc505d.map,193,260,37462,144,237,48,22,43958,169,241,23,18,-25,4,29,86,441
27,brc505d.map,193,260,39797,153,242,39,17,28526,109,73,83,186,44,-169,213,2190,2550
28,brc505d.map,193,260,10452,40,207,152,52,47172,181,147,11,112,-141,-60,201,20789,2915
29,brc505d.map,193,260,22168,85,191,107,68,21043,80,16,112,243,5,-175,180,7868,5216
30,brc505d.map,193,260,26588,102,191,90,68,41359,159,240,33,19,-57,49,106,1264,613
31,brc505d.map,193,260,12346,47,133,145,126,48253,185,106,7,153,-138,-27,165,14848,5288
32,brc505d.map,193,260,24578,94,121,98,138,11655,44,44,148,215,50,-77,127,1539,133
33,brc505d.map,193,260,16155,62,224,130,35,18631,71,88,121,171,-9,-136,145,638,1212
34,brc505d.map,193,260,49550,190,109,2,150,8519,32,60,160,199,158,-49,207,5826,25524
35,brc505d.map,193,260,43180,166,239,26,20,8702,33,137,159,122,133,-102,235,1226,7512
36,brc505d.map,193,260,29130,112,249,80,10,32029,123,210,69,49,-11,-39,50,52,161
37,brc505d.map,193,260,10185,39,214,153,45,19587,75,172,117,87,-36,-42,78,110,79
38,brc505d.map,193,260,9008,34,91,158,168,14700,56,119,136,140,-22,28,50,51,51
39,brc505d.map,193,260,6704,25,55,167,204,7578,29,221,163,38,-4,166,170,171,315
40,brc505d.map,193,260,32001,123,238,69,21,10741,41,178,151,81,82,-60,142,461,282
41,brc505d.map,193,260,15847,60,12,132,247,14567,56,252,136,7,4,240,244,1593,5823
42,brc505d.map,193,260,16617,63,22,129,237,9642,37,237,155,22,26,215,241,1736,5848
43,brc505d.map,193,260,38394,147,85,45,174,23157,89,242,103,17,58,157,215,1272,1720
44,brc505d.map,193,260,6155,23,84,169,175,1829,7,250,185,9,16,166,182,183,214
45,brc505d.map,193,260,31633,121,86,71,173,12702,48,37,144,222,73,-49,122,10630,26077
46,brc505d.map,193,260,21656,83,183,109,76,283,1,236,191,23,82,53,135,146,1127
47,brc505d.map,193,260,25441,97,38,95,221,12807,49,192,143,67,48,154,202,3018,12502
48,brc505d.map,193,260,12728,48,11,144,248,36665,141,254,51,5,-93,243,336,10809,8606
49,brc505d.map,193,260,45506,175,253,17,6,1532,5,27,187,232,170,-226,396,2777,17929
50,brc505d.map,193,260,4003,15,156,177,103,22436,86,183,106,76,-71,27,98,600,99
51,brc505d.map,193,260,18440,70,19,122,240,38093,146,126,46,133,-76,107,183,30174,14792
52,brc505d.map,193,260,29876,114,23,78,236,12109,46,110,146,149,68,87,155,3362,2401
53,brc505d.map,193,260,5240,20,219,172,40,6005,23,234,169,25,-3,15,18,19,19
54,brc505d.map,193,260,10980,42,199,150,60,44246,170,213,22,46,-128,14,142,7189,2334
55,brc505d.map,193,260,6057,23,182,169,77,17919,68,20,124,239,-45,-162,207,634,208
56,brc505d.map,193,260,8632,33,207,159,52,41490,159,109,33,150,-126,-98,224,10947,2182
57,brc505d.map,193,260,6049,23,190,169,69,46855,180,204,12,55,-157,14,171,10288,3486
58,brc505d.map,193,260,21635,83,204,109,55,47567,182,12,10,247,-99,-192,291,35022,8766
59,brc505d.map,193,260,11154,42,25,150,234,25070,96,149,96,110,-54,124,178,224,2395
60,brc505d.map,193,260,37643,144,56,48,203,30389,116,30,76,229,28,-26,54,1447,1383
61,brc505d.map,193,260,23106,88,33,104,226,32267,124,232,68,27,-36,199,235,7804,18866
62,brc505d.map,193,260,3400,13,239,179,20,15470,59,129,133,130,-46,-110,156,157,157
63,brc505d.map,193,260,43908,168,31,24,228,8924,34,175,158,84,134,144,278,6826,24852
64,brc505d.map,193,260,11313,43,126,149,133,37197,143,242,49,17,-100,116,216,738,440
65,brc505d.map,193,260,13904,53,135,139,124,5756,22,223,170,36,31,88,119,120,120
66,brc505d.map,193,260,35584,136,35,56,224,36923,142,256,50,3,-6,221,227,16518,36475
67,brc505d.map,193,260,29910,115,249,77,10,22478,86,141,106,118,29,-108,137,5170,1433
68,brc505d.map,193,260,853,3,186,189,73,10294,39,105,153,154,-36,-81,117,118,118
69,brc505d.map,193,260,11152,42,27,150,232,49564,190,95,2,164,-148,68,216,22878,9305
70,brc505d.map,193,260,46842,180,217,12,42,37709,145,250,47,9,35,33,68,183,234
71,brc505d.map,193,260,17148,65,11,127,248,1990,7,89,185,170,58,78,136,235,1072
72,brc505d.map,193,260,9400,36,219,156,40,36052,138,87,54,172,-102,-132,234,9410,1743
73,brc505d.map,193,260,15736,60,123,132,136,39108,150,151,42,108,-90,28,118,10056,1730
74,brc505d.map,193,260,43276,166,143,26,116,19295,74,204,118,55,92,61,153,2860,13879
75,brc505d.map,193,260,39170,150,89,42,170,49196,189,203,3,56,-39,114,153,5252,4105
76,brc505d.map,193,260,21817,83,22,109,237,25055,96,164,96,95,-13,142,155,9761,7208
77,brc505d.map,193,260,20809,80,250,112,9,43801,168,138,24,121,-88,-112,200,15295,2458
78,brc505d.map,193,260,25466,97,13,95,246,33463,128,76,64,183,-31,63,94,23924,17662
79,brc505d.map,193,260,5008,19,191,173,68,9807,37,72,155,187,-18,-119,137,138,138
80,brc505d.map,193,260,22982,88,157,104,102,20326,78,213,114,46,10,56,66,356,1674
81,brc505d.map,193,260,8475,32,104,160,155,43030,165,129,27,130,-133,25,158,25717,5782
82,brc505d.map,193,260,19514,75,245,117,14,44829,172,150,20,109,-97,-95,192,17411,2477
83,brc505d.map,193,260,4595,17,84,175,175,18063,69,136,123,123,-52,52,104,105,105
84,brc505d.map,193,260,30717,118,222,74,37,42094,161,25,31,234,-43,-197,240,35717,10030
85,brc505d.map,193,260,43643,167,36,25,223,8414,32,165,160,94,135,129,264,6979,22997
86,brc505d.map,193,260,6701,25,58,167,201,30197,116,222,76,37,-91,164,255,1363,387
87,brc505d.map,193,260,22242,85,117,107,142,28823,110,36,82,223,-25,-81,106,4694,3717
88,brc505d.map,193,260,47220,181,99,11,160,11277,43,162,149,97,138,63,201,5306,13633
89,brc505d.map,193,260,32274,124,225,68,34,37838,145,121,47,138,-21,-104,125,8542,3126
90,brc505d.map,193,260,11299,43,140,149,119,36900,141,19,51,240,-98,-121,219,4775,4104
91,brc505d.map,193,260,46520,178,19,14,240,40028,153,11,39,248,25,-8,33,3331,3244
92,brc505d.map,193,260,13138,50,121,142,138,18991,73,248,119,11,-23,127,150,151,180
93,brc505d.map,193,260,3032,11,87,181,172,5349,20,110,172,149,-9,23,32,33,33
94,brc505d.map,193,260,45864,176,155,16,104,574,2,205,190,54,174,50,224,3076,23042
95,brc505d.map,193,260,43491,167,188,25,71,10103,38,36,154,223,129,-152,281,5978,23318
96,brc505d.map,193,260,21787,83,52,109,207,32725,125,34,67,225,-42,-18,60,263,817
97,brc505d.map,193,260,45400,174,99,18,160,44837,172,142,20,117,2,43,45,200,187
98,brc505d.map,193,260,49384,189,15,3,244,12198,46,21,146,238,143,6,149,5707,6729
99,brc505d.map,193,260,38016,146,203,46,56,36861,141,58,51,201,5,-145,150,33021,16264
0,brc997d.map,252,184,5074,27,77,224,106,28853,156,34,95,149,-129,-43,172,1621,1805
1,brc997d.map,252,184,19257,104,62,147,121,14844,80,59,171,124,24,-3,27,28,28
2,brc997d.map,252,184,28615,155,88,96,95,41255,224,144,27,39,-69,56,125,189,726
3,brc997d.map,252,184,9721,52,30,199,153,26105,141,22,110,161,-89,-8,97,3142,19858
4,brc997d.map,252,184,38525,209,114,42,69,39079,212,112,39,71,-3,-2,5,6,6
5,brc997d.map,252,184,33710,183,145,68,38,11191,60,32,191,151,123,-113,236,19858,3142
6,brc997d.map,252,184,11110,60,113,191,70,34014,184,25,67,158,-124,-88,212,557,459
7,brc997d.map,252,184,18429,100,154,151,29,6878,37,113,214,70,63,-41,104,868,361
8,brc997d.map,252,184,8569,46,78,205,105,4626,25,157,226,26,21,79,100,3173,1334
9,brc997d.map,252,184,16712,90,31,161,152,18635,101,132,150,51,-11,101,112,3142,19858
10,brc997d.map,252,184,24717,134,122,117,61,34855,189,104,62,79,-55,-18,73,74,74
11,brc997d.map,252,184,20024,108,31,143,152,8768,47,63,204,120,61,32,93,3142,19858
12,brc997d.map,252,184,8394,45,69,206,114,20743,112,48,139,135,-67,-21,88,19858,3142
13,brc997d.map,252,184,35075,190,68,61,115,11735,63,40,188,143,127,-28,155,19858,3142
14,brc997d.map,252,184,13955,75,28,176,155,1589,8,66,243,117,67,38,105,3142,19858
15,brc997d.map,252,184,14106,76,61,175,122,15343,83,112,168,71,-7,51,58,3142,19858
16,brc997d.map,252,184,19307,104,12,147,171,19468,105,35,146,148,-1,23,24,25,25
17,brc997d.map,252,184,26547,144,132,107,51,13180,71,67,180,116,73,-65,138,258,176
18,brc997d.map,252,184,16544,89,15,162,168,23330,126,37,125,146,-37,22,59,3142,19858
19,brc997d.map,252,184,34626,188,149,63,34,7262,39,97,212,86,149,-52,201,207,1043
20,brc997d.map,252,184,24970,135,53,116,130,11366,61,41,190,142,74,-12,86,19858,3142
21,brc997d.map,252,184,15674,85,149,166,34,35181,191,146,60,37,-106,-3,109,1078,967
22,brc997d.map,252,184,31333,170,130,81,53,26478,143,17,108,166,27,-113,140,894,141
23,brc997d.map,252,184,16497,89,62,162,121,5827,31,60,220,123,58,-2,60,3142,19858
24,brc997d.map,252,184,13960,75,23,176,160,39827,216,100,35,83,-141,77,218,3142,19858
25,brc997d.map,252,184,10457,56,30,195,153,16141,87,50,164,133,-31,20,51,52,52
26,brc997d.map,252,184,24731,134,108,117,75,15158,82,113,169,70,52,5,57,58,58
27,brc997d.map,252,184,27700,150,83,101,100,7982,43,113,208,70,107,30,137,173,420
28,brc997d.map,252,184,15144,82,127,169,56,11991,65,152,186,31,17,25,42,61,47
29,brc997d.map,252,184,20323,110,100,141,83,19781,107,90,144,93,3,-10,13,14,14
30,brc997d.map,252,184,14811,80,92,171,91,38501,209,138,42,45,-129,46,175,639,180
31,brc997d.map,252,184,30866,167,45,84,138,20359,110,64,141,119,57,19,76,19858,3142
32,brc997d.map,252,184,14089,76,78,175,105,21651,117,60,134,123,-41,-18,59,1230,301
33,brc997d.map,252,184,9090,49,109,202,74,40766,221,81,30,102,-172,-28,200,1469,204
34,brc997d.map,252,184,36120,196,127,55,56,26482,143,13,108,170,53,-114,167,885,192
35,brc997d.map,252,184,3982,21,65,230,118,14695,79,24,172,159,-58,-41,99,19858,3142
36,brc997d.map,252,184,23107,125,76,126,107,7996,43,99,208,84,82,23,105,1458,779
37,brc997d.map,252,184,18556,100,27,151,156,12621,68,74,183,109,32,47,79,3142,19858
38,brc997d.map,252,184,39233,213,142,38,41,36006,195,57,56,126,18,-85,103,104,104
39,brc997d.map,252,184,14810,80,93,171,90,8367,45,96,206,87,35,3,38,254,334
40,brc997d.map,252,184,4629,25,154,226,29,10421,56,66,195,117,-31,-88,119,1547,3344
41,brc997d.map,252,184,34089,185,134,66,49,30885,167,26,84,157,18,-108,126,655,142
42,brc997d.map,252,184,5995,32,76,219,107,9700,52,51,199,132,-20,-25,45,46,46
43,brc997d.map,252,184,16141,87,50,164,133,13199,71,48,180,135,16,-2,18,19,19
44,brc997d.map,252,184,31729,172,102,79,81,38500,209,139,42,44,-37,37,74,154,232
45,brc997d.map,252,184,33421,181,66,70,117,17359,94,120,157,63,87,54,141,145,280
46,brc997d.map,252,184,28793,156,94,95,89,24742,134,97,117,86,22,3,25,26,26
47,brc997d.map,252,184,29938,162,53,89,130,35175,191,152,60,31,-29,99,128,146,1075
48,brc997d.map,252,184,35940,195,123,56,60,45532,247,99,4,84,-52,-24,76,169,85
49,brc997d.map,252,184,19164,104,155,147,28,33781,183,74,68,109,-79,-81,160,315,161
50,brc997d.map,252,184,9815,53,120,198,63,6367,34,72,217,111,19,-48,67,206,69
51,brc997d.map,252,184,28417,154,102,97,81,9327,50,56,201,127,104,-46,150,171,186
52,brc997d.map,252,184,32248,175,135,76,48,9273,50,110,201,73,125,-25,150,156,448
53,brc997d.map,252,184,33380,181,107,70,76,16646,90,97,161,86,91,-10,101,102,169
54,brc997d.map,252,184,2302,12,89,239,94,31247,169,32,82,151,-157,-57,214,2024,3465
55,brc997d.map,252,184,14305,77,46,174,137,34492,187,99,64,84,-110,53,163,3142,19858
56,brc997d.map,252,184,39988,217,123,34,60,18246,99,153,152,30,118,30,148,149,270
57,brc997d.map,252,184,9464,51,103,200,80,18409,100,174,151,9,-49,71,120,250,944
58,brc997d.map,252,184,34020,184,19,67,164,26605,144,74,107,109,40,55,95,160,115
59,brc997d.map,252,184,21106,114,53,137,130,10374,56,113,195,70,58,60,118,3142,19858
60,brc997d.map,252,184,14704,79,15,172,168,23172,125,11,126,172,-46,-4,50,3142,19858
61,brc997d.map,252,184,28489,154,30,97,153,1194,6,93,245,90,148,63,211,3143,2206
62,brc997d.map,252,184,29537,160,86,91,97,16293,88,82,163,101,72,-4,76,77,77
63,brc997d.map,252,184,15740,85,83,166,100,31246,169,33,82,150,-84,-50,134,353,318
64,brc997d.map,252,184,34272,186,135,65,48,21669,117,42,134,141,69,-93,162,19858,3142
65,brc997d.map,252,184,17334,94,145,157,38,15470,84,169,167,14,10,24,34,41,35
66,brc997d.map,252,184,13285,72,146,179,37,27894,151,73,100,110,-79,-73,152,371,420
67,brc997d.map,252,184,45140,245,123,6,60,25628,139,131,112,52,106,8,114,115,115
68,brc997d.map,252,184,14956,81,131,170,52,18293,99,106,152,77,-18,-25,43,44,44
69,brc997d.map,252,184,32970,179,149,72,34,18188,98,27,153,156,81,-122,203,19858,3142
70,brc997d.map,252,184,33720,183,135,68,48,32972,179,147,72,36,4,12,16,17,17
71,brc997d.map,252,184,30478,165,65,86,118,9263,50,120,201,63,115,55,170,233,564
72,brc997d.map,252,184,22316,121,131,130,52,16421,89,138,162,45,32,7,39,40,40
73,brc997d.map,252,184,23440,127,111,124,72,33612,182,59,69,124,-55,-52,107,161,114
74,brc997d.map,252,184,42034,228,101,23,82,7108,38,67,213,116,190,-34,224,228,1266
75,brc997d.map,252,184,32504,176,63,75,120,38568,209,71,42,112,-33,8,41,66,42
76,brc997d.map,252,184,24358,132,113,119,70,33527,182,144,69,39,-50,31,81,117,82
77,brc997d.map,252,184,13538,73,77,178,106,18019,97,12,154,171,-24,-65,89,19858,3142
78,brc997d.map,252,184,17358,94,121,157,62,26046,141,81,110,102,-47,-40,87,88,88
79,brc997d.map,252,184,31338,170,125,81,58,42365,230,138,21,45,-60,13,73,161,75
80,brc997d.map,252,184,30129,163,46,88,137,8342,45,121,206,62,118,75,193,427,1410
81,brc997d.map,252,184,17889,97,142,154,41,7567,41,160,210,23,56,18,74,83,412
82,brc997d.map,252,184,7301,39,58,212,125,16455,89,104,162,79,-50,46,96,481,126
83,brc997d.map,252,184,35960,195,103,56,80,8721,47,110,204,73,148,7,155,156,208
84,brc997d.map,252,184,23081,125,102,126,81,22515,122,116,129,67,3,14,17,18,18
85,brc997d.map,252,184,33937,184,102,67,81,19562,106,125,145,58,78,23,101,102,102
86,brc997d.map,252,184,5739,31,148,220,35,15478,84,161,167,22,-53,13,66,67,67
87,brc997d.map,252,184,41472,225,111,26,72,29581,160,42,91,141,65,-69,134,269,402
88,brc997d.map,252,184,36345,197,86,54,97,10373,56,114,195,69,141,28,169,170,947
89,brc997d.map,252,184,45708,248,107,3,76,26060,141,67,110,116,107,-40,147,148,836
90,brc997d.map,252,184,43117,234,122,17,61,42934,233,121,18,62,1,-1,2,3,3
91,brc997d.map,252,184,17217,93,78,158,105,15657,85,166,166,17,8,88,96,217,97
92,brc997d.map,252,184,18720,101,47,150,136,22524,122,107,129,76,-21,60,81,3142,19858
93,brc997d.map,252,184,43153,234,86,17,97,7385,40,158,211,25,194,72,266,927,1100
94,brc997d.map,252,184,27563,149,36,102,147,25279,137,112,114,71,12,76,88,176,89
95,brc997d.map,252,184,9512,51,55,200,128,19287,104,32,147,151,-53,-23,76,19858,3142
96,brc997d.map,252,184,27923,151,44,100,139,8733,47,98,204,85,104,54,158,3061,1270
97,brc997d.map,252,184,45873,249,126,2,57,31711,172,120,79,63,77,-6,83,84,192
98,brc997d.map,252,184,15345,83,110,168,73,24733,134,106,117,77,-51,-4,55,56,56
99,brc997d.map,252,184,13990,76,177,175,6,2871,15,72,236,111,61,-105,166,1844,3082
0,brc999d.map,157,178,5392,30,125,126,52,8593,48,128,108,49,-18,3,21,76,115
1,brc999d.map,157,178,27872,156,73,0,104,19533,109,46,47,131,47,-27,74,172,765
2,brc999d.map,157,178,17386,97,57,59,120,2381,13,110,143,67,84,53,137,138,183
3,brc999d.map,157,178,19496,109,83,47,94,20078,112,35,44,142,-3,-48,51,53,52
4,brc999d.map,157,178,17752,99,47,57,130,15764,88,77,68,100,11,30,41,42,42
5,brc999d.map,157,178,16297,91,78,65,99,8889,49,10,107,167,42,-68,110,160,111
6,brc999d.map,157,178,15363,86,122,70,55,7685,43,146,113,31,43,24,67,71,68
7,brc999d.map,157,178,22900,128,61,28,116,9295,52,138,104,39,76,77,153,373,154
8,brc999d.map,157,178,17680,99,119,57,58,4387,24,62,132,115,75,-57,132,148,133
9,brc999d.map,157,178,17538,98,83,58,94,8495,47,48,109,129,51,-35,86,87,91
10,brc999d.map,157,178,13216,74,133,82,44,23215,130,102,26,75,-56,-31,87,88,88
11,brc999d.map,157,178,6821,38,120,118,57,16918,95,169,61,8,-57,49,106,160,218
12,brc999d.map,157,178,11000,61,35,95,142,17845,100,132,56,45,-39,97,136,240,137
13,brc999d.map,157,178,15434,86,51,70,126,11899,66,26,90,151,20,-25,45,46,46
14,brc999d.map,157,178,23231,130,86,26,91,21463,120,74,36,103,10,-12,22,23,23
15,brc999d.map,157,178,11432,64,137,92,40,11681,65,66,91,111,-1,-71,72,73,73
16,brc999d.map,157,178,15576,87,87,69,90,16632,93,99,63,78,-6,12,18,19,19
17,brc999d.map,157,178,12364,69,95,87,82,6838,38,103,118,74,31,8,39,41,81
18,brc999d.map,157,178,15752,88,89,68,88,22547,126,58,30,119,-38,-31,69,70,70
19,brc999d.map,157,178,3448,19,111,137,66,11694,65,53,91,124,-46,-58,104,105,450
20,brc999d.map,157,178,5099,28,62,128,115,11599,65,148,91,29,-37,86,123,126,366
21,brc999d.map,157,178,11648,65,99,91,78,6166,34,63,122,114,31,-36,67,68,68
22,brc999d.map,157,178,13907,78,154,78,23,16604,93,127,63,50,-15,-27,42,43,43
23,brc999d.map,157,178,11441,64,128,92,49,7508,42,145,114,32,22,17,39,40,40
24,brc999d.map,157,178,2789,15,58,141,119,22718,127,65,29,112,-112,7,119,120,120
25,brc999d.map,157,178,17721,99,78,57,99,14261,80,156,76,21,19,78,97,98,98
26,brc999d.map,157,178,23780,133,71,23,106,6286,35,121,121,56,98,50,148,149,425
27,brc999d.map,157,178,8222,46,143,110,34,9831,55,136,101,41,-9,-7,16,17,17
28,brc999d.map,157,178,9555,53,56,103,121,17189,96,76,60,101,-43,20,63,64,64
29,brc999d.map,157,178,19638,110,119,46,58,17015,95,72,61,105,15,-47,62,63,63
30,brc999d.map,157,178,11996,67,107,89,70,7030,39,89,117,88,28,-18,46,47,47
31,brc999d.map,157,178,14611,82,162,74,15,11446,64,123,92,54,18,-39,57,58,58
32,brc999d.map,157,178,10644,59,35,97,142,10983,61,52,95,125,-2,17,19,20,20
33,brc999d.map,157,178,17098,96,167,60,10,12606,70,31,86,146,26,-136,162,163,163
34,brc999d.map,157,178,16241,91,134,65,43,6468,36,117,120,60,55,-17,72,84,73
35,brc999d.map,157,178,13416,75,111,81,66,8049,45,138,111,39,30,27,57,58,72
36,brc999d.map,157,178,7913,44,96,112,81,12867,72,126,84,51,-28,30,58,59,59
37,brc999d.map,157,178,10448,58,53,98,124,9210,51,45,105,132,7,-8,15,16,16
38,brc999d.map,157,178,2800,15,47,141,130,12315,69,144,87,33,-54,97,151,164,548
39,brc999d.map,157,178,14264,80,153,76,24,12573,70,64,86,113,10,-89,99,100,100
40,brc999d.map,157,178,17543,98,78,58,99,7375,41,100,115,77,57,22,79,80,80
41,brc999d.map,157,178,15733,88,108,68,69,8077,45,110,111,67,43,2,45,113,60
42,brc999d.map,157,178,16626,93,105,63,72,19531,109,48,47,129,-16,-57,73,74,74
43,brc999d.map,157,178,22515,126,90,30,87,26628,149,71,7,106,-23,-19,42,49,43
44,brc999d.map,157,178,8425,47,118,109,59,10607,59,72,97,105,-12,-46,58,73,209
45,brc999d.map,157,178,16283,91,92,65,85,17734,99,65,57,112,-8,-27,35,36,36
46,brc999d.map,157,178,16678,93,53,63,124,20255,113,36,43,141,-20,-17,37,144,38
47,brc999d.map,157,178,6539,36,46,120,131,4388,24,61,132,116,12,15,27,28,28
48,brc999d.map,157,178,5410,30,107,126,70,5622,31,73,125,104,-1,-34,35,36,36
49,brc999d.map,157,178,8530,47,13,109,164,14262,80,155,76,22,-33,142,175,181,984
50,brc999d.map,157,178,16633,93,98,63,79,16742,94,167,62,10,-1,69,70,838,222
51,brc999d.map,157,178,8531,47,12,109,165,2559,14,110,142,67,33,98,131,165,134
52,brc999d.map,157,178,12737,71,78,85,99,20225,113,66,43,111,-42,-12,54,55,55
53,brc999d.map,157,178,1344,7,79,149,98,15133,85,174,71,3,-78,95,173,231,174
54,brc999d.map,157,178,11978,67,125,89,52,12486,70,151,86,26,-3,26,29,30,30
55,brc999d.map,157,178,4323,24,126,132,51,7190,40,107,116,70,-16,-19,35,36,67
56,brc999d.map,157,178,9664,54,125,102,52,2606,14,63,142,114,40,-62,102,106,238
57,brc999d.map,157,178,19856,111,79,45,98,10962,61,73,95,104,50,-6,56,57,57
58,brc999d.map,157,178,14808,83,143,73,34,7855,44,154,112,23,39,11,50,51,51
59,brc999d.map,157,178,11697,65,50,91,127,13316,74,33,82,144,-9,-17,26,27,27
60,brc999d.map,157,178,18251,102,82,54,95,7276,40,21,116,156,62,-61,123,275,124
61,brc999d.map,157,178,10305,57,18,99,159,26454,148,67,8,110,-91,49,140,3318,240
62,brc999d.map,157,178,12204,68,77,88,100,13847,77,36,79,141,-9,-41,50,51,51
63,brc999d.map,157,178,17041,95,46,61,131,3323,18,58,138,119,77,12,89,90,339
64,brc999d.map,157,178,14353,80,64,76,113,19461,109,118,47,59,-29,54,83,84,84
65,brc999d.map,157,178,10125,56,20,100,157,17046,95,41,61,136,-39,21,60,61,64
66,brc999d.map,157,178,15136,85,171,71,6,23227,130,90,26,87,-45,-81,126,269,1532
67,brc999d.map,157,178,21137,118,44,38,133,6822,38,119,118,58,80,75,155,156,156
68,brc999d.map,157,178,8400,47,143,109,34,15350,86,135,70,42,-39,-8,47,48,48
69,brc999d.map,157,178,9289,52,144,104,33,13249,74,100,82,77,-22,-44,66,67,109
70,brc999d.map,157,178,18280,102,53,54,124,22521,126,84,30,93,-24,31,55,56,56
71,brc999d.map,157,178,14682,82,91,74,86,15883,89,136,67,41,-7,45,52,53,53
72,brc999d.map,157,178,9888,55,79,101,98,19485,109,94,47,83,-54,15,69,70,73
73,brc999d.map,157,178,15177,85,130,71,47,22335,125,92,31,85,-40,-38,78,79,79
74,brc999d.map,157,178,11441,64,128,92,49,15522,87,141,69,36,-23,13,36,37,37
75,brc999d.map,157,178,7243,40,54,116,123,20014,112,99,44,78,-72,45,117,118,118
76,brc999d.map,157,178,9185,51,70,105,107,11135,62,78,94,99,-11,8,19,20,20
77,brc999d.map,157,178,5608,31,87,125,90,16916,95,171,61,6,-64,84,148,204,354
78,brc999d.map,157,178,9464,53,147,103,30,16077,90,120,66,57,-37,-27,64,65,65
79,brc999d.map,157,178,2971,16,54,140,123,11462,64,107,92,70,-48,53,101,108,123
80,brc999d.map,157,178,9998,56,147,100,30,16390,92,163,64,14,-36,16,52,63,53
81,brc999d.map,157,178,20946,117,57,39,120,21629,121,86,35,91,-4,29,33,34,34
82,brc999d.map,157,178,13457,75,70,81,107,4043,22,50,134,127,53,-20,73,74,74
83,brc999d.map,157,178,5733,32,140,124,37,9783,54,6,102,171,-22,-134,156,165,1360
84,brc999d.map,157,178,13112,73,59,83,118,10974,61,61,95,116,12,2,14,15,15
85,brc999d.map,157,178,13614,76,91,80,86,7815,43,16,113,161,33,-75,108,109,145
86,brc999d.map,157,178,7779,43,52,113,125,5285,29,54,127,123,14,2,16,17,17
87,brc999d.map,157,178,13457,75,70,81,107,7077,39,42,117,135,36,-28,64,65,65
88,brc999d.map,157,178,20594,115,53,41,124,9467,53,144,103,33,62,91,153,388,154
89,brc999d.map,157,178,20556,115,91,41,86,4735,26,70,130,107,89,-21,110,111,300
90,brc999d.map,157,178,8323,46,42,110,135,19885,111,50,45,127,-65,8,73,74,74
91,brc999d.map,157,178,15757,88,84,68,93,15525,87,138,69,39,1,54,55,56,56
92,brc999d.map,157,178,8444,47,99,109,78,7420,41,55,115,122,6,-44,50,51,51
93,brc999d.map,157,178,8296,46,69,110,108,20928,117,75,39,102,-71,6,77,78,78
94,brc999d.map,157,178,5618,31,77,125,100,13054,73,117,83,60,-42,40,82,83,83
95,brc999d.map,157,178,14442,81,153,75,24,23077,129,62,27,115,-48,-91,139,141,469
96,brc999d.map,157,178,6512,36,73,120,104,20429,114,40,42,137,-78,-33,111,388,112
97,brc999d.map,157,178,12346,69,113,87,64,9431,52,2,104,175,17,-111,128,231,129
98,brc999d.map,157,178,6896,38,45,118,132,9024,50,53,106,124,-12,8,20,21,21
99,brc999d.map,157,178,14739,82,34,74,143,1150,6,95,150,82,76,61,137,164,141
0,combat.map,193,177,18333,103,74,89,102,31110,175,41,17,135,-72,-33,105,106,106
1,combat.map,193,177,3824,21,69,171,107,22276,125,25,67,151,-104,-44,148,149,149
2,combat.map,193,177,509,2,21,190,155,10974,62,176,130,0,-60,155,215,216,216
3,combat.map,193,177,30586,172,34,20,142,25559,144,105,48,71,28,71,99,2507,978
4,combat.map,193,177,31689,179,170,13,6,27077,152,3,40,173,27,-167,194,2149,2477
5,combat.map,193,177,18305,103,102,89,74,16679,94,135,98,41,9,33,42,43,43
6,combat.map,193,177,28856,163,171,29,5,2624,14,30,178,146,149,-141,290,469,310
7,combat.map,193,177,16352,92,108,100,68,31380,177,125,15,51,-85,17,102,103,103
8,combat.map,193,177,25600,144,64,48,112,7849,44,115,148,61,100,51,151,152,152
9,combat.map,193,177,15543,87,32,105,144,5727,32,113,160,63,55,81,136,137,137
10,combat.map,193,177,30291,171,152,21,24,16676,94,138,98,38,77,-14,91,92,92
11,combat.map,193,177,13834,78,148,114,28,4460,25,141,167,35,53,-7,60,61,61
12,combat.map,193,177,2617,14,37,178,139,14403,81,110,111,66,-67,73,140,141,141
13,combat.map,193,177,16108,91,175,101,1,8764,49,85,143,91,42,-90,132,133,133
14,combat.map,193,177,21644,122,126,70,50,12365,69,24,123,152,53,-102,155,156,156
15,combat.map,193,177,6196,35,175,157,1,3118,17,67,175,109,18,-108,126,396,1876
16,combat.map,193,177,10816,61,157,131,19,1391,7,24,185,152,54,-133,187,188,332
17,combat.map,193,177,13499,76,129,116,47,25501,144,163,48,13,-68,34,102,103,103
18,combat.map,193,177,20710,117,175,75,1,8886,50,140,142,36,67,-35,102,103,103
19,combat.map,193,177,10795,60,1,132,175,5853,33,164,159,12,27,163,190,831,191
20,combat.map,193,177,23105,130,81,62,95,27082,153,175,39,1,-23,94,117,118,118
21,combat.map,193,177,21846,123,101,69,75,26575,150,151,42,25,-27,50,77,78,78
22,combat.map,193,177,10508,59,111,133,65,30054,169,35,23,141,-110,-76,186,187,187
23,combat.map,193,177,17548,99,151,93,25,1901,10,45,182,131,89,-106,195,196,256
24,combat.map,193,177,29873,168,39,24,137,3591,20,125,172,51,148,86,234,235,235
25,combat.map,193,177,20982,118,80,74,96,28542,161,131,31,45,-43,51,94,95,95
26,combat.map,193,177,19642,110,4,82,172,25194,142,116,50,60,-32,112,144,145,145
27,combat.map,193,177,9342,52,38,140,138,12670,71,73,121,103,-19,35,54,55,55
28,combat.map,193,177,740,4,144,188,32,25701,145,140,47,36,-141,-4,145,188,652
29,combat.map,193,177,14645,82,45,110,131,30351,171,92,21,84,-89,47,136,137,137
30,combat.map,193,177,25816,145,25,47,151,11722,66,136,126,40,79,111,190,191,191
31,combat.map,193,177,12346,69,43,123,133,1166,6,72,186,104,63,29,92,93,93
32,combat.map,193,177,7966,45,175,147,1,343,1,10,191,166,44,-165,209,210,210
33,combat.map,193,177,20795,117,90,75,86,1039,5,22,187,154,112,-68,180,181,181
34,combat.map,193,177,17900,101,153,91,23,31678,178,4,14,172,-77,-149,226,227,227
35,combat.map,193,177,27825,157,140,35,36,28343,160,153,32,23,-3,13,16,17,17
36,combat.map,193,177,13099,74,175,118,1,32253,182,137,10,39,-108,-38,146,147,147
37,combat.map,193,177,33848,191,135,1,41,24902,140,54,52,122,51,-81,132,1937,133
38,combat.map,193,177,24286,137,139,55,37,10519,59,100,133,76,78,-39,117,118,118
39,combat.map,193,177,26000,146,18,46,158,7659,43,128,149,48,103,110,213,214,214
40,combat.map,193,177,8184,46,134,146,42,11665,65,16,127,160,-19,-118,137,138,138
41,combat.map,193,177,25443,143,44,49,132,5075,28,57,164,119,115,13,128,129,129
42,combat.map,193,177,10877,61,96,131,80,15311,86,87,106,89,-25,-9,34,35,35
43,combat.map,193,177,10056,56,32,136,144,25835,145,6,47,170,-89,-26,115,116,116
44,combat.map,193,177,28539,161,134,31,42,13782,77,23,115,153,84,-111,195,196,196
45,combat.map,193,177,19057,107,58,85,118,22340,126,138,66,38,-19,80,99,100,100
46,combat.map,193,177,3067,17,118,175,58,20375,115,156,77,20,-98,38,136,137,137
47,combat.map,193,177,12610,71,133,121,43,9942,56,146,136,30,15,13,28,29,29
48,combat.map,193,177,11136,62,14,130,162,28635,161,38,31,138,-99,24,123,124,124
49,combat.map,193,177,841,4,43,188,133,17060,96,108,96,68,-92,65,157,158,158
50,combat.map,193,177,7641,43,146,149,30,22021,124,103,68,73,-81,-43,124,125,125
51,combat.map,193,177,12064,68,148,124,28,18536,104,48,88,128,-36,-100,136,137,137
52,combat.map,193,177,4283,24,141,168,35,16479,93,158,99,18,-69,17,86,87,87
53,combat.map,193,177,25368,143,119,49,57,13621,76,7,116,169,67,-112,179,180,180
54,combat.map,193,177,9705,54,29,138,147,26231,148,141,44,35,-94,112,206,207,207
55,combat.map,193,177,5160,29,149,163,27,1112,6,126,186,50,23,-23,46,47,137
56,combat.map,193,177,17242,97,103,95,73,8700,49,149,143,27,48,46,94,95,95
57,combat.map,193,177,28388,160,108,32,68,18621,105,140,87,36,55,32,87,88,88
58,combat.map,193,177,33797,190,9,2,167,22877,129,132,63,44,61,123,184,185,185
59,combat.map,193,177,24611,139,168,53,8,1452,8,140,184,36,131,-28,159,160,160
60,combat.map,193,177,24277,137,148,55,28,21454,121,139,71,37,16,-9,25,26,26
61,combat.map,193,177,23696,133,21,59,155,13412,75,39,117,137,58,18,76,77,77
62,combat.map,193,177,20436,115,95,77,81,5215,29,94,163,82,86,-1,87,88,88
63,combat.map,193,177,3649,20,67,172,109,15206,85,15,107,161,-65,-52,117,118,118
64,combat.map,193,177,8241,46,77,146,99,11431,64,73,128,103,-18,-4,22,23,23
65,combat.map,193,177,9411,53,146,139,30,30451,172,169,20,7,-119,23,142,143,143
66,combat.map,193,177,27580,155,31,37,145,8277,46,41,146,135,109,10,119,120,120
67,combat.map,193,177,1938,10,8,182,168,11429,64,75,128,101,-54,67,121,122,122
68,combat.map,193,177,17227,97,118,95,58,24823,140,133,52,43,-43,15,58,59,59
69,combat.map,193,177,19352,109,117,83,59,6766,38,136,154,40,71,19,90,91,91
70,combat.map,193,177,19389,109,80,83,96,9783,55,128,137,48,54,48,102,103,103
71,combat.map,193,177,14156,79,3,113,173,1886,10,60,182,116,69,57,126,127,127
72,combat.map,193,177,3416,19,123,173,53,14296,80,40,112,136,-61,-83,144,145,145
73,combat.map,193,177,32333,182,57,10,119,1782,10,164,182,12,172,107,279,280,280
74,combat.map,193,177,2901,16,107,176,69,31446,177,59,15,117,-161,-48,209,210,210
75,combat.map,193,177,1061,5,0,187,176,12582,71,161,121,15,-66,161,227,442,228
76,combat.map,193,177,18784,106,154,86,22,4628,26,150,166,26,80,-4,84,85,85
77,combat.map,193,177,26825,151,78,41,98,14017,79,142,113,34,72,64,136,137,137
78,combat.map,193,177,27881,157,84,35,92,23651,133,66,59,110,24,-18,42,43,43
79,combat.map,193,177,30306,171,137,21,39,18239,103,168,89,8,68,31,99,100,100
80,combat.map,193,177,6834,38,68,154,108,10679,60,117,132,59,-22,49,71,72,72
81,combat.map,193,177,25308,142,2,50,174,2597,14,57,178,119,128,55,183,184,184
82,combat.map,193,177,2595,14,59,178,117,21164,119,75,73,101,-105,16,121,122,122
83,combat.map,193,177,627,3,80,189,96,7693,43,94,149,82,-40,14,54,55,55
84,combat.map,193,177,1723,9,46,183,130,13525,76,103,116,73,-67,57,124,125,125
85,combat.map,193,177,2579,14,75,178,101,13374,75,77,117,99,-61,2,63,64,64
86,combat.map,193,177,14363,81,150,111,26,6317,35,54,157,122,46,-96,142,143,143
87,combat.map,193,177,33713,190,93,2,83,22143,125,158,67,18,65,65,130,131,131
88,combat.map,193,177,2462,13,15,179,161,3494,19,45,173,131,-6,30,36,37,37
89,combat.map,193,177,13494,76,134,116,42,11958,67,77,125,99,9,-57,66,67,67
90,combat.map,193,177,11896,67,139,125,37,18104,102,126,90,50,-35,-13,48,49,49
91,combat.map,193,177,4654,26,124,166,52,22806,128,26,64,150,-102,-98,200,201,201
92,combat.map,193,177,19105,107,10,85,166,18557,104,27,88,149,3,17,20,21,21
93,combat.map,193,177,23394,132,146,60,30,30790,173,7,19,169,-41,-139,180,181,181
94,combat.map,193,177,21106,119,133,73,43,13044,73,53,119,123,46,-80,126,127,127
95,combat.map,193,177,19052,107,63,85,113,6588,37,137,155,39,70,74,144,145,145
96,combat.map,193,177,21880,123,67,69,109,17747,100,129,92,47,23,62,85,86,86
97,combat.map,193,177,8392,47,103,145,73,13602,76,26,116,150,-29,-77,106,107,107
98,combat.map,193,177,26472,149,77,43,99,9350,52,30,140,146,97,-47,144,145,145
99,combat.map,193,177,21589,121,4,71,172,28454,160,42,32,134,-39,38,77,78,78
0,combat2.map,193,177,1500,8,92,184,84,3790,21,103,171,73,-13,11,24,25,25
1,combat2.map,193,177,33778,190,28,2,148,18509,104,75,88,101,86,47,133,134,1057
2,combat2.map,193,177,10683,60,113,132,63,836,4,48,188,128,56,-65,121,122,122
3,combat2.map,193,177,18592,105,169,87,7,16553,93,84,99,92,12,-85,97,98,98
4,combat2.map,193,177,21664,122,106,70,70,23698,133,19,59,157,-11,-87,98,99,99
5,combat2.map,193,177,4000,22,70,170,106,6805,38,97,154,79,-16,27,43,44,44
6,combat2.map,193,177,5923,33,94,159,82,11478,64,26,128,150,-31,-68,99,100,100
7,combat2.map,193,177,20777,117,108,75,68,7311,41,122,151,54,76,14,90,91,91
8,combat2.map,193,177,11961,67,74,125,102,8198,46,120,146,56,21,46,67,68,68
9,combat2.map,193,177,31082,175,69,17,107,18991,107,124,85,52,68,55,123,124,124
10,combat2.map,193,177,30657,173,140,19,36,21962,124,162,68,14,49,22,71,72,72
11,combat2.map,193,177,15688,88,64,104,112,33998,192,162,0,14,-104,98,202,2041,203
12,combat2.map,193,177,19682,111,141,81,35,2479,14,175,178,1,97,34,131,438,132
13,combat2.map,193,177,8274,46,44,146,132,33044,186,54,6,122,-140,10,150,151,151
14,combat2.map,193,177,26369,148,3,44,173,12139,68,73,124,103,80,70,150,151,151
15,combat2.map,193,177,24560,138,42,54,134,8589,48,83,144,93,90,41,131,132,132
16,combat2.map,193,177,10490,59,129,133,47,27551,155,60,37,116,-96,-69,165,166,166
17,combat2.map,193,177,3659,20,57,172,119,29036,164,168,28,8,-144,111,255,256,324
18,combat2.map,193,177,24556,138,46,54,130,19725,111,98,81,78,27,52,79,80,80
19,combat2.map,193,177,18709,105,52,87,124,2197,12,103,180,73,93,51,144,145,145
20,combat2.map,193,177,9904,55,7,137,169,21291,120,125,72,51,-65,118,183,184,184
21,combat2.map,193,177,14176,80,160,112,16,2305,13,172,179,4,67,12,79,80,80
22,combat2.map,193,177,23153,130,33,62,143,7841,44,123,148,53,86,90,176,177,177
23,combat2.map,193,177,17574,99,125,93,51,3439,19,100,173,76,80,-25,105,106,106
24,combat2.map,193,177,13446,75,5,117,171,12975,73,122,119,54,2,117,119,120,120
25,combat2.map,193,177,30368,171,75,21,101,10550,59,69,133,107,112,-6,118,119,119
26,combat2.map,193,177,31875,180,161,12,15,4628,26,150,166,26,154,-11,165,256,2570
27,combat2.map,193,177,11558,65,123,127,53,6534,36,14,156,162,29,-109,138,448,139
28,combat2.map,193,177,17146,96,22,96,154,3531,19,8,173,168,77,-14,91,130,92
29,combat2.map,193,177,30704,173,93,19,83,7167,40,89,152,87,133,-4,137,138,138
30,combat2.map,193,177,22610,127,45,65,131,30084,169,5,23,171,-42,-40,82,83,83
31,combat2.map,193,177,30432,171,11,21,165,11880,67,155,125,21,104,144,248,249,249
32,combat2.map,193,177,11621,65,60,127,116,6239,35,132,157,44,30,72,102,103,103
33,combat2.map,193,177,12656,71,87,121,89,23710,133,7,59,169,-62,-80,142,143,143
34,combat2.map,193,177,23064,130,122,62,54,26361,148,11,44,165,-18,-111,129,130,130
35,combat2.map,193,177,7632,43,155,149,21,24142,136,106,56,70,-93,-49,142,143,143
36,combat2.map,193,177,1007,5,54,187,122,11703,66,155,126,21,-61,101,162,313,163
37,combat2.map,193,177,14808,83,59,109,117,33662,190,144,2,32,-107,85,192,561,193
38,combat2.map,193,177,4379,24,45,168,131,4445,25,156,167,20,-1,111,112,113,113
39,combat2.map,193,177,14566,82,124,110,52,26879,151,24,41,152,-69,-100,169,170,170
40,combat2.map,193,177,12136,68,76,124,100,19235,108,57,84,119,-40,-19,59,60,60
41,combat2.map,193,177,21872,123,75,69,101,32302,182,88,10,88,-59,13,72,99,73
42,combat2.map,193,177,28403,160,93,32,83,10206,57,59,135,117,103,-34,137,138,138
43,combat2.map,193,177,12695,71,48,121,128,22679,128,153,64,23,-57,105,162,163,163
44,combat2.map,193,177,29435,166,123,26,53,8732,49,117,143,59,117,-6,123,124,124
45,combat2.map,193,177,16100,90,6,102,170,25487,143,0,49,176,-53,-6,59,60,60
46,combat2.map,193,177,29146,164,58,28,118,1365,7,50,185,126,157,-8,165,166,166
47,combat2.map,193,177,18344,103,63,89,113,9770,55,141,137,35,48,78,126,127,127
48,combat2.map,193,177,12083,68,129,124,47,13396,75,55,117,121,-7,-74,81,82,82
49,combat2.map,193,177,24464,138,138,54,38,29659,167,76,25,100,-29,-62,91,1705,492
50,combat2.map,193,177,20235,114,119,78,57,11661,65,20,127,156,49,-99,148,149,149
51,combat2.map,193,177,33916,191,67,1,109,24381,137,44,55,132,54,-23,77,78,78
52,combat2.map,193,177,12085,68,127,124,49,33597,189,32,3,144,-121,-95,216,1180,217
53,combat2.map,193,177,7407,41,26,151,150,30967,174,7,18,169,-133,-19,152,153,153
54,combat2.map,193,177,12208,68,4,124,172,22928,129,81,63,95,-61,77,138,139,139
55,combat2.map,193,177,31585,178,97,14,79,28970,163,57,29,119,15,-40,55,178,570
56,combat2.map,193,177,17376,98,146,94,30,20386,115,145,77,31,-17,-1,18,19,19
57,combat2.map,193,177,29201,164,3,28,173,25675,145,166,47,10,19,163,182,2539,3095
58,combat2.map,193,177,19290,108,2,84,174,30132,170,134,22,42,-62,132,194,195,195
59,combat2.map,193,177,11944,67,91,125,85,7466,42,144,150,32,25,53,78,79,79
60,combat2.map,193,177,22052,124,72,68,104,2693,15,138,177,38,109,66,175,176,176
61,combat2.map,193,177,6905,39,174,153,2,10253,57,12,135,164,-18,-162,180,181,181
62,combat2.map,193,177,1113,6,125,186,51,21646,122,124,70,52,-116,-1,117,118,118
63,combat2.map,193,177,18545,104,39,88,137,18745,105,16,87,160,-1,-23,24,25,25
64,combat2.map,193,177,25873,146,145,46,31,22812,128,20,64,156,18,-125,143,144,144
65,combat2.map,193,177,19600,110,46,82,130,10534,59,85,133,91,51,39,90,91,91
66,combat2.map,193,177,8524,48,148,144,28,861,4,23,188,153,44,-125,169,170,258
67,combat2.map,193,177,3288,18,74,174,102,22888,129,121,63,55,-111,47,158,159,159
68,combat2.map,193,177,9518,53,39,139,137,12951,73,146,119,30,-20,107,127,128,128
69,combat2.map,193,177,5218,29,91,163,85,14351,81,162,111,14,-52,71,123,124,124
70,combat2.map,193,177,28824,162,26,30,150,23811,134,83,58,93,28,57,85,86,86
71,combat2.map,193,177,12522,70,44,122,132,23862,134,32,58,144,-64,-12,76,77,77
72,combat2.map,193,177,10123,57,142,135,34,30852,174,122,18,54,-117,-20,137,138,138
73,combat2.map,193,177,14964,84,80,108,96,20935,118,127,74,49,-34,47,81,82,82
74,combat2.map,193,177,27337,154,97,38,79,32386,182,4,10,172,-28,-93,121,122,1606
75,combat2.map,193,177,1267,7,148,185,28,30381,171,62,21,114,-164,-86,250,251,251
76,combat2.map,193,177,33930,191,53,1,123,14662,82,28,110,148,109,-25,134,135,135
77,combat2.map,193,177,18330,103,77,89,99,5606,31,57,161,119,72,-20,92,93,93
78,combat2.map,193,177,25585,144,79,48,97,21170,119,69,73,107,25,-10,35,36,36
79,combat2.map,193,177,32195,181,18,11,158,23438,132,102,60,74,49,84,133,134,1060
80,combat2.map,193,177,32909,185,12,7,164,15806,89,123,103,53,96,111,207,208,208
81,combat2.map,193,177,13849,78,133,114,43,24611,139,168,53,8,-61,35,96,97,97
82,combat2.map,193,177,10000,56,88,136,88,19507,110,139,82,37,-54,51,105,106,106
83,combat2.map,193,177,12609,71,134,121,42,18666,105,95,87,81,-34,-39,73,74,74
84,combat2.map,193,177,22050,124,74,68,102,25915,146,103,46,73,-22,29,51,52,52
85,combat2.map,193,177,2048,11,75,181,101,26940,152,140,40,36,-141,65,206,207,207
86,combat2.map,193,177,25898,146,120,46,56,32317,182,73,10,103,-36,-47,83,84,560
87,combat2.map,193,177,24016,135,55,57,121,3066,17,119,175,57,118,64,182,183,183
88,combat2.map,193,177,23619,133,98,59,78,12907,72,13,120,163,61,-85,146,147,147
89,combat2.map,193,177,1198,6,40,186,136,5711,32,129,160,47,-26,89,115,116,116
90,combat2.map,193,177,13010,73,87,119,89,20306,114,48,78,128,-41,-39,80,81,81
91,combat2.map,193,177,30416,171,27,21,149,26802,151,101,41,75,20,74,94,2393,633
92,combat2.map,193,177,24001,135,70,57,106,10604,59,15,133,161,76,-55,131,132,132
93,combat2.map,193,177,33848,191,135,1,41,2737,15,94,177,82,176,-41,217,218,218
94,combat2.map,193,177,30507,172,113,20,63,21927,123,20,69,156,49,-93,142,143,143
95,combat2.map,193,177,22164,125,137,67,39,21951,124,173,68,3,1,36,37,38,38
96,combat2.map,193,177,1354,7,61,185,115,7859,44,105,148,71,-37,44,81,82,82
97,combat2.map,193,177,2648,14,6,178,170,29434,166,124,26,52,-152,118,270,271,2781
98,combat2.map,193,177,27354,154,80,38,96,8018,45,123,147,53,109,43,152,153,153
99,combat2.map,193,177,18657,105,104,87,72,10890,61,83,131,93,44,-21,65,66,66
0,den000d.map,276,432,46896,108,191,167,240,4634,10,117,265,314,98,-74,172,335,480
1,den000d.map,276,432,22537,52,358,223,73,26566,61,217,214,214,-9,-141,150,151,379
2,den000d.map,276,432,39074,90,237,185,194,77284,178,43,97,388,-88,-194,282,10997,6850
3,den000d.map,276,432,36032,83,255,192,176,13934,32,321,243,110,51,66,117,557,125
4,den000d.map,276,432,90355,209,364,66,67,95973,222,362,53,69,-13,-2,15,16,16
5,den000d.map,276,432,64418,149,381,126,50,45004,104,355,171,76,45,-26,71,72,72
6,den000d.map,276,432,99640,230,151,45,280,70504,163,343,112,88,67,192,259,6393,7266
7,den000d.map,276,432,22340,51,123,224,308,10479,24,320,251,111,27,197,224,6531,12819
8,den000d.map,276,432,89101,206,322,69,109,34079,78,48,197,383,128,-274,402,16514,18222
9,den000d.map,276,432,78461,181,162,94,269,34263,79,296,196,135,102,134,236,1214,1098
10,den000d.map,276,432,73803,170,68,105,363,46004,106,219,169,212,64,151,215,10443,11554
11,den000d.map,276,432,85747,198,220,77,211,21076,48,91,227,340,150,-129,279,4190,6615
12,den000d.map,276,432,76427,176,36,99,395,24925,57,130,218,301,119,94,213,313,214
13,den000d.map,276,432,60363,139,116,136,315,66334,153,193,122,238,-14,77,91,1606,2551
14,den000d.map,276,432,37694,87,321,188,110,16718,38,129,237,302,49,-192,241,13504,11893
15,den000d.map,276,432,18346,42,229,233,202,43835,101,228,174,203,-59,-1,60,61,61
16,den000d.map,276,432,42948,99,251,176,180,103351,239,328,36,103,-140,77,217,876,6203
17,den000d.map,276,432,88880,205,111,70,320,60389,139,90,136,341,66,-21,87,8993,4704
18,den000d.map,276,432,35948,83,339,192,92,59892,138,155,137,276,-55,-184,239,3788,8569
19,den000d.map,276,432,68016,157,239,118,192,94925,219,114,56,317,-62,-125,187,5253,3705
20,den000d.map,276,432,74768,173,399,102,32,112397,260,354,15,77,-87,-45,132,2897,401
21,den000d.map,276,432,68859,159,260,116,171,68207,157,48,118,383,2,-212,214,14453,8740
22,den000d.map,276,432,33194,76,69,199,362,32573,75,258,200,173,1,189,190,7588,10592
23,den000d.map,276,432,79641,184,278,91,153,35645,82,210,193,221,102,-68,170,183,1032
24,den000d.map,276,432,67250,155,141,120,290,48002,111,381,164,50,44,240,284,15769,12477
25,den000d.map,276,432,64563,149,236,126,195,55973,129,186,146,245,20,-50,70,71,71
26,den000d.map,276,432,89619,207,236,68,195,20959,48,208,227,223,159,-28,187,2091,4032
27,den000d.map,276,432,16931,39,348,236,83,47724,110,227,165,204,-71,-121,192,193,699
28,den000d.map,276,432,88316,204,243,71,188,19149,44,290,231,141,160,47,207,2746,3048
29,den000d.map,276,432,72728,168,279,107,152,84187,194,52,81,379,-26,-227,253,13482,7951
30,den000d.map,276,432,61581,142,194,133,237,80998,187,217,88,214,-45,23,68,1268,1922
31,den000d.map,276,432,94953,219,86,56,345,42977,99,222,176,209,120,136,256,6233,2228
32,den000d.map,276,432,99516,230,275,45,156,54292,125,139,150,292,105,-136,241,13225,13166
33,den000d.map,276,432,51475,119,364,156,67,88659,205,332,70,99,-86,-32,118,218,120
34,den000d.map,276,432,35601,82,254,193,177,43612,100,19,175,412,-18,-235,253,15237,10783
35,den000d.map,276,432,99929,231,294,44,137,50796,117,179,158,252,114,-115,229,1012,6827
36,den000d.map,276,432,83128,192,247,83,184,73479,170,392,105,39,22,145,167,3336,4296
37,den000d.map,276,432,88897,205,94,70,337,38437,88,10,187,421,117,-84,201,204,983
38,den000d.map,276,432,49137,113,110,162,321,108539,251,324,24,107,-138,214,352,4269,16467
39,den000d.map,276,432,30100,69,139,206,292,66276,153,251,122,180,-84,112,196,328,2050
40,den000d.map,276,432,36905,85,246,190,185,72453,167,122,108,309,-82,-124,206,839,2074
41,den000d.map,276,432,62459,144,180,131,251,48639,112,176,163,255,32,-4,36,37,37
42,den000d.map,276,432,52616,121,87,154,344,61829,143,378,132,53,-22,291,313,18878,32338
43,den000d.map,276,432,18664,43,343,232,88,62831,145,240,130,191,-102,-103,205,338,436
44,den000d.map,276,432,15827,36,156,239,275,37741,87,274,188,157,-51,118,169,3369,7679
45,den000d.map,276,432,71420,165,291,110,140,78367,181,256,94,175,-16,-35,51,52,70
46,den000d.map,276,432,65888,152,207,123,224,83801,193,6,82,425,-41,-201,242,9894,12752
47,den000d.map,276,432,11338,26,325,249,106,76331,176,132,99,299,-150,-193,343,2258,2785
48,den000d.map,276,432,81874,189,205,86,226,32133,74,266,201,165,115,61,176,456,1512
49,den000d.map,276,432,80632,186,151,89,280,35630,82,225,193,206,104,74,178,4056,1202
50,den000d.map,276,432,27368,63,279,212,152,90479,209,240,66,191,-146,-39,185,2446,2513
51,den000d.map,276,432,77177,178,150,97,281,79755,184,164,91,267,-6,14,20,21,21
52,den000d.map,276,432,76011,175,20,100,411,51255,118,152,157,279,57,132,189,9630,5508
53,den000d.map,276,432,97385,225,246,50,185,60116,139,363,136,68,86,117,203,4330,6963
54,den000d.map,276,432,64393,149,406,126,25,82479,190,32,85,399,-41,-374,415,32597,31252
55,den000d.map,276,432,55241,127,54,148,377,39187,90,124,185,307,37,70,107,18426,9633
56,den000d.map,276,432,54243,125,188,150,243,96598,223,169,52,262,-98,-19,117,5543,2603
57,den000d.map,276,432,24040,55,151,220,280,25261,58,226,217,205,-3,75,78,4602,5715
58,den000d.map,276,432,54186,125,245,150,186,53108,122,27,153,404,3,-218,221,15522,8102
59,den000d.map,276,432,68346,158,341,117,90,42815,99,384,176,47,59,43,102,103,481
60,den000d.map,276,432,72537,167,38,108,393,78594,181,29,94,402,-14,-9,23,24,24
61,den000d.map,276,432,35608,82,247,193,184,77445,179,314,96,117,-97,67,164,12076,4609
62,den000d.map,276,432,94443,218,164,57,267,16039,37,376,238,55,181,212,393,2485,4495
63,den000d.map,276,432,10668,24,131,251,300,53207,123,360,152,71,-99,229,328,16123,19096
64,den000d.map,276,432,69664,161,319,114,112,14140,32,115,243,316,129,-204,333,13646,19160
65,den000d.map,276,432,27144,62,71,213,360,93005,215,306,60,125,-153,235,388,840,2658
66,den000d.map,276,432,45562,105,229,170,202,65750,152,345,123,86,-47,116,163,15932,8883
67,den000d.map,276,432,41201,95,270,180,161,45380,105,411,170,20,-10,141,151,2165,5984
68,den000d.map,276,432,71780,166,363,109,68,108535,251,328,24,103,-85,-35,120,121,121
69,den000d.map,276,432,61396,142,379,133,52,28574,66,369,209,62,76,-10,86,87,87
70,den000d.map,276,432,59603,137,12,138,419,38830,89,49,186,382,48,37,85,86,86
71,den000d.map,276,432,79121,183,366,92,65,72526,167,49,108,382,16,-317,333,27444,18961
72,den000d.map,276,432,18016,41,127,234,304,56003,129,156,146,275,-88,29,117,2222,429
73,den000d.map,276,432,13035,30,356,245,75,46679,108,408,167,23,-78,52,130,447,3376
74,den000d.map,276,432,59819,138,228,137,203,93621,216,122,59,309,-78,-106,184,2175,2481
75,den000d.map,276,432,79264,183,223,92,208,28149,65,362,210,69,118,139,257,5523,5273
76,den000d.map,276,432,48705,112,110,163,321,47489,109,30,166,401,3,-80,83,9226,18643
77,den000d.map,276,432,33448,77,247,198,184,31602,73,365,202,66,4,118,122,1266,1289
78,den000d.map,276,432,43476,100,155,175,276,49653,114,26,161,405,-14,-129,143,2328,5981
79,den000d.map,276,432,85163,197,372,78,59,105535,244,304,31,127,-47,-68,115,162,165
80,den000d.map,276,432,49488,114,191,161,240,20211,46,92,229,339,68,-99,167,510,331
81,den000d.map,276,432,96872,224,327,51,104,62383,144,256,131,175,80,-71,151,1246,394
82,den000d.map,276,432,18331,42,244,233,187,58567,135,184,140,247,-93,-60,153,2071,667
83,den000d.map,276,432,41416,95,55,180,376,31612,73,355,202,76,22,300,322,14312,22695
84,den000d.map,276,432,56497,130,94,145,337,103350,239,329,36,102,-109,235,344,3351,15101
85,den000d.map,276,432,75690,175,341,100,90,83132,192,243,83,188,-17,-98,115,2472,3190
86,den000d.map,276,432,45843,106,380,169,51,35693,82,162,193,269,24,-218,242,17131,10846
87,den000d.map,276,432,62378,144,261,131,170,87837,203,290,72,141,-59,29,88,155,1110
88,den000d.map,276,432,45451,105,340,170,91,13495,31,328,244,103,74,-12,86,87,164
89,den000d.map,276,432,68757,159,362,116,69,50447,116,96,159,335,43,-266,309,30339,17019
90,den000d.map,276,432,35944,83,343,192,88,43163,99,36,176,395,-16,-307,323,24672,18032
91,den000d.map,276,432,82064,189,15,86,416,32030,74,369,201,62,115,354,469,20210,23628
92,den000d.map,276,432,18411,42,164,233,267,66174,153,353,122,78,-111,189,300,17955,28309
93,den000d.map,276,432,55976,129,183,146,248,87909,203,218,72,213,-74,35,109,1981,1993
94,den000d.map,276,432,56627,131,396,144,35,102462,237,353,38,78,-106,-43,149,150,150
95,den000d.map,276,432,51809,119,30,156,401,88866,205,125,70,306,-86,95,181,183,316
96,den000d.map,276,432,102880,238,367,37,64,59612,137,3,138,428,101,-364,465,31979,12693
97,den000d.map,276,432,44819,103,108,172,323,73247,169,192,106,239,-66,84,150,4150,4389
98,den000d.map,276,432,58739,135,12,140,419,87189,201,74,74,357,-66,62,128,6183,341
99,den000d.map,276,432,87086,201,177,74,254,34206,79,353,196,78,122,176,298,13049,10548
0,den001d.map,75,205,8523,41,86,33,118,13443,65,86,9,118,-24,0,24,1167,883
1,den001d.map,75,205,6077,29,72,45,132,5839,28,105,46,99,1,33,34,35,35
2,den001d.map,75,205,8112,39,87,35,117,5468,26,66,48,138,13,-21,34,42,35
3,den001d.map,75,205,3723,18,171,56,33,8117,39,82,35,122,-21,-89,110,111,897
4,den001d.map,75,205,8622,42,192,32,12,5047,24,77,50,127,18,-115,133,3795,422
5,den001d.map,75,205,12591,61,118,13,86,13423,65,106,9,98,-4,-12,16,17,21
6,den001d.map,75,205,10826,52,38,22,166,6446,31,113,43,91,21,75,96,97,97
7,den001d.map,75,205,5297,25,32,49,172,6863,33,106,41,98,-8,74,82,83,246
8,den001d.map,75,205,11961,58,133,16,71,8373,40,31,34,173,18,-102,120,121,121
9,den001d.map,75,205,2363,11,96,63,108,4093,19,6,55,198,-8,-90,98,428,205
10,den001d.map,75,205,8552,41,57,33,147,9951,48,93,26,111,-7,36,43,44,44
11,den001d.map,75,205,1144,5,85,69,119,8076,39,123,35,81,-34,38,72,98,73
12,den001d.map,75,205,5026,24,98,50,106,14460,70,94,4,110,-46,-4,50,1435,3462
13,den001d.map,75,205,9832,47,7,27,197,508,2,106,72,98,45,99,144,194,251
14,den001d.map,75,205,6240,30,114,44,90,13641,66,93,8,111,-36,-21,57,549,74
15,den001d.map,75,205,5808,28,136,46,68,1336,6,98,68,106,22,-38,60,75,93
16,den001d.map,75,205,6260,30,94,44,110,7231,35,148,39,56,-5,54,59,60,60
17,den001d.map,75,205,4691,22,23,52,181,10133,49,116,25,88,-27,93,120,121,440
18,den001d.map,75,205,5604,27,135,47,69,9308,45,121,29,83,-18,-14,32,33,33
19,den001d.map,75,205,11177,54,97,20,107,5221,25,108,49,96,29,11,40,457,2505
20,den001d.map,75,205,2401,11,58,63,146,9361,45,68,29,136,-34,10,44,709,971
21,den001d.map,75,205,7856,38,138,36,66,9559,46,75,28,129,-8,-63,71,72,72
22,den001d.map,75,205,8054,39,145,35,59,10126,49,123,25,81,-10,-22,32,33,33
23,den001d.map,75,205,6127,29,22,45,182,11791,57,98,17,106,-28,76,104,2544,545
24,den001d.map,75,205,7462,36,122,38,82,4639,22,75,52,129,14,-47,61,1642,353
25,den001d.map,75,205,10289,50,165,24,39,7315,35,64,39,140,15,-101,116,117,117
26,den001d.map,75,205,11065,53,4,21,200,9351,45,78,29,126,8,74,82,85,83
27,den001d.map,75,205,564,2,50,72,154,9830,47,9,27,195,-45,-41,86,161,121
28,den001d.map,75,205,6291,30,63,44,141,10883,53,186,21,18,-23,123,146,157,274
29,den001d.map,75,205,2177,10,77,64,127,9615,46,19,28,185,-36,-58,94,121,99
30,den001d.map,75,205,4642,22,72,52,132,4525,22,189,52,15,0,117,117,1683,3043
31,den001d.map,75,205,8133,39,66,35,138,2591,12,73,62,131,27,7,34,1254,945
32,den001d.map,75,205,14043,68,101,6,103,6661,32,103,42,101,36,2,38,251,612
33,den001d.map,75,205,9548,46,86,28,118,4462,21,47,53,157,25,-39,64,3884,1151
34,den001d.map,75,205,2419,11,40,63,164,6741,32,23,42,181,-21,-17,38,41,41
35,den001d.map,75,205,8513,41,96,33,108,518,2,96,72,108,39,0,39,869,586
36,den001d.map,75,205,8074,39,125,35,79,10550,51,109,23,95,-12,-16,28,29,29
37,den001d.map,75,205,8720,42,94,32,110,13870,67,69,7,135,-25,-25,50,1373,1066
38,den001d.map,75,205,1762,8,82,66,122,782,3,37,71,167,5,-45,50,51,51
39,den001d.map,75,205,8425,41,184,33,20,13620,66,114,8,90,-25,-70,95,96,96
40,den001d.map,75,205,11257,54,17,20,187,8535,41,74,33,130,13,57,70,71,71
41,den001d.map,75,205,8572,41,37,33,167,7524,36,60,38,144,5,23,28,29,29
42,den001d.map,75,205,14452,70,102,4,102,4476,21,33,53,171,49,-69,118,495,1378
43,den001d.map,75,205,10013,48,31,26,173,4703,22,11,52,193,26,-20,46,59,47
44,den001d.map,75,205,9770,47,69,27,135,8547,41,62,33,142,6,-7,13,14,14
45,den001d.map,75,205,13613,66,121,8,83,8039,39,160,35,44,27,39,66,77,470
46,den001d.map,75,205,7523,36,61,38,143,6742,32,22,42,182,4,-39,43,44,44
47,den001d.map,75,205,14450,70,104,4,100,1339,6,95,68,109,64,-9,73,470,815
48,den001d.map,75,205,1812,8,32,66,172,8086,39,113,35,91,-31,81,112,712,370
49,den001d.map,75,205,4946,24,178,50,26,500,2,114,72,90,22,-64,86,518,846
50,den001d.map,75,205,5760,28,184,46,20,13820,67,119,7,85,-39,-65,104,105,330
51,den001d.map,75,205,7984,38,10,36,194,2959,14,115,60,89,24,105,129,583,130
52,den001d.map,75,205,5104,24,20,50,184,6604,32,160,42,44,-8,140,148,977,597
53,den001d.map,75,205,13426,65,103,9,101,6226,30,128,44,76,35,25,60,68,352
54,den001d.map,75,205,4456,21,53,53,151,3774,18,120,56,84,3,67,70,491,426
55,den001d.map,75,205,7395,36,189,38,15,7047,34,127,40,77,2,-62,64,101,65
56,den001d.map,75,205,9193,44,31,30,173,5399,26,135,48,69,18,104,122,226,123
57,den001d.map,75,205,1562,7,77,67,127,1371,6,63,68,141,1,-14,15,16,16
58,den001d.map,75,205,1971,9,78,65,126,13660,66,74,8,130,-57,-4,61,1860,1183
59,den001d.map,75,205,6056,29,93,45,111,4279,20,25,54,179,9,-68,77,164,258
60,den001d.map,75,205,13084,63,35,11,169,10847,52,17,22,187,11,-18,29,44,30
61,den001d.map,75,205,14296,69,53,5,151,9509,46,125,28,79,23,72,95,409,381
62,den001d.map,75,205,11051,53,18,21,186,8071,39,128,35,76,14,110,124,126,157
63,den001d.map,75,205,5625,27,114,47,90,15101,73,68,1,136,-46,-46,92,1222,393
64,den001d.map,75,205,11616,56,68,18,136,1811,8,33,66,171,48,-35,83,350,2150
65,den001d.map,75,205,7768,37,21,37,183,3802,18,92,56,112,19,71,90,1766,526
66,den001d.map,75,205,5496,26,38,48,166,8215,40,189,34,15,-14,151,165,166,682
67,den001d.map,75,205,11248,54,26,20,178,4298,20,6,54,198,34,-20,54,55,55
68,den001d.map,75,205,2360,11,99,63,105,13472,65,57,9,147,-54,-42,96,2603,1107
69,den001d.map,75,205,8852,43,167,31,37,4845,23,74,51,130,20,-93,113,3076,425
70,den001d.map,75,205,4648,22,66,52,138,11635,56,49,18,155,-34,-17,51,3438,2627
71,den001d.map,75,205,4947,24,177,50,27,9309,45,120,29,84,-21,-57,78,79,318
72,den001d.map,75,205,1563,7,76,67,128,14468,70,86,4,118,-63,10,73,1929,1187
73,den001d.map,75,205,6856,33,113,41,91,12014,58,80,16,124,-25,-33,58,1321,305
74,den001d.map,75,205,11713,57,176,17,28,10956,53,113,21,91,4,-63,67,447,681
75,den001d.map,75,205,5033,24,91,50,113,7045,34,129,40,75,-10,38,48,262,1905
76,den001d.map,75,205,10224,49,25,25,179,11161,54,113,20,91,-5,88,93,288,276
77,den001d.map,75,205,7253,35,126,39,78,11975,58,119,16,85,-23,-7,30,31,31
78,den001d.map,75,205,10014,48,30,26,174,7967,38,27,36,177,10,-3,13,14,14
79,den001d.map,75,205,3603,17,86,57,118,7220,35,159,39,45,-18,73,91,284,1484
80,den001d.map,75,205,6941,33,28,41,176,4583,22,131,52,73,11,103,114,294,115
81,den001d.map,75,205,7273,35,106,39,98,8142,39,57,35,147,-4,-49,53,54,54
82,den001d.map,75,205,7241,35,138,39,66,14037,68,107,6,97,-33,-31,64,212,68
83,den001d.map,75,205,13696,66,38,8,166,15055,73,114,1,90,-7,76,83,84,84
84,den001d.map,75,205,7673,37,116,37,88,4741,23,178,51,26,14,62,76,384,77
85,den001d.map,75,205,7097,34,77,40,127,8730,42,84,32,120,-8,7,15,16,16
86,den001d.map,75,205,8705,42,109,32,95,8431,41,178,33,26,1,69,70,71,71
87,den001d.map,75,205,14665,71,94,3,110,11917,58,177,16,27,13,83,96,1267,769
88,den001d.map,75,205,9008,43,11,31,193,4194,20,110,54,94,23,99,122,489,123
89,den001d.map,75,205,7656,37,133,37,71,4836,23,83,51,121,14,-50,64,1891,305
90,den001d.map,75,205,1163,5,66,69,138,13479,65,50,9,154,-60,-16,76,854,508
91,den001d.map,75,205,9108,44,116,30,88,10797,52,67,22,137,-8,-49,57,1492,444
92,den001d.map,75,205,14642,71,117,3,87,2196,10,58,64,146,61,-59,120,121,121
93,den001d.map,75,205,1339,6,95,68,109,6299,30,55,44,149,-24,-40,64,1121,1139
94,den001d.map,75,205,12417,60,87,14,117,4011,19,88,55,116,41,1,42,2473,2169
95,den001d.map,75,205,10432,50,22,24,182,6419,31,140,43,64,19,118,137,138,138
96,den001d.map,75,205,9264,45,165,29,39,6363,31,196,43,8,14,31,45,79,46
97,den001d.map,75,205,13459,65,70,9,134,7676,37,113,37,91,28,43,71,348,737
98,den001d.map,75,205,7290,35,89,39,115,11350,55,129,19,75,-20,40,60,61,61
99,den001d.map,75,205,2382,11,77,63,127,7182,35,197,39,7,-24,120,144,164,1621
0,den005d.map,328,237,61672,260,184,67,52,19204,81,229,246,7,179,45,224,1170,1066
1,den005d.map,328,237,20409,86,209,241,27,70786,298,76,29,160,-212,-133,345,14041,9343
2,den005d.map,328,237,65152,274,22,53,214,20220,85,161,242,75,189,139,328,12119,9164
3,den005d.map,328,237,17369,73,168,254,68,67053,282,17,45,219,-209,-151,360,7899,11443
4,den005d.map,328,237,72226,304,58,23,178,74581,314,73,13,163,-10,15,25,26,26
5,den005d.map,328,237,54316,229,193,98,43,60708,256,200,71,36,-27,7,34,35,35
6,den005d.map,328,237,60772,256,136,71,100,5039,21,174,306,62,235,38,273,8881,6791
7,den005d.map,328,237,73411,309,58,18,178,59700,251,23,76,213,58,-35,93,726,1222
8,den005d.map,328,237,74638,314,16,13,220,57575,242,15,85,221,72,-1,73,74,112
9,den005d.map,328,237,63426,267,89,60,147,63396,267,119,60,117,0,30,30,75,47
10,den005d.map,328,237,19707,83,200,244,36,17364,73,173,254,63,10,-27,37,423,284
11,den005d.map,328,237,64442,271,21,56,215,70798,298,64,29,172,-27,43,70,646,656
12,den005d.map,328,237,24448,103,199,224,37,75121,316,7,11,229,-213,-192,405,6515,4543
13,den005d.map,328,237,5960,25,201,302,35,9049,38,193,289,43,-13,-8,21,22,22
14,den005d.map,328,237,76010,320,66,7,170,70261,296,127,31,109,24,61,85,4581,5592
15,den005d.map,328,237,57936,244,128,83,108,42513,179,146,148,90,65,18,83,4609,3012
16,den005d.map,328,237,40802,172,198,155,38,69770,294,144,33,92,-122,-54,176,3484,2869
17,den005d.map,328,237,38953,164,151,163,85,27313,115,178,212,58,49,27,76,532,546
18,den005d.map,328,237,62154,262,176,65,60,63828,269,161,58,75,-7,-15,22,23,35
19,den005d.map,328,237,61826,260,30,67,206,59422,250,64,77,172,10,34,44,45,45
20,den005d.map,328,237,65843,277,42,50,194,71542,301,31,26,205,-24,-11,35,1054,1750
21,den005d.map,328,237,41296,174,178,153,58,22840,96,148,231,88,78,-30,108,3478,1369
22,den005d.map,328,237,61098,257,47,70,189,25148,106,210,221,26,151,163,314,4052,3663
23,den005d.map,328,237,3641,15,150,312,86,64385,271,78,56,158,-256,-72,328,4523,7664
24,den005d.map,328,237,12393,52,167,275,69,30874,130,172,197,64,-78,5,83,1542,889
25,den005d.map,328,237,8136,34,158,293,78,41779,176,169,151,67,-142,11,153,2920,2170
26,den005d.map,328,237,26118,110,188,217,48,61519,259,100,68,136,-149,-88,237,2785,1219
27,den005d.map,328,237,55276,233,181,94,55,73630,310,76,17,160,-77,-105,182,8375,4220
28,den005d.map,328,237,61768,260,88,67,148,72958,307,37,20,199,-47,-51,98,2162,2388
29,den005d.map,328,237,58573,247,202,80,34,71735,302,75,25,161,-55,-127,182,7852,4056
30,den005d.map,328,237,74394,313,23,14,213,17382,73,155,254,81,240,132,372,12117,10881
31,den005d.map,328,237,71506,301,67,26,169,25884,109,185,218,51,192,118,310,4642,12669
32,den005d.map,328,237,1923,8,209,319,27,75111,316,17,11,219,-308,-192,500,10046,14091
33,den005d.map,328,237,6954,29,155,298,81,63820,269,169,58,67,-240,14,254,3684,4996
34,den005d.map,328,237,64897,273,40,54,196,65157,274,17,53,219,-1,-23,24,446,609
35,den005d.map,328,237,73322,309,147,18,89,72684,306,74,21,162,3,-73,76,5858,3314
36,den005d.map,328,237,40372,170,154,157,82,47446,200,190,127,46,-30,36,66,271,575
37,den005d.map,328,237,14746,62,184,265,52,34894,147,181,180,55,-85,-3,88,401,897
38,den005d.map,328,237,41027,173,210,154,26,66590,280,6,47,230,-107,-204,311,4013,5149
39,den005d.map,328,237,53853,227,182,100,54,6941,29,168,298,68,198,-14,212,4533,2170
40,den005d.map,328,237,17395,73,142,254,94,60167,253,30,74,206,-180,-112,292,6571,11437
41,den005d.map,328,237,18327,77,158,250,78,61103,257,42,70,194,-180,-116,296,5615,9592
42,den005d.map,328,237,60776,256,132,71,104,71236,300,100,27,136,-44,-32,76,7081,3345
43,den005d.map,328,237,18584,78,138,249,98,74266,313,151,14,85,-235,13,248,7910,8590
44,den005d.map,328,237,72240,304,44,23,192,5247,22,203,305,33,282,159,441,14057,13854
45,den005d.map,328,237,20208,85,173,242,63,74823,315,68,12,168,-230,-105,335,14472,11625
46,den005d.map,328,237,64188,270,38,57,198,15461,65,180,262,56,205,142,347,6091,6396
47,den005d.map,328,237,5010,21,203,306,33,58285,245,16,82,220,-224,-187,411,9536,12060
48,den005d.map,328,237,21888,92,152,235,84,69875,294,39,33,197,-202,-113,315,13805,13194
49,den005d.map,328,237,19234,81,199,246,37,50294,212,186,115,50,-131,-13,144,574,641
50,den005d.map,328,237,40841,172,159,155,77,30854,130,192,197,44,42,33,75,233,179
51,den005d.map,328,237,29915,126,183,201,53,62430,263,137,64,99,-137,-46,183,1384,391
52,den005d.map,328,237,63593,268,159,59,77,74580,314,74,13,162,-46,-85,131,6482,2805
53,den005d.map,328,237,57721,243,106,84,130,4346,18,156,309,80,225,50,275,6998,8434
54,den005d.map,328,237,38236,161,157,166,79,24671,104,213,223,23,57,56,113,336,1323
55,den005d.map,328,237,73149,308,83,19,153,54847,231,136,96,100,77,53,130,3695,6091
56,den005d.map,328,237,61428,259,191,68,45,20868,88,224,239,12,171,33,204,1163,1693
57,den005d.map,328,237,62208,262,122,65,114,44141,186,177,141,59,76,55,131,1232,782
58,den005d.map,328,237,54330,229,179,98,57,22052,93,225,234,11,136,46,182,350,414
59,den005d.map,328,237,59304,250,182,77,54,59144,249,105,78,131,1,-77,78,741,617
60,den005d.map,328,237,65749,277,136,50,100,73934,311,9,16,227,-34,-127,161,2673,3064
61,den005d.map,328,237,58830,248,182,79,54,60422,254,12,73,224,-6,-170,176,751,1858
62,den005d.map,328,237,32297,136,171,191,65,19494,82,176,245,60,54,5,59,1310,1028
63,den005d.map,328,237,27552,116,176,211,60,38942,164,162,163,74,-48,-14,62,532,418
64,den005d.map,328,237,66976,282,94,45,142,55566,234,128,93,108,48,34,82,4332,7827
65,den005d.map,328,237,61538,259,81,68,155,1275,5,146,322,90,254,65,319,7821,5996
66,den005d.map,328,237,24905,105,216,222,20,63254,266,24,61,212,-161,-192,353,7518,2631
67,den005d.map,328,237,68410,288,82,39,154,23718,100,218,227,18,188,136,324,4756,15600
68,den005d.map,328,237,71521,301,52,26,184,57404,242,186,85,50,59,134,193,4126,7073
69,den005d.map,328,237,73688,310,18,17,218,8335,35,196,292,40,275,178,453,14290,10346
70,den005d.map,328,237,7904,33,153,294,83,49822,210,184,117,52,-177,31,208,2147,3052
71,den005d.map,328,237,44377,187,178,140,58,42267,178,155,149,81,9,-23,32,226,268
72,den005d.map,328,237,63361,267,154,60,82,17557,74,217,253,19,193,63,256,3447,1528
73,den005d.map,328,237,67305,283,2,44,234,63198,266,80,61,156,17,78,95,806,368
74,den005d.map,328,237,39420,166,158,161,78,47925,202,185,125,51,-36,27,63,64,74
75,den005d.map,328,237,64802,273,135,54,101,44821,189,208,138,28,84,73,157,801,585
76,den005d.map,328,237,35835,151,188,176,48,16166,68,186,259,50,83,-2,85,799,743
77,den005d.map,328,237,23025,97,200,230,36,10458,44,206,283,30,53,6,59,3464,1143
78,den005d.map,328,237,60257,254,177,73,59,26330,111,213,216,23,143,36,179,2864,740
79,den005d.map,328,237,47723,201,150,126,86,62044,261,49,66,187,-60,-101,161,2019,4247
80,den005d.map,328,237,63944,269,45,58,191,60174,253,23,74,213,16,-22,38,39,39
81,den005d.map,328,237,13827,58,155,269,81,38477,162,153,165,83,-104,-2,106,3425,2248
82,den005d.map,328,237,40330,170,196,157,40,66461,280,135,47,101,-110,-61,171,1108,1991
83,den005d.map,328,237,59517,251,206,76,30,13559,57,186,270,50,194,-20,214,2450,2178
84,den005d.map,328,237,9784,41,169,286,67,65241,275,170,52,66,-234,1,235,4627,6781
85,den005d.map,328,237,54154,228,118,99,118,70583,297,42,30,194,-69,-76,145,5442,4913
86,den005d.map,328,237,24707,104,177,223,59,12159,51,164,276,72,53,-13,66,395,1326
87,den005d.map,328,237,67883,286,135,41,101,46525,196,163,131,73,90,28,118,2271,797
88,den005d.map,328,237,61826,260,30,67,206,72572,306,186,21,50,-46,156,202,767,1594
89,den005d.map,328,237,24034,101,139,226,97,47926,202,184,125,52,-101,45,146,1297,4913
90,den005d.map,328,237,70713,298,149,29,87,66347,279,12,48,224,19,-137,156,1872,3079
91,den005d.map,328,237,48620,205,201,122,35,2933,12,147,315,89,193,-54,247,3129,3849
92,den005d.map,328,237,72660,306,98,21,138,60893,256,15,71,221,50,-83,133,757,1268
93,den005d.map,328,237,61112,257,33,70,203,50056,211,187,116,49,46,154,200,1999,1195
94,den005d.map,328,237,16170,68,182,259,54,19042,80,154,247,82,-12,-28,40,59,217
95,den005d.map,328,237,9769,41,184,286,52,54851,231,132,96,104,-190,-52,242,8691,8715
96,den005d.map,328,237,70248,296,140,31,96,45102,190,164,137,72,106,24,130,2582,1863
97,den005d.map,328,237,8345,35,186,292,50,64862,273,75,54,161,-238,-111,349,4958,9961
98,den005d.map,328,237,62043,261,50,66,186,49875,210,131,117,105,51,81,132,1209,1386
99,den005d.map,328,237,70362,296,26,31,210,67303,283,4,44,232,13,-22,35,43,62
0,den009d.map,31,46,1264,27,23,3,22,1124,24,25,6,20,3,2,5,6,6
1,den009d.map,31,46,153,3,30,27,15,845,18,28,12,17,-15,-2,17,18,18
2,den009d.map,31,46,285,6,36,24,9,190,4,39,26,6,2,3,5,6,6
3,den009d.map,31,46,1106,24,43,6,2,1196,26,45,4,0,-2,2,4,5,5
4,den009d.map,31,46,144,3,39,27,6,1310,28,23,2,22,-25,-16,41,49,42
5,den009d.map,31,46,1008,21,3,9,42,1201,26,40,4,5,-5,37,42,90,133
6,den009d.map,31,46,234,5,41,25,4,1397,30,28,0,17,-25,-13,38,39,39
7,den009d.map,31,46,1090,23,13,7,32,590,12,7,18,38,11,-6,17,18,23
8,den009d.map,31,46,204,4,25,26,20,1340,29,39,1,6,-25,14,39,40,40
9,den009d.map,31,46,1396,30,29,0,16,110,2,27,28,18,28,-2,30,31,31
10,den009d.map,31,46,640,13,3,17,42,882,19,37,11,8,-6,34,40,265,426
11,den009d.map,31,46,273,5,2,25,43,106,2,31,28,14,3,29,32,375,486
12,den009d.map,31,46,1098,23,5,7,40,307,6,14,24,31,17,9,26,27,27
13,den009d.map,31,46,512,11,39,19,6,817,17,10,13,35,-6,-29,35,513,287
14,den009d.map,31,46,468,10,37,20,8,334,7,33,23,12,3,-4,7,8,8
15,den009d.map,31,46,266,5,9,25,36,301,6,20,24,25,-1,11,12,13,13
16,den009d.map,31,46,732,15,3,15,42,1277,27,10,3,35,-12,7,19,20,20
17,den009d.map,31,46,1370,29,9,1,36,163,3,20,27,25,26,11,37,56,38
18,den009d.map,31,46,130,2,7,28,38,286,6,35,24,10,-4,28,32,365,531
19,den009d.map,31,46,283,6,38,24,7,1222,26,19,4,26,-20,-19,39,325,42
20,den009d.map,31,46,214,4,15,26,30,311,6,10,24,35,-2,-5,7,8,8
21,den009d.map,31,46,422,9,37,21,8,510,11,41,19,4,-2,4,6,7,7
22,den009d.map,31,46,744,16,37,14,8,869,18,4,12,41,-2,-33,35,374,235
23,den009d.map,31,46,939,20,26,10,19,775,16,6,14,39,4,-20,24,159,184
24,den009d.map,31,46,177,3,6,27,39,1234,26,7,4,38,-23,1,24,25,25
25,den009d.map,31,46,1395,30,30,0,15,166,3,17,27,28,27,-13,40,463,111
26,den009d.map,31,46,694,15,41,15,4,1279,27,8,3,37,-12,-33,45,46,109
27,den009d.map,31,46,1001,21,10,9,35,681,14,8,16,37,7,-2,9,10,10
28,den009d.map,31,46,195,4,34,26,11,325,7,42,23,3,-3,8,11,12,12
29,den009d.map,31,46,169,3,14,27,31,605,13,38,17,7,-10,24,34,340,664
30,den009d.map,31,46,1244,27,43,3,2,740,16,41,14,4,11,-2,13,14,14
31,den009d.map,31,46,229,4,0,26,45,102,2,35,28,10,2,35,37,379,536
32,den009d.map,31,46,890,19,29,11,16,292,6,29,24,16,13,0,13,14,14
33,den009d.map,31,46,659,14,30,16,15,1372,29,7,1,38,-15,-23,38,39,118
34,den009d.map,31,46,107,2,30,28,15,405,8,8,22,37,-6,-22,28,462,358
35,den009d.map,31,46,224,4,5,26,40,60,1,31,29,14,3,26,29,373,484
36,den009d.map,31,46,1106,24,43,6,2,333,7,34,23,11,17,-9,26,27,27
37,den009d.map,31,46,819,17,8,13,37,151,3,32,27,13,14,24,38,359,438
38,den009d.map,31,46,745,16,36,14,9,1367,29,12,1,33,-13,-24,37,38,52
39,den009d.map,31,46,616,13,27,17,18,467,10,38,20,7,3,11,14,15,15
40,den009d.map,31,46,1067,23,36,7,9,1150,25,45,5,0,-2,9,11,12,12
41,den009d.map,31,46,286,6,35,24,10,335,7,32,23,13,-1,-3,4,5,5
42,den009d.map,31,46,1249,27,38,3,7,531,11,20,19,25,16,-18,34,35,35
43,den009d.map,31,46,258,5,17,25,28,750,16,31,14,14,-11,14,25,324,639
44,den009d.map,31,46,315,6,6,24,39,1164,25,31,5,14,-19,25,44,207,255
45,den009d.map,31,46,746,16,35,14,10,707,15,28,15,17,1,-7,8,9,9
46,den009d.map,31,46,1155,25,40,5,5,374,8,39,22,6,17,-1,18,19,19
47,den009d.map,31,46,117,2,20,28,25,935,20,30,10,15,-18,10,28,275,660
48,den009d.map,31,46,250,5,25,25,20,1251,27,36,3,9,-22,11,33,34,34
49,den009d.map,31,46,97,2,40,28,5,1019,22,38,8,7,-20,-2,22,23,23
50,den009d.map,31,46,1372,29,7,1,38,1349,29,30,1,15,0,23,23,26,26
51,den009d.map,31,46,1322,28,11,2,34,1188,25,7,5,38,3,-4,7,8,8
52,den009d.map,31,46,171,3,12,27,33,1214,26,27,4,18,-23,15,38,131,220
53,den009d.map,31,46,1065,23,38,7,7,603,13,40,17,5,10,2,12,13,13
54,den009d.map,31,46,226,4,3,26,42,244,5,31,25,14,-1,28,29,372,486
55,den009d.map,31,46,728,15,7,15,38,824,17,3,13,42,-2,-4,6,7,7
56,den009d.map,31,46,913,19,6,11,39,1026,22,31,8,14,-3,25,28,131,146
57,den009d.map,31,46,105,2,32,28,13,388,8,25,22,20,-6,-7,13,14,14
58,den009d.map,31,46,528,11,23,19,22,886,19,33,11,12,-8,10,18,19,19
59,den009d.map,31,46,1115,24,34,6,11,708,15,27,15,18,9,-7,16,17,17
60,den009d.map,31,46,121,2,16,28,29,379,8,34,22,11,-6,18,24,341,656
61,den009d.map,31,46,932,20,33,10,12,365,7,2,23,43,13,-31,44,419,358
62,den009d.map,31,46,754,16,27,14,18,915,19,4,11,41,-3,-23,26,177,214
63,den009d.map,31,46,337,7,30,23,15,870,18,3,12,42,-11,-27,38,355,369
64,den009d.map,31,46,816,17,11,13,34,95,2,42,28,3,15,31,46,337,547
65,den009d.map,31,46,1314,28,19,2,26,755,16,26,14,19,12,7,19,22,20
66,den009d.map,31,46,1400,30,25,0,20,541,11,10,19,35,19,-15,34,65,44
67,den009d.map,31,46,701,15,34,15,11,1095,23,8,7,37,-8,-26,34,219,137
68,den009d.map,31,46,474,10,31,20,14,1003,21,8,9,37,-11,-23,34,281,248
69,den009d.map,31,46,1410,30,15,0,30,274,5,1,25,44,25,-14,39,40,69
70,den009d.map,31,46,1370,29,9,1,36,684,14,5,16,40,15,-4,19,20,20
71,den009d.map,31,46,416,9,43,21,2,1270,27,17,3,28,-18,-26,44,65,49
72,den009d.map,31,46,867,18,6,12,39,111,2,26,28,19,16,20,36,364,268
73,den009d.map,31,46,137,2,0,28,45,362,7,5,23,40,-5,5,10,11,11
74,den009d.map,31,46,1275,27,12,3,33,702,15,33,15,12,12,21,33,48,34
75,den009d.map,31,46,1046,22,11,8,34,375,8,38,22,7,14,27,41,191,437
76,den009d.map,31,46,862,18,11,12,34,1006,21,5,9,40,-3,-6,9,10,10
77,den009d.map,31,46,691,15,44,15,1,237,5,38,25,7,10,-6,16,17,17
78,den009d.map,31,46,635,13,8,17,37,109,2,28,28,17,11,20,31,356,398
79,den009d.map,31,46,1069,23,34,7,11,686,14,3,16,42,9,-31,40,261,193
80,den009d.map,31,46,544,11,7,19,38,566,12,31,18,14,-1,24,25,352,436
81,den009d.map,31,46,264,5,11,25,34,361,7,6,23,39,-2,-5,7,8,8
82,den009d.map,31,46,564,12,33,18,12,981,21,30,9,15,-9,-3,12,13,13
83,den009d.map,31,46,509,11,42,19,3,319,6,2,24,43,5,-40,45,567,377
84,den009d.map,31,46,1170,25,25,5,20,83,1,8,29,37,24,-17,41,134,210
85,den009d.map,31,46,1316,28,17,2,28,845,18,28,12,17,10,11,21,26,22
86,den009d.map,31,46,616,13,27,17,18,1354,29,25,1,20,-16,-2,18,19,19
87,den009d.map,31,46,960,20,5,10,40,331,7,36,23,9,13,31,44,362,470
88,den009d.map,31,46,560,12,37,18,8,1015,22,42,8,3,-10,5,15,16,16
89,den009d.map,31,46,1025,22,32,8,13,653,14,36,16,9,8,4,12,13,13
90,den009d.map,31,46,1145,24,4,6,41,212,4,17,26,28,20,13,33,34,34
91,den009d.map,31,46,337,7,30,23,15,502,10,3,20,42,-3,-27,30,456,369
92,den009d.map,31,46,73,1,18,29,27,278,6,43,24,2,-5,25,30,352,684
93,den009d.map,31,46,243,5,32,25,13,1310,28,23,2,22,-23,-9,32,40,33
94,den009d.map,31,46,693,15,42,15,3,342,7,25,23,20,8,-17,25,26,26
95,den009d.map,31,46,816,17,11,13,34,753,16,28,14,17,1,17,18,151,218
96,den009d.map,31,46,222,4,7,26,38,1359,29,20,1,25,-25,13,38,85,39
97,den009d.map,31,46,327,7,40,23,5,255,5,20,25,25,2,-20,22,682,348
98,den009d.map,31,46,1170,25,25,5,20,431,9,28,21,17,16,3,19,20,20
99,den009d.map,31,46,1318,28,15,2,30,310,6,11,24,34,22,-4,26,42,46
0,den011d.map,165,245,2394,9,55,155,189,25486,104,238,60,6,-95,183,278,5026,7378
1,den011d.map,165,245,36937,150,57,14,187,9395,38,159,126,85,112,102,214,333,1591
2,den011d.map,165,245,29216,119,183,45,61,418,1,71,163,173,118,-112,230,1105,1071
3,den011d.map,165,245,25009,102,225,62,19,29084,118,70,46,174,-16,-155,171,2033,2209
4,den011d.map,165,245,28841,117,68,47,176,10939,44,85,120,159,73,17,90,1464,1849
5,den011d.map,165,245,922,3,57,161,187,10019,40,25,124,219,-37,-32,69,280,90
6,den011d.map,165,245,19464,79,135,85,109,28677,117,232,47,12,-38,97,135,168,580
7,den011d.map,165,245,26978,110,216,54,28,8950,36,114,128,130,74,-102,176,536,730
8,den011d.map,165,245,18040,73,89,91,155,2129,8,75,156,169,65,-14,79,1570,2711
9,den011d.map,165,245,9230,37,79,127,165,11407,46,107,118,137,-9,28,37,38,38
10,den011d.map,165,245,31040,126,74,38,170,13860,56,104,108,140,70,30,100,2433,1534
11,den011d.map,165,245,11866,48,138,116,106,2907,11,32,153,212,37,-106,143,2297,2531
12,den011d.map,165,245,13667,55,52,109,192,8675,35,144,129,100,20,92,112,312,122
13,den011d.map,165,245,24761,101,228,63,16,17339,70,55,94,189,31,-173,204,4131,3916
14,den011d.map,165,245,24376,99,123,65,121,3139,12,45,152,199,87,-78,165,1054,2009
15,den011d.map,165,245,36204,147,55,17,189,5581,22,53,142,191,125,-2,127,2461,3513
16,den011d.map,165,245,26969,110,225,54,19,35713,145,56,19,188,-35,-169,204,3543,2557
17,den011d.map,165,245,3370,13,59,151,185,24327,99,172,65,72,-86,113,199,4733,6798
18,den011d.map,165,245,31177,127,182,37,62,9013,36,51,128,193,91,-131,222,5837,4803
19,den011d.map,165,245,38184,155,35,9,209,20905,85,164,79,80,70,129,199,385,956
20,den011d.map,165,245,36217,147,42,17,202,9913,40,131,124,113,107,89,196,1451,2483
21,den011d.map,165,245,35937,146,77,18,167,13829,56,135,108,109,90,58,148,265,1488
22,den011d.map,165,245,10006,40,38,124,206,5503,22,131,142,113,18,93,111,1567,1521
23,den011d.map,165,245,26083,106,131,58,113,28303,115,116,49,128,-9,-15,24,34,25
24,den011d.map,165,245,8965,36,99,128,145,21871,89,178,75,66,-53,79,132,470,403
25,den011d.map,165,245,11131,45,138,119,106,10227,41,62,123,182,4,-76,80,3010,1167
26,den011d.map,165,245,9249,37,60,127,184,14166,57,43,107,201,-20,-17,37,228,291
27,den011d.map,165,245,11865,48,139,116,105,25346,103,133,61,111,-55,-6,61,62,65
28,den011d.map,165,245,4322,17,87,147,157,10455,42,79,122,165,-25,-8,33,310,318
29,den011d.map,165,245,13409,54,65,110,179,9715,39,84,125,160,15,19,34,35,35
30,den011d.map,165,245,29224,119,175,45,69,24617,100,127,64,117,19,-48,67,1036,1272
31,den011d.map,165,245,22978,93,51,71,193,5659,23,220,141,24,70,169,239,2427,3766
32,den011d.map,165,245,5909,24,215,140,29,26533,108,171,56,73,-84,-44,128,1788,2697
33,den011d.map,165,245,26795,109,154,55,90,20405,83,174,81,70,26,20,46,57,47
34,den011d.map,165,245,25013,102,221,62,23,8182,33,147,131,97,69,-74,143,2087,2212
35,den011d.map,165,245,17538,71,101,93,143,5511,22,123,142,121,49,22,71,2015,6601
36,den011d.map,165,245,36706,149,43,15,201,25107,102,127,62,117,47,84,131,155,795
37,den011d.map,165,245,10497,42,37,122,207,10231,41,58,123,186,1,21,22,23,23
38,den011d.map,165,245,25755,105,214,59,30,8484,34,90,130,154,71,-124,195,664,597
39,den011d.map,165,245,7971,32,113,132,131,29900,122,234,42,10,-90,121,211,825,696
40,den011d.map,165,245,13587,55,132,109,112,25740,105,229,59,15,-50,97,147,204,587
41,den011d.map,165,245,26139,106,75,58,169,16283,66,131,98,113,40,56,96,179,127
42,den011d.map,165,245,5016,20,128,144,116,4294,17,115,147,129,3,-13,16,17,17
43,den011d.map,165,245,39403,160,41,4,203,34237,139,62,25,182,21,21,42,529,559
44,den011d.map,165,245,23874,97,135,67,109,36678,149,71,15,173,-52,-64,116,117,197
45,den011d.map,165,245,7413,30,181,134,63,5926,24,198,140,46,6,17,23,24,24
46,den011d.map,165,245,29084,118,70,46,174,25191,102,43,62,201,16,-27,43,44,44
47,den011d.map,165,245,6081,24,43,140,201,2402,9,47,155,197,15,4,19,20,20
48,den011d.map,165,245,7289,29,60,135,184,22997,93,32,71,212,-64,-28,92,313,94
49,den011d.map,165,245,11129,45,140,119,104,2826,11,113,153,131,34,-27,61,98,68
50,den011d.map,165,245,21873,89,176,75,68,17014,69,135,95,109,20,-41,61,244,77
51,den011d.map,165,245,32277,131,62,33,182,20766,84,58,80,186,47,-4,51,1249,1283
52,den011d.map,165,245,15898,64,26,100,218,38154,155,65,9,179,-91,39,130,1373,756
53,den011d.map,165,245,9985,40,59,124,185,18236,74,138,90,106,-34,79,113,1882,3722
54,den011d.map,165,245,25912,105,57,59,187,25556,104,168,60,76,1,111,112,1468,756
55,den011d.map,165,245,26038,106,176,58,68,10127,41,162,123,82,65,-14,79,1879,1152
56,den011d.map,165,245,28540,116,124,48,120,16559,67,100,97,144,49,-24,73,3962,1583
57,den011d.map,165,245,20195,82,139,82,105,34469,140,75,24,169,-58,-64,122,1113,308
58,den011d.map,165,245,6403,26,211,138,33,20172,82,162,82,82,-56,-49,105,2108,2854
59,den011d.map,165,245,18802,76,62,88,182,26311,107,148,57,96,-31,86,117,3178,2880
60,den011d.map,165,245,6653,27,206,137,38,20423,83,156,81,88,-56,-50,106,1939,2743
61,den011d.map,165,245,20996,85,73,79,171,7135,29,214,135,30,56,141,197,4573,5979
62,den011d.map,165,245,17130,69,19,95,225,11119,45,150,119,94,24,131,155,1600,1722
63,den011d.map,165,245,5416,22,218,142,26,26401,107,58,57,186,-85,-160,245,1214,542
64,den011d.map,165,245,2379,9,70,155,174,23332,95,187,69,57,-86,117,203,937,1098
65,den011d.map,165,245,5861,23,18,141,226,20910,85,159,79,85,-62,141,203,3902,2860
66,den011d.map,165,245,26248,107,211,57,33,19172,78,182,86,62,29,-29,58,104,96
67,den011d.map,165,245,35977,146,37,18,207,9511,38,43,126,201,108,6,114,1757,3684
68,den011d.map,165,245,8001,32,83,132,161,6627,27,232,137,12,5,149,154,1415,1555
69,den011d.map,165,245,10161,41,128,123,116,5618,22,16,142,228,19,-112,131,1758,1557
70,den011d.map,165,245,24336,99,163,65,81,5588,22,46,142,198,77,-117,194,4568,4451
71,den011d.map,165,245,23728,96,36,68,208,26479,108,225,56,19,-12,189,201,2101,2376
72,den011d.map,165,245,29281,119,118,45,126,24759,101,230,63,14,18,112,130,1502,2051
73,den011d.map,165,245,6907,28,197,136,47,24950,101,39,63,205,-73,-158,231,282,6883
74,den011d.map,165,245,3605,14,69,150,175,23975,97,34,67,210,-83,-35,118,260,2058
75,den011d.map,165,245,5105,20,39,144,205,25079,102,155,62,89,-82,116,198,4459,3133
76,den011d.map,165,245,17498,71,141,93,103,14935,60,9,104,235,11,-132,143,3201,3801
77,den011d.map,165,245,9929,40,115,124,129,1153,4,71,160,173,36,-44,80,231,538
78,den011d.map,165,245,930,3,49,161,195,25886,105,83,59,161,-102,34,136,1633,1157
79,den011d.map,165,245,9771,39,28,125,216,28787,117,122,47,122,-78,94,172,962,330
80,den011d.map,165,245,25996,106,218,58,26,6532,26,82,138,162,80,-136,216,3771,815
81,den011d.map,165,245,15331,62,103,102,141,24693,100,51,64,193,-38,-52,90,1307,803
82,den011d.map,165,245,12163,49,86,115,158,3878,15,41,149,203,34,-45,79,1376,3945
83,den011d.map,165,245,33738,137,71,27,173,10731,43,48,121,196,94,-23,117,1596,824
84,den011d.map,165,245,24522,100,222,64,22,2082,8,122,156,122,92,-100,192,587,2600
85,den011d.map,165,245,25001,102,233,62,11,33738,137,71,27,173,-35,-162,197,2119,2529
86,den011d.map,165,245,34494,140,50,24,194,23567,96,197,68,47,44,147,191,2253,1741
87,den011d.map,165,245,8884,36,180,128,64,25255,103,224,61,20,-67,44,111,1861,2645
88,den011d.map,165,245,26784,109,165,55,79,8996,36,68,128,176,73,-97,170,379,424
89,den011d.map,165,245,32024,130,70,34,174,2154,8,50,156,194,122,-20,142,1632,1480
90,den011d.map,165,245,1897,7,62,157,182,15899,64,25,100,219,-57,-37,94,1946,290
91,den011d.map,165,245,13832,56,132,108,112,25370,103,109,61,135,-47,-23,70,122,101
92,den011d.map,165,245,12674,51,65,113,179,9738,39,61,125,183,12,-4,16,871,365
93,den011d.map,165,245,24769,101,220,63,24,5580,22,54,142,190,79,-166,245,7066,6236
94,den011d.map,165,245,37674,153,55,11,189,6413,26,201,138,43,127,146,273,3239,1840
95,den011d.map,165,245,11939,48,65,116,179,13684,55,35,109,209,-7,-30,37,38,74
96,den011d.map,165,245,22475,91,64,73,180,17303,70,91,94,153,21,27,48,72,56
97,den011d.map,165,245,24853,101,136,63,108,4711,19,188,145,56,82,52,134,245,143
98,den011d.map,165,245,7424,30,170,134,74,25322,103,157,61,87,-73,-13,86,1130,1585
99,den011d.map,165,245,6165,25,204,139,40,14198,57,11,107,233,-32,-193,225,3967,3447
0,den012d.map,284,258,24209,93,42,190,215,69439,269,220,14,37,-176,178,354,6454,8402
1,den012d.map,284,258,68416,265,211,18,46,37405,144,4,139,253,121,-207,328,1473,697
2,den012d.map,284,258,55090,213,121,70,136,30411,117,32,166,225,96,-89,185,4038,5182
3,den012d.map,284,258,53402,206,3,77,254,27708,107,155,176,102,99,152,251,3306,356
4,den012d.map,284,258,40757,157,6,126,251,29054,112,99,171,158,45,93,138,869,245
5,den012d.map,284,258,65875,255,172,28,85,61566,238,95,45,162,17,-77,94,305,1094
6,den012d.map,284,258,6786,26,179,257,78,64484,249,15,34,242,-223,-164,387,4559,5767
7,den012d.map,284,258,24390,94,119,189,138,63367,245,100,38,157,-151,-19,170,5508,8180
8,den012d.map,284,258,69777,270,140,13,117,50071,194,238,89,19,76,98,174,330,535
9,den012d.map,284,258,26448,102,125,181,132,64945,251,70,32,187,-149,-55,204,4288,7764
10,den012d.map,284,258,58962,228,119,55,138,24470,94,39,189,218,134,-80,214,4172,3808
11,den012d.map,284,258,55488,215,239,68,18,61416,238,245,45,12,-23,6,29,30,30
12,den012d.map,284,258,5752,22,181,261,76,60899,236,246,47,11,-214,65,279,630,356
13,den012d.map,284,258,25718,99,81,184,176,25679,99,120,184,137,0,39,39,40,40
14,den012d.map,284,258,61309,237,94,46,163,51117,198,224,85,33,39,130,169,6502,2257
15,den012d.map,284,258,17107,66,178,217,79,35589,137,14,146,243,-71,-164,235,353,1556
16,den012d.map,284,258,48529,188,232,95,25,6524,25,183,258,74,163,-49,212,682,2537
17,den012d.map,284,258,32241,124,8,159,249,57493,222,40,61,217,-98,32,130,223,131
18,den012d.map,284,258,50346,195,221,88,36,54378,210,59,73,198,-15,-162,177,2869,9147
19,den012d.map,284,258,68172,264,197,19,60,43071,166,14,117,243,98,-183,281,1310,604
20,den012d.map,284,258,54859,212,94,71,163,53870,208,51,75,206,4,-43,47,622,569
21,den012d.map,284,258,25456,98,85,185,172,50459,195,108,88,149,-97,23,120,8792,5700
22,den012d.map,284,258,68937,267,206,16,51,1374,5,173,278,84,262,-33,295,2470,5357
23,den012d.map,284,258,28070,108,51,175,206,35855,138,6,145,251,-30,-45,75,76,76
24,den012d.map,284,258,26273,101,42,182,215,25906,100,151,183,106,1,109,110,111,111
25,den012d.map,284,258,23276,90,201,193,56,22252,86,193,197,64,4,-8,12,13,13
26,den012d.map,284,258,29372,113,39,170,218,54885,212,68,71,189,-99,29,128,1413,1478
27,den012d.map,284,258,51577,199,22,84,235,15305,59,174,224,83,140,152,292,1682,4093
28,den012d.map,284,258,22480,87,223,196,34,3429,13,182,270,75,74,-41,115,153,1492
29,den012d.map,284,258,51008,197,75,86,182,67126,260,211,23,46,-63,136,199,976,759
30,den012d.map,284,258,27602,106,3,177,254,58229,225,78,58,179,-119,75,194,916,645
31,den012d.map,284,258,68209,264,160,19,97,63337,245,130,38,127,19,-30,49,163,54
32,den012d.map,284,258,56265,218,236,65,21,66979,259,100,24,157,-41,-136,177,732,1742
33,den012d.map,284,258,33553,130,244,153,13,26154,101,161,182,96,29,-83,112,113,138
34,den012d.map,284,258,43109,167,234,116,23,57958,224,91,59,166,-57,-143,200,5697,5953
35,den012d.map,284,258,53650,207,13,76,244,59011,228,70,55,187,-21,57,78,83,191
36,den012d.map,284,258,28244,109,135,174,122,26629,103,202,180,55,6,67,73,74,74
37,den012d.map,284,258,8074,31,181,252,76,61294,237,109,46,148,-206,-72,278,10812,8660
38,den012d.map,284,258,63938,247,45,36,212,29220,113,191,170,66,134,146,280,11931,6309
39,den012d.map,284,258,69259,268,142,15,115,57230,221,45,62,212,47,-97,144,195,460
40,den012d.map,284,258,29833,115,94,168,163,61882,239,37,44,220,-124,-57,181,2980,5969
41,den012d.map,284,258,70988,275,219,8,38,48997,189,22,94,235,86,-197,283,1414,636
42,den012d.map,284,258,52131,202,242,81,15,70468,273,223,10,34,-71,-19,90,289,92
43,den012d.map,284,258,67617,262,236,21,21,26044,100,13,183,244,162,-223,385,1710,4118
44,den012d.map,284,258,22933,88,28,195,229,56926,220,91,63,166,-132,63,195,3619,2417
45,den012d.map,284,258,57194,221,81,62,176,66396,257,167,26,90,-36,86,122,1964,311
46,den012d.map,284,258,48482,187,21,96,236,67699,262,154,21,103,-75,133,208,531,848
47,den012d.map,284,258,65730,254,59,29,198,62098,240,79,43,178,14,20,34,40,35
48,den012d.map,284,258,23079,89,140,194,117,4727,18,174,265,83,71,34,105,325,1263
49,den012d.map,284,258,71844,278,137,5,120,40783,158,238,125,19,120,101,221,377,1010
50,den012d.map,284,258,27859,107,4,176,253,63918,247,65,36,192,-140,61,201,2003,237
51,den012d.map,284,258,23452,90,25,193,232,62388,241,47,42,210,-151,22,173,3257,857
52,den012d.map,284,258,70202,272,231,11,26,26371,102,202,181,55,170,-29,199,1138,1132
53,den012d.map,284,258,70018,271,157,12,100,60806,235,81,48,176,36,-76,112,199,147
54,den012d.map,284,258,65065,252,208,31,49,11172,43,179,240,78,209,-29,238,1856,5211
55,den012d.map,284,258,23425,90,52,193,205,53164,206,241,77,16,-116,189,305,306,1055
56,den012d.map,284,258,51067,197,16,86,241,30411,117,32,166,225,80,16,96,612,115
57,den012d.map,284,258,8073,31,182,252,75,64687,250,70,33,187,-219,-112,331,8112,10467
58,den012d.map,284,258,60090,232,23,51,234,26709,103,122,180,135,129,99,228,478,2978
59,den012d.map,284,258,65762,254,27,29,230,22671,87,32,196,225,167,5,172,838,1592
60,den012d.map,284,258,22001,85,186,198,71,24689,95,78,188,179,-10,-108,118,334,739
61,den012d.map,284,258,42552,164,17,119,240,56129,217,114,66,143,-53,97,150,1252,1503
62,den012d.map,284,258,21384,82,29,201,228,48683,188,78,95,179,-106,49,155,6256,2117
63,den012d.map,284,258,27938,108,183,175,74,23813,92,180,191,77,16,-3,19,20,20
64,den012d.map,284,258,36656,142,237,141,20,29070,112,83,171,174,30,-154,184,781,1696
65,den012d.map,284,258,71609,277,114,6,143,65638,254,151,29,106,23,37,60,157,97
66,den012d.map,284,258,25970,100,87,183,170,61059,236,86,47,171,-136,-1,137,3961,6534
67,den012d.map,284,258,62939,243,12,40,245,23461,90,16,193,241,153,4,157,158,158
68,den012d.map,284,258,70202,272,231,11,26,44108,170,9,113,248,102,-222,324,1608,647
69,den012d.map,284,258,25480,98,61,185,196,54895,212,58,71,199,-114,-3,117,2347,2105
70,den012d.map,284,258,31729,122,4,161,253,53846,208,75,75,182,-86,71,157,3507,820
71,den012d.map,284,258,27882,108,239,175,18,66765,258,56,25,201,-150,-183,333,2364,4562
72,den012d.map,284,258,59096,229,243,54,14,58201,225,106,58,151,4,-137,141,5992,4228
73,den012d.map,284,258,23552,91,183,192,74,24880,96,145,187,112,-5,-38,43,111,130
74,den012d.map,284,258,12960,50,197,233,60,23448,90,29,193,228,-40,-168,208,2126,1264
75,den012d.map,284,258,46880,181,75,102,182,70552,273,139,10,118,-92,64,156,965,186
76,den012d.map,284,258,63361,245,106,38,151,70582,273,109,10,148,-28,3,31,32,32
77,den012d.map,284,258,25001,96,24,187,233,49772,192,21,91,236,-96,-3,99,311,136
78,den012d.map,284,258,60060,232,53,51,204,67156,260,181,23,76,-28,128,156,277,2515
79,den012d.map,284,258,27294,105,53,178,204,9871,38,190,245,67,67,137,204,1033,506
80,den012d.map,284,258,27945,108,176,175,81,63346,245,121,38,136,-137,-55,192,9585,10315
81,den012d.map,284,258,40634,157,129,126,128,64901,251,114,32,143,-94,-15,109,1770,3678
82,den012d.map,284,258,26403,102,170,181,87,67763,262,90,21,167,-160,-80,240,7710,9115
83,den012d.map,284,258,54378,210,59,73,198,46310,179,129,104,128,31,70,101,1030,1555
84,den012d.map,284,258,27521,106,84,177,173,68510,265,117,18,140,-159,33,192,4546,8152
85,den012d.map,284,258,43617,169,242,114,15,58751,227,72,56,185,-58,-170,228,2876,5249
86,den012d.map,284,258,46056,178,125,105,132,62327,241,108,42,149,-63,-17,80,1754,2925
87,den012d.map,284,258,8328,32,185,251,72,65838,255,209,28,48,-223,24,247,4921,1749
88,den012d.map,284,258,24554,95,213,188,44,66399,257,164,26,93,-162,-49,211,3500,1989
89,den012d.map,284,258,25939,100,118,183,139,54876,212,77,71,180,-112,-41,153,6933,6386
90,den012d.map,284,258,25612,99,187,184,70,35076,135,11,148,246,-36,-176,212,213,213
91,den012d.map,284,258,64856,251,159,32,98,42555,164,14,119,243,87,-145,232,974,5900
92,den012d.map,284,258,53598,207,65,76,192,30054,116,131,167,126,91,66,157,6512,4883
93,den012d.map,284,258,42034,162,19,121,238,57491,222,42,61,215,-60,23,83,97,384
94,den012d.map,284,258,22824,88,137,195,120,28059,108,62,175,195,-20,-75,95,96,114
95,den012d.map,284,258,26713,103,118,180,139,28370,109,9,174,248,-6,-109,115,116,116
96,den012d.map,284,258,28114,108,7,175,250,58174,225,133,58,124,-117,126,243,1502,1970
97,den012d.map,284,258,26612,103,219,180,38,46694,180,3,103,254,-77,-216,293,389,2672
98,den012d.map,284,258,52336,202,37,81,220,68430,265,197,18,60,-63,160,223,543,1078
99,den012d.map,284,258,64649,250,108,33,149,28442,110,195,173,62,140,87,227,10239,8626
0,den020d.map,115,87,4137,47,38,67,48,8370,96,68,18,18,-49,30,79,883,238
1,den020d.map,115,87,6811,78,61,36,25,6284,72,66,42,20,6,5,11,12,12
2,den020d.map,115,87,5524,63,43,51,43,4991,57,54,57,32,6,11,17,18,18
3,den020d.map,115,87,4892,56,66,58,20,565,6,43,108,43,50,-23,73,642,309
4,den020d.map,115,87,6206,71,57,43,29,1279,14,25,100,61,57,-32,89,156,1127
5,den020d.map,115,87,2778,31,5,83,81,6275,72,75,42,11,-41,70,111,1418,366
6,den020d.map,115,87,8306,95,45,19,41,6887,79,72,35,14,16,27,43,457,220
7,den020d.map,115,87,8536,98,76,16,10,4983,57,62,57,24,41,-14,55,500,940
8,den020d.map,115,87,3112,35,19,79,67,741,8,41,106,45,27,22,49,64,198
9,den020d.map,115,87,6630,76,68,38,18,6279,72,71,42,15,4,3,7,29,54
10,den020d.map,115,87,4568,52,42,62,44,6438,74,86,40,0,-22,44,66,543,344
11,den020d.map,115,87,9234,106,74,8,12,3330,38,62,76,24,68,-12,80,584,1082
12,den020d.map,115,87,1961,22,39,92,47,3077,35,54,79,32,-13,15,28,976,234
13,den020d.map,115,87,9152,105,69,9,17,3417,39,62,75,24,66,-7,73,578,1186
14,den020d.map,115,87,2741,31,42,83,44,7079,81,54,33,32,-50,12,62,178,79
15,den020d.map,115,87,670,7,25,107,61,5926,68,76,46,10,-61,51,112,1506,333
16,den020d.map,115,87,7265,83,42,31,44,3181,36,37,78,49,47,-5,52,53,53
17,den020d.map,115,87,6878,79,81,35,5,8823,101,50,13,36,-22,-31,53,432,651
18,den020d.map,115,87,5922,68,80,46,6,3277,37,28,77,58,31,-52,83,331,1138
19,den020d.map,115,87,2568,29,41,85,45,4731,54,53,60,33,-25,12,37,38,38
20,den020d.map,115,87,8448,97,77,17,9,757,8,25,106,61,89,-52,141,380,1766
21,den020d.map,115,87,1784,20,42,94,44,8447,97,78,17,8,-77,36,113,1216,355
22,den020d.map,115,87,4760,54,24,60,62,3445,39,34,75,52,15,10,25,26,26
23,den020d.map,115,87,6472,74,52,40,34,8196,94,68,20,18,-20,16,36,471,363
24,den020d.map,115,87,9049,104,85,10,1,845,9,24,105,62,95,-61,156,477,1834
25,den020d.map,115,87,4057,46,31,68,55,637,7,58,107,28,39,27,66,69,147
26,den020d.map,115,87,485,5,36,109,50,8463,97,62,17,24,-92,26,118,1367,232
27,den020d.map,115,87,4542,52,68,62,18,3639,41,14,73,72,11,-54,65,153,432
28,den020d.map,115,87,6196,71,67,43,19,9062,104,72,10,14,-33,5,38,671,512
29,den020d.map,115,87,2816,32,54,82,32,4893,56,65,58,21,-24,11,35,42,36
30,den020d.map,115,87,6177,71,86,43,0,566,6,42,108,44,65,-44,109,728,1270
31,den020d.map,115,87,1265,14,39,100,47,8004,92,86,22,0,-78,47,125,1795,349
32,den020d.map,115,87,632,7,63,107,23,4468,51,55,63,31,-44,-8,52,323,684
33,den020d.map,115,87,4987,57,58,57,28,4388,50,48,64,38,7,-10,17,19,18
34,den020d.map,115,87,8218,94,46,20,40,931,10,25,104,61,84,-21,105,106,277
35,den020d.map,115,87,8624,99,75,15,11,8012,92,78,22,8,7,3,10,11,11
36,den020d.map,115,87,6537,75,74,39,12,8292,95,59,19,27,-20,-15,35,550,676
37,den020d.map,115,87,3374,38,18,76,68,3967,45,34,69,52,-7,16,23,24,43
38,den020d.map,115,87,3299,37,6,77,80,6293,72,57,42,29,-35,51,86,1282,758
39,den020d.map,115,87,4309,49,40,65,46,3461,39,18,75,68,10,-22,32,49,33
40,den020d.map,115,87,4123,47,52,67,34,3620,41,33,73,53,6,-19,25,170,548
41,den020d.map,115,87,9002,103,45,11,41,3886,44,28,70,58,59,-17,76,77,116
42,den020d.map,115,87,6994,80,52,34,34,8188,94,76,20,10,-14,24,38,504,407
43,den020d.map,115,87,9177,105,44,9,42,6647,76,51,38,35,29,7,36,43,37
44,den020d.map,115,87,4576,52,34,62,52,2826,32,44,82,42,20,10,30,31,31
45,den020d.map,115,87,4644,53,53,61,33,895,10,61,104,25,43,8,51,688,308
46,den020d.map,115,87,4977,57,68,57,18,8567,98,45,16,41,-41,-23,64,146,81
47,den020d.map,115,87,2944,33,13,81,73,3461,39,18,75,68,-6,5,11,29,15
48,den020d.map,115,87,3122,35,9,79,77,6742,77,43,37,43,-42,34,76,77,171
49,den020d.map,115,87,3684,42,56,72,30,2815,32,55,82,31,10,-1,11,12,12
50,den020d.map,115,87,2945,33,12,81,74,8799,101,74,13,12,-68,62,130,1722,413
51,den020d.map,115,87,112,1,61,113,25,5870,67,45,47,41,-66,-16,82,311,743
52,den020d.map,115,87,1006,11,37,103,49,4455,51,68,63,18,-40,31,71,537,260
53,den020d.map,115,87,4041,46,47,68,39,1788,20,38,94,48,26,-9,35,36,36
54,den020d.map,115,87,4221,48,41,66,45,6470,74,54,40,32,-26,13,39,335,68
55,den020d.map,115,87,9176,105,45,9,41,6369,73,68,41,18,32,23,55,350,150
56,den020d.map,115,87,4466,51,57,63,29,1959,22,41,92,45,29,-16,45,46,46
57,den020d.map,115,87,9049,104,85,10,1,654,7,41,107,45,97,-44,141,710,1700
58,den020d.map,115,87,4225,48,37,66,49,3505,40,61,74,25,8,24,32,210,140
59,den020d.map,115,87,4253,48,9,66,77,5262,60,44,54,42,-12,35,47,85,211
60,den020d.map,115,87,3445,39,34,75,52,3719,42,21,72,65,-3,-13,16,17,20
61,den020d.map,115,87,112,1,61,113,25,4059,46,29,68,57,-45,-32,77,178,121
62,den020d.map,115,87,1185,13,32,101,54,2476,28,46,86,40,-15,14,29,60,30
63,den020d.map,115,87,929,10,27,104,59,3189,36,29,78,57,-26,2,28,211,258
64,den020d.map,115,87,9051,104,83,10,3,8015,92,75,22,11,12,-8,20,21,24
65,den020d.map,115,87,7435,85,46,29,40,4157,47,18,67,68,38,-28,66,67,138
66,den020d.map,115,87,3680,42,60,72,26,3214,36,4,78,82,6,-56,62,389,898
67,den020d.map,115,87,2913,33,44,81,42,4575,52,35,62,51,-19,-9,28,29,29
68,den020d.map,115,87,5608,64,46,50,40,4851,55,20,59,66,9,-26,35,198,113
69,den020d.map,115,87,9841,113,76,1,10,6274,72,76,42,10,41,0,41,517,684
70,den020d.map,115,87,1280,14,24,100,62,9839,113,78,1,8,-99,54,153,1657,488
71,den020d.map,115,87,3883,44,31,70,55,6021,69,68,45,18,-25,37,62,866,205
72,den020d.map,115,87,4233,48,29,66,57,9839,113,78,1,8,-65,49,114,1113,449
73,den020d.map,115,87,6804,78,68,36,18,911,10,45,104,41,68,-23,91,765,1588
74,den020d.map,115,87,3107,35,24,79,62,4463,51,60,63,26,-16,36,52,53,179
75,den020d.map,115,87,4501,51,22,63,64,8119,93,58,21,28,-42,36,78,1026,436
76,den020d.map,115,87,5324,61,69,53,17,4900,56,58,58,28,5,-11,16,17,17
77,den020d.map,115,87,5435,62,45,52,41,1173,13,44,101,42,49,-1,50,333,92
78,den020d.map,115,87,8641,99,58,15,28,4230,48,32,66,54,51,-26,77,170,585
79,den020d.map,115,87,6481,74,43,40,43,8019,92,71,22,15,-18,28,46,447,233
80,den020d.map,115,87,4892,56,66,58,20,3087,35,44,79,42,21,-22,43,186,44
81,den020d.map,115,87,4304,49,45,65,41,4569,52,41,62,45,-3,-4,7,8,8
82,den020d.map,115,87,2920,33,37,81,49,4345,49,4,65,82,-16,-33,49,50,61
83,den020d.map,115,87,2942,33,15,81,71,8047,92,43,22,43,-59,28,87,88,106
84,den020d.map,115,87,4936,56,22,58,64,2390,27,45,87,41,29,23,52,60,54
85,den020d.map,115,87,5088,58,44,56,42,8450,97,75,17,11,-39,31,70,710,300
86,den020d.map,115,87,1259,14,45,100,41,8367,96,71,18,15,-82,26,108,1486,836
87,den020d.map,115,87,3032,34,12,80,74,8472,97,53,17,33,-63,41,104,1304,172
88,den020d.map,115,87,2129,24,45,90,41,6131,70,45,44,41,-46,0,46,47,47
89,den020d.map,115,87,563,6,45,108,41,892,10,64,104,22,-4,19,23,24,29
90,den020d.map,115,87,5163,59,56,55,30,843,9,26,105,60,50,-30,80,81,182
91,den020d.map,115,87,3632,41,21,73,65,3337,38,55,76,31,3,34,37,843,230
92,den020d.map,115,87,3944,45,57,69,29,3692,42,48,72,38,3,-9,12,151,87
93,den020d.map,115,87,4629,53,68,61,18,4765,54,19,60,67,-1,-49,50,351,123
94,den020d.map,115,87,917,10,39,104,47,1453,16,25,98,61,-6,-14,20,21,21
95,den020d.map,115,87,923,10,33,104,53,6364,73,73,41,13,-63,40,103,1310,296
96,den020d.map,115,87,4763,54,21,60,65,1004,11,39,103,47,43,18,61,76,162
97,den020d.map,115,87,4808,55,63,59,23,8447,97,78,17,8,-42,15,57,980,503
98,den020d.map,115,87,3362,38,30,76,56,6011,69,78,45,8,-31,48,79,1035,316
99,den020d.map,115,87,8372,96,66,18,20,1189,13,28,101,58,83,-38,121,269,1561
0,den101d.map,39,69,733,10,25,28,43,1542,22,44,16,24,-12,19,31,35,32
1,den101d.map,39,69,2520,36,32,2,36,1812,26,50,12,18,10,18,28,42,29
2,den101d.map,39,69,715,10,43,28,25,750,10,8,28,60,0,-35,35,529,366
3,den101d.map,39,69,1872,27,59,11,9,1260,18,50,20,18,9,-9,18,19,19
4,den101d.map,39,69,2228,32,48,6,20,1358,19,21,19,47,13,-27,40,55,221
5,den101d.map,39,69,264,3,11,35,57,337,4,7,34,61,-1,-4,5,6,6
6,den101d.map,39,69,1708,24,16,14,52,524,7,27,31,41,17,11,28,655,165
7,den101d.map,39,69,272,3,3,35,65,2526,36,26,2,42,-33,23,56,114,128
8,den101d.map,39,69,1418,20,30,18,38,551,7,0,31,68,13,-30,43,165,327
9,den101d.map,39,69,481,6,1,32,67,1500,21,17,17,51,-15,16,31,313,62
10,den101d.map,39,69,1809,26,53,12,15,2079,30,59,8,9,-4,6,10,11,11
11,den101d.map,39,69,852,12,44,26,24,1645,23,10,15,58,-11,-34,45,264,146
12,den101d.map,39,69,97,1,40,37,28,958,13,7,25,61,-12,-33,45,518,586
13,den101d.map,39,69,1850,26,12,12,56,588,8,32,30,36,18,20,38,646,167
14,den101d.map,39,69,1465,21,52,17,16,1859,26,3,12,65,-5,-49,54,55,90
15,den101d.map,39,69,24,0,44,38,24,790,11,37,27,31,-11,-7,18,39,19
16,den101d.map,39,69,1136,16,36,22,32,577,8,43,30,25,8,7,15,16,40
17,den101d.map,39,69,2386,34,28,4,40,102,1,35,37,33,33,7,40,361,344
18,den101d.map,39,69,1517,21,0,17,68,1367,19,12,19,56,2,12,14,19,29
19,den101d.map,39,69,468,6,14,32,54,1804,26,58,12,10,-20,44,64,137,564
20,den101d.map,39,69,193,2,13,36,55,1643,23,12,15,56,-21,-1,22,23,23
21,den101d.map,39,69,1700,24,24,14,44,1926,27,5,11,63,-3,-19,22,23,31
22,den101d.map,39,69,2389,34,25,4,43,645,9,44,29,24,25,19,44,54,99
23,den101d.map,39,69,1488,21,29,17,39,2165,31,42,7,26,-10,13,23,210,92
24,den101d.map,39,69,714,10,44,28,24,266,3,9,35,59,7,-35,42,539,364
25,den101d.map,39,69,1578,22,8,16,60,2315,33,30,5,38,-11,22,33,38,67
26,den101d.map,39,69,714,10,44,28,24,2279,33,66,5,2,-23,22,45,71,227
27,den101d.map,39,69,2518,36,34,2,34,1926,27,5,11,63,9,-29,38,106,47
28,den101d.map,39,69,848,12,48,26,20,2009,29,60,9,8,-17,12,29,67,222
29,den101d.map,39,69,1506,21,11,17,57,1683,24,41,14,27,-3,30,33,39,116
30,den101d.map,39,69,2492,36,60,2,8,197,2,9,36,59,34,-51,85,595,424
31,den101d.map,39,69,2074,30,64,8,4,1740,25,53,13,15,5,-11,16,17,17
32,den101d.map,39,69,1664,24,60,14,8,658,9,31,29,37,15,-29,44,45,73
33,den101d.map,39,69,686,9,3,29,65,2319,33,26,5,42,-24,23,47,72,119
34,den101d.map,39,69,526,7,25,31,43,519,7,32,31,36,0,7,7,8,8
35,den101d.map,39,69,1648,23,7,15,61,1133,16,39,22,29,7,32,39,120,200
36,den101d.map,39,69,312,4,32,34,36,35,0,33,38,35,4,1,5,6,6
37,den101d.map,39,69,2488,36,64,2,4,1801,26,61,12,7,10,-3,13,14,14
38,den101d.map,39,69,25,0,43,38,25,730,10,28,28,40,-10,-15,25,26,31
39,den101d.map,39,69,1704,24,20,14,48,1563,22,23,16,45,2,3,5,6,6
40,den101d.map,39,69,826,11,1,27,67,1626,23,29,15,39,-12,28,40,192,137
41,den101d.map,39,69,1369,19,10,19,58,2522,36,30,2,38,-17,20,37,42,98
42,den101d.map,39,69,1568,22,18,16,50,2363,34,51,4,17,-12,33,45,46,46
43,den101d.map,39,69,716,10,42,28,26,405,5,8,33,60,5,-34,39,529,366
44,den101d.map,39,69,1232,17,9,21,59,2281,33,64,5,4,-16,55,71,248,419
45,den101d.map,39,69,1099,15,4,23,64,340,4,4,34,64,11,0,11,12,12
46,den101d.map,39,69,1290,18,20,20,48,1199,17,42,21,26,1,22,23,37,24
47,den101d.map,39,69,2448,35,35,3,33,2003,29,66,9,2,6,31,37,108,112
48,den101d.map,39,69,653,9,36,29,32,1671,24,53,14,15,-15,17,32,61,33
49,den101d.map,39,69,128,1,9,37,59,1913,27,18,11,50,-26,9,35,89,50
50,den101d.map,39,69,1794,26,68,12,0,1483,21,34,17,34,5,-34,39,40,40
51,den101d.map,39,69,618,8,2,30,66,343,4,1,34,67,4,-1,5,6,6
52,den101d.map,39,69,2456,35,27,3,41,236,3,39,35,29,32,12,44,301,308
53,den101d.map,39,69,1539,22,47,16,21,1950,28,50,10,18,-6,3,9,10,10
54,den101d.map,39,69,437,6,45,32,23,310,4,34,34,34,2,-11,13,20,18
55,den101d.map,39,69,1609,23,46,15,22,1122,16,50,22,18,7,4,11,12,12
56,den101d.map,39,69,248,3,27,35,41,1778,25,15,13,53,-22,-12,34,183,715
57,den101d.map,39,69,56,0,12,38,56,741,10,17,28,51,-10,5,15,16,16
58,den101d.map,39,69,245,3,30,35,38,1399,20,49,18,19,-17,19,36,82,37
59,den101d.map,39,69,882,12,14,26,54,615,8,5,30,63,4,-9,13,14,14
60,den101d.map,39,69,1608,23,47,15,21,318,4,26,34,42,19,-21,40,51,61
61,den101d.map,39,69,472,6,10,32,58,2087,30,51,8,17,-24,41,65,207,449
62,den101d.map,39,69,1540,22,46,16,22,317,4,27,34,41,18,-19,37,48,54
63,den101d.map,39,69,224,3,51,35,17,1700,24,24,14,44,-21,-27,48,102,70
64,den101d.map,39,69,1368,19,11,19,57,1916,27,15,11,53,-8,4,12,13,13
65,den101d.map,39,69,2424,35,59,3,9,1546,22,40,16,28,13,-19,32,33,33
66,den101d.map,39,69,2352,34,62,4,6,1745,25,48,13,20,9,-14,23,24,24
67,den101d.map,39,69,1584,22,2,16,66,1229,17,12,21,56,5,10,15,16,16
68,den101d.map,39,69,1544,22,42,16,26,2149,31,58,7,10,-9,16,25,26,26
69,den101d.map,39,69,1707,24,17,14,51,1550,22,36,16,32,2,19,21,22,22
70,den101d.map,39,69,296,4,48,34,20,1693,24,31,14,37,-20,-17,37,77,48
71,den101d.map,39,69,401,5,12,33,56,164,2,42,36,26,3,30,33,360,525
72,den101d.map,39,69,1211,17,30,21,38,1836,26,26,12,42,-9,-4,13,16,14
73,den101d.map,39,69,1748,25,45,13,23,1679,24,45,14,23,1,0,1,2,2
74,den101d.map,39,69,595,8,25,30,43,2445,35,38,3,30,-27,13,40,389,420
75,den101d.map,39,69,778,11,49,27,19,1445,20,3,18,65,-9,-46,55,409,320
76,den101d.map,39,69,1336,19,43,19,25,2159,31,48,7,20,-12,5,17,50,28
77,den101d.map,39,69,1792,25,1,13,67,1508,21,9,17,59,4,8,12,22,13
78,den101d.map,39,69,432,6,50,32,18,815,11,12,27,56,-5,-38,43,528,363
79,den101d.map,39,69,506,7,45,31,23,855,12,41,26,27,-5,-4,9,10,10
80,den101d.map,39,69,1441,20,7,18,61,733,10,25,28,43,10,18,28,721,416
81,den101d.map,39,69,1356,19,23,19,45,2446,35,37,3,31,-16,14,30,95,34
82,den101d.map,39,69,1273,18,37,20,31,2357,34,57,4,11,-16,20,36,37,37
83,den101d.map,39,69,2180,31,27,7,41,1855,26,7,12,61,5,-20,25,26,26
84,den101d.map,39,69,992,14,42,24,26,274,3,1,35,67,11,-41,52,538,383
85,den101d.map,39,69,1024,14,10,24,58,2349,34,65,4,3,-20,55,75,277,463
86,den101d.map,39,69,1121,16,51,22,17,1349,19,30,19,38,-3,-21,24,25,31
87,den101d.map,39,69,2506,36,46,2,22,715,10,43,28,25,26,-3,29,77,133
88,den101d.map,39,69,2281,33,64,5,4,2437,35,46,3,22,-2,-18,20,110,84
89,den101d.map,39,69,1776,25,17,13,51,34,0,34,38,34,25,17,42,460,196
90,den101d.map,39,69,792,11,35,27,33,2017,29,52,9,16,-18,17,35,50,36
91,den101d.map,39,69,2281,33,64,5,4,550,7,1,31,67,26,-63,89,554,463
92,den101d.map,39,69,1795,26,67,12,1,2311,33,34,5,34,-7,-33,40,41,51
93,den101d.map,39,69,2232,32,44,6,24,1220,17,21,21,47,15,-23,38,50,257
94,den101d.map,39,69,1865,27,66,11,2,754,10,4,28,64,17,-62,79,448,253
95,den101d.map,39,69,2297,33,48,5,20,2454,35,29,3,39,-2,-19,21,22,22
96,den101d.map,39,69,680,9,9,29,59,1707,24,17,14,51,-15,8,23,89,37
97,den101d.map,39,69,1209,17,32,21,36,733,10,25,28,43,7,-7,14,211,144
98,den101d.map,39,69,177,2,29,36,39,341,4,3,34,65,-2,-26,28,535,735
99,den101d.map,39,69,1508,21,9,17,59,727,10,31,28,37,11,22,33,705,397
0,den200d.map,334,200,38506,192,93,141,106,24427,122,172,211,27,70,79,149,309,617
1,den200d.map,334,200,12852,64,147,269,52,654,3,145,330,54,61,-2,63,64,64
2,den200d.map,334,200,50101,250,98,83,101,55239,276,160,57,39,-26,62,88,14007,1769
3,den200d.map,334,200,48930,244,69,89,130,49140,245,59,88,140,-1,-10,11,12,12
4,den200d.map,334,200,45811,229,188,104,11,4844,24,155,309,44,205,-33,238,1769,14007
5,den200d.map,334,200,27228,136,171,197,28,61566,307,33,26,166,-171,-138,309,7456,771
6,den200d.map,334,200,32028,160,171,173,28,65367,326,32,7,167,-166,-139,305,6934,851
7,den200d.map,334,200,59684,298,115,35,84,59917,299,82,34,117,-1,-33,34,310,93
8,den200d.map,334,200,30421,152,178,181,21,55391,276,8,57,191,-124,-170,294,491,716
9,den200d.map,334,200,63179,315,20,18,179,61174,305,25,28,174,10,5,15,16,16
10,den200d.map,334,200,40939,204,60,129,139,37269,186,130,147,69,18,70,88,352,1380
11,den200d.map,334,200,62454,312,145,21,54,49423,247,176,86,23,65,31,96,14007,1769
12,den200d.map,334,200,49162,245,37,88,162,22214,111,185,222,14,134,148,282,583,1204
13,den200d.map,334,200,23424,117,175,216,24,39249,196,150,137,49,-79,-25,104,563,186
14,den200d.map,334,200,40520,202,79,131,120,10445,52,154,281,45,150,75,225,2700,2073
15,den200d.map,334,200,60650,303,149,30,50,40701,203,98,130,101,100,-51,151,476,1312
16,den200d.map,334,200,7851,39,148,294,51,46636,233,163,100,36,-194,15,209,14007,1769
17,den200d.map,334,200,47592,237,7,96,192,39653,198,146,135,53,39,139,178,3799,4015
18,den200d.map,334,200,56419,282,180,51,19,58175,290,24,43,175,-8,-156,164,1769,14007
19,den200d.map,334,200,41923,209,76,124,123,50173,250,26,83,173,-41,-50,91,285,246
20,den200d.map,334,200,39021,195,178,138,21,62709,313,90,20,109,-118,-88,206,703,2959
21,den200d.map,334,200,53589,267,10,66,189,49015,245,184,88,15,22,174,196,14007,1769
22,den200d.map,334,200,45902,229,97,104,102,50167,250,32,83,167,-21,-65,86,87,314
23,den200d.map,334,200,40089,200,110,133,89,29830,149,169,184,30,51,59,110,267,113
24,den200d.map,334,200,44096,220,103,113,96,45619,228,180,105,19,-8,77,85,14007,1769
25,den200d.map,334,200,50832,254,167,79,32,46500,232,99,101,100,22,-68,90,1769,14007
26,den200d.map,334,200,59516,297,83,36,116,48229,241,170,92,29,56,87,143,14007,1769
27,den200d.map,334,200,61474,307,125,26,74,54373,271,26,62,173,36,-99,135,1798,2071
28,den200d.map,334,200,51032,255,167,78,32,48206,241,193,92,6,14,26,40,42,41
29,den200d.map,334,200,38725,193,74,140,125,65973,329,26,4,173,-136,-48,184,1766,2245
30,den200d.map,334,200,59971,299,28,34,171,38223,191,176,142,23,108,148,256,421,450
31,den200d.map,334,200,60052,300,147,33,52,53151,265,48,68,151,35,-99,134,1690,638
32,den200d.map,334,200,26032,130,167,203,32,24233,121,166,212,33,9,-1,10,11,11
33,den200d.map,334,200,49684,248,115,85,84,39919,199,80,134,119,49,-35,84,85,117
34,den200d.map,334,200,5850,29,149,304,50,49987,249,12,84,187,-220,-137,357,6211,6659
35,den200d.map,334,200,21825,109,174,224,25,23638,118,161,215,38,-9,-13,22,23,23
36,den200d.map,334,200,51153,255,46,78,153,37647,188,152,145,47,67,106,173,253,367
37,den200d.map,334,200,42513,212,86,121,113,49538,247,61,86,138,-35,-25,60,215,61
38,den200d.map,334,200,19651,98,148,235,51,37060,185,139,148,60,-87,-9,96,1523,1320
39,den200d.map,334,200,26441,132,158,201,41,29625,148,174,185,25,-16,16,32,33,33
40,den200d.map,334,200,23016,115,183,218,16,29805,149,194,184,5,-34,11,45,686,170
41,den200d.map,334,200,60522,302,77,31,122,51964,259,35,74,164,43,-42,85,804,3008
42,den200d.map,334,200,48736,243,63,90,136,55366,276,33,57,166,-33,-30,63,64,64
43,den200d.map,334,200,47737,238,62,95,137,61685,308,114,25,85,-70,52,122,500,2349
44,den200d.map,334,200,48593,242,6,91,193,62578,312,21,21,178,-70,15,85,86,86
45,den200d.map,334,200,55211,276,188,57,11,26839,134,160,199,39,142,-28,170,1769,14007
46,den200d.map,334,200,20048,100,151,233,48,22804,114,195,219,4,-14,44,58,60,77
47,den200d.map,334,200,43091,215,108,118,91,49827,249,172,84,27,-34,64,98,14007,1769
48,den200d.map,334,200,43083,215,116,118,83,49557,247,42,86,157,-32,-74,106,257,239
49,den200d.map,334,200,51833,259,166,74,33,40935,204,64,129,135,55,-102,157,1769,14007
50,den200d.map,334,200,45814,229,185,104,14,51007,255,192,78,7,-26,7,33,53,35
51,den200d.map,334,200,47940,239,59,94,140,49687,248,112,85,87,-9,53,62,119,1480
52,den200d.map,334,200,38457,192,142,141,57,1046,5,153,328,46,187,11,198,1392,2439
53,den200d.map,334,200,41849,209,150,124,49,51812,259,187,74,12,-50,37,87,14007,1769
54,den200d.map,334,200,1066,5,133,328,66,36876,184,123,149,76,-179,-10,189,2450,1920
55,den200d.map,334,200,27232,136,167,197,32,47909,239,90,94,109,-103,-77,180,505,2487
56,den200d.map,334,200,63283,316,116,17,83,47764,238,35,95,164,78,-81,159,329,463
57,den200d.map,334,200,39924,199,75,134,124,62461,312,138,21,61,-113,63,176,1290,3628
58,den200d.map,334,200,60110,300,89,33,110,47886,239,113,94,86,61,24,85,98,146
59,den200d.map,334,200,60520,302,79,31,120,45528,227,71,106,128,75,-8,83,478,1348
60,den200d.map,334,200,62891,314,108,19,91,37636,188,163,145,36,126,55,181,1336,2713
61,den200d.map,334,200,34818,174,181,159,18,44693,223,106,110,93,-49,-75,124,316,207
62,den200d.map,334,200,60690,303,109,30,90,32634,163,165,170,34,140,56,196,1261,3228
63,den200d.map,334,200,43930,219,69,114,130,51787,258,12,75,187,-39,-57,96,232,306
64,den200d.map,334,200,44724,223,75,110,124,25054,125,145,208,54,98,70,168,4261,1087
65,den200d.map,334,200,36682,183,117,150,82,43127,215,72,118,127,-32,-45,77,78,89
66,den200d.map,334,200,49552,247,47,86,152,38713,193,86,140,113,54,39,93,157,287
67,den200d.map,334,200,36233,181,166,152,33,39708,198,91,135,108,-17,-75,92,93,132
68,den200d.map,334,200,45883,229,116,104,83,27231,136,168,197,31,93,52,145,1443,1569
69,den200d.map,334,200,59676,298,123,35,76,33831,169,168,164,31,129,45,174,1242,3678
70,den200d.map,334,200,24010,120,189,213,10,37823,189,176,144,23,-69,-13,82,618,109
71,den200d.map,334,200,49232,246,167,87,32,36846,184,153,149,46,62,-14,76,1769,14007
72,den200d.map,334,200,32629,163,170,170,29,445,2,154,331,45,161,-16,177,179,179
73,den200d.map,334,200,39651,198,148,135,51,38020,190,179,143,20,8,31,39,40,40
74,den200d.map,334,200,49011,245,188,88,11,37676,188,123,145,76,57,-65,122,1769,14007
75,den200d.map,334,200,38428,192,171,141,28,28230,141,169,192,30,51,-2,53,54,54
76,den200d.map,334,200,53764,268,35,65,164,51566,257,33,76,166,11,-2,13,14,14
77,den200d.map,334,200,36676,183,123,150,76,63974,319,25,14,174,-136,-98,234,428,400
78,den200d.map,334,200,50035,250,164,83,35,61108,305,91,28,108,-55,-73,128,1769,14007
79,den200d.map,334,200,21227,106,172,227,27,39934,199,65,134,134,-93,-107,200,4762,633
80,den200d.map,334,200,38939,194,60,139,139,42101,210,98,123,101,-16,38,54,251,481
81,den200d.map,334,200,24029,120,170,213,29,58991,294,8,39,191,-174,-162,336,1060,770
82,den200d.map,334,200,65969,329,30,4,169,40333,201,66,132,133,128,36,164,2193,2053
83,den200d.map,334,200,58985,294,14,39,185,22611,113,188,220,11,181,174,355,688,1346
84,den200d.map,334,200,13053,65,146,268,53,30639,153,160,180,39,-88,14,102,2670,409
85,den200d.map,334,200,38456,192,143,141,56,1645,8,154,325,45,184,11,195,1350,2435
86,den200d.map,334,200,43494,217,105,116,94,51623,258,176,75,23,-41,71,112,14007,1769
87,den200d.map,334,200,35032,175,167,158,32,34826,174,173,159,26,1,6,7,8,8
88,den200d.map,334,200,34440,172,159,161,40,25614,128,185,205,14,44,26,70,151,242
89,den200d.map,334,200,60696,303,103,30,96,47439,237,160,96,39,66,57,123,14007,1769
90,den200d.map,334,200,37080,185,119,148,80,26250,131,149,202,50,54,30,84,1779,787
91,den200d.map,334,200,62244,311,155,22,44,54629,273,170,60,29,38,15,53,14007,1769
92,den200d.map,334,200,39265,196,134,137,65,59910,299,89,34,110,-103,-45,148,462,2280
93,den200d.map,334,200,21640,108,159,225,40,61278,306,121,27,78,-198,-38,236,6052,5114
94,den200d.map,334,200,51385,256,14,77,185,54215,271,184,62,15,-15,170,185,14007,1769
95,den200d.map,334,200,59109,295,90,38,109,61270,306,129,27,70,-11,39,50,51,63
96,den200d.map,334,200,52553,262,46,71,153,25441,127,158,206,41,135,112,247,5668,1036
97,den200d.map,334,200,61724,308,75,25,124,56423,282,176,51,23,26,101,127,14007,1769
98,den200d.map,334,200,6448,32,151,301,48,54167,270,32,63,167,-238,-119,357,2622,6729
99,den200d.map,334,200,49609,248,190,85,9,42326,211,73,122,126,37,-117,154,1769,14007
0,den200n.map,334,199,50737,254,7,79,191,50628,254,116,79,82,0,109,109,208,161
1,den200n.map,334,199,11393,57,148,276,50,55267,277,54,56,144,-220,-94,314,6133,6200
2,den200n.map,334,199,47121,236,41,97,157,20332,102,164,231,34,134,123,257,4296,5417
3,den200n.map,334,199,33267,167,164,166,34,46596,234,168,99,30,-67,4,71,14171,2053
4,den200n.map,334,199,41300,207,91,126,107,51309,257,32,76,166,-50,-59,109,319,229
5,den200n.map,334,199,44800,225,173,108,25,42692,214,92,119,106,11,-81,92,2053,14171
6,den200n.map,334,199,44666,224,108,109,90,33263,167,168,166,30,57,60,117,198,227
7,den200n.map,334,199,50233,252,113,81,85,59590,299,109,34,89,-47,-4,51,395,418
8,den200n.map,334,199,56688,284,26,49,172,30076,151,171,182,27,133,145,278,587,496
9,den200n.map,334,199,46591,234,173,99,25,50383,253,162,80,36,-19,-11,30,270,267
10,den200n.map,334,199,60588,304,106,29,92,61063,306,29,27,169,-2,-77,79,3289,2529
11,den200n.map,334,199,63657,319,22,14,176,64265,322,11,11,187,-3,-11,14,15,15
12,den200n.map,334,199,38708,194,96,139,102,61452,308,38,25,160,-114,-58,172,5018,484
13,den200n.map,334,199,13376,67,155,266,43,52091,261,46,72,152,-194,-109,303,2134,5858
14,den200n.map,334,199,62267,312,19,21,179,49053,246,99,87,99,66,80,146,150,155
15,den200n.map,334,199,22888,115,195,218,3,42883,215,100,118,98,-100,-95,195,881,353
16,den200n.map,334,199,50054,251,93,82,105,61591,309,98,24,100,-58,5,63,83,64
17,den200n.map,334,199,58006,291,101,42,97,48782,245,171,88,27,46,70,116,14171,2053
18,den200n.map,334,199,49889,250,59,83,139,10797,54,147,279,51,196,88,284,5685,2297
19,den200n.map,334,199,17754,89,155,244,43,23301,117,180,216,18,-28,25,53,56,61
20,den200n.map,334,199,32860,165,173,168,25,39902,200,96,133,102,-35,-77,112,121,205
21,den200n.map,334,199,60577,304,117,29,81,48287,242,69,91,129,62,-48,110,160,445
22,den200n.map,334,199,61961,311,126,22,72,57420,288,90,45,108,23,-36,59,99,60
23,den200n.map,334,199,62366,313,119,20,79,55710,279,9,54,189,34,-110,144,1902,2816
24,den200n.map,334,199,51953,261,184,72,14,51365,258,175,75,23,3,-9,12,13,13
25,den200n.map,334,199,49486,248,64,85,134,61190,307,101,26,97,-59,37,96,157,106
26,den200n.map,334,199,51499,258,41,75,157,63565,319,114,14,84,-61,73,134,697,1386
27,den200n.map,334,199,52241,262,95,71,103,43586,219,193,114,5,43,98,141,14171,2053
28,den200n.map,334,199,42894,215,89,118,109,52767,265,166,68,32,-50,77,127,14171,2053
29,den200n.map,334,199,53098,266,34,67,164,61574,309,115,24,83,-43,81,124,1410,1560
30,den200n.map,334,199,50241,252,105,81,93,44182,222,194,111,4,30,89,119,14171,2053
31,den200n.map,334,199,43856,220,122,113,76,44873,225,100,108,98,-5,-22,27,28,43
32,den200n.map,334,199,20762,104,132,229,66,53525,268,5,65,193,-164,-127,291,1862,7879
33,den200n.map,334,199,20136,101,161,232,37,61754,310,134,23,64,-209,-27,236,6528,4995
34,den200n.map,334,199,61978,311,109,22,89,48307,242,49,91,149,69,-60,129,168,346
35,den200n.map,334,199,21514,108,176,225,22,21325,107,166,226,32,1,-10,11,17,12
36,den200n.map,334,199,62576,314,108,19,90,842,4,152,329,46,310,44,354,5698,6284
37,den200n.map,334,199,23906,120,172,213,26,62139,312,147,21,51,-192,-25,217,6402,1572
38,den200n.map,334,199,49918,250,30,83,168,61471,308,19,25,179,-58,-11,69,76,70
39,den200n.map,334,199,62001,311,86,22,112,34863,175,160,158,38,136,74,210,288,609
40,den200n.map,334,199,60480,303,15,30,183,12980,65,153,268,45,238,138,376,8122,2323
41,den200n.map,334,199,55147,277,174,56,24,42124,211,63,122,135,66,-111,177,2053,14171
42,den200n.map,334,199,49138,246,14,87,184,40245,202,151,131,47,44,137,181,4285,3393
43,den200n.map,334,199,1840,9,149,324,49,13181,66,151,267,47,-57,2,59,60,60
44,den200n.map,334,199,23337,117,144,216,54,41923,210,65,123,133,-93,-79,172,1262,3777
45,den200n.map,334,199,48491,243,64,90,134,48910,245,43,88,155,-2,-21,23,24,24
46,den200n.map,334,199,53760,270,168,63,30,51902,260,36,73,162,10,-132,142,2053,14171
47,den200n.map,334,199,56817,285,96,48,102,54341,273,184,60,14,12,88,100,14171,2053
48,den200n.map,334,199,61344,308,146,25,52,31065,156,177,177,21,152,31,183,1497,5704
49,den200n.map,334,199,61549,309,140,24,58,26703,134,161,199,37,175,21,196,4957,6253
50,den200n.map,334,199,61393,308,97,25,101,13381,67,150,266,48,241,53,294,5757,4214
51,den200n.map,334,199,65844,330,24,3,174,37631,189,178,144,20,141,154,295,456,507
52,den200n.map,334,199,48840,245,113,88,85,55941,281,176,52,22,-36,63,99,14171,2053
53,den200n.map,334,199,39136,196,66,137,132,49984,251,163,82,35,-55,97,152,14171,2053
54,den200n.map,334,199,46593,234,171,99,27,48034,241,123,92,75,-7,-48,55,2053,14171
55,den200n.map,334,199,50557,254,187,79,11,36671,184,143,149,55,70,-44,114,2053,14171
56,den200n.map,334,199,4429,22,147,311,51,50430,253,115,80,83,-231,-32,263,3721,3506
57,den200n.map,334,199,41668,209,121,124,77,38740,194,64,139,134,15,-57,72,688,384
58,den200n.map,334,199,49256,247,95,86,103,54102,271,25,62,173,-24,-70,94,95,95
59,den200n.map,334,199,46794,235,169,98,29,33466,168,164,165,34,67,-5,72,2053,14171
60,den200n.map,334,199,39858,200,140,133,58,57108,286,4,47,194,-86,-136,222,553,5499
61,den200n.map,334,199,61280,307,11,26,187,61971,311,116,22,82,-4,105,109,2788,2085
62,den200n.map,334,199,49883,250,65,83,133,22935,115,148,218,50,135,83,218,5418,1381
63,den200n.map,334,199,36471,183,144,150,54,43303,217,78,116,120,-34,-66,100,101,111
64,den200n.map,334,199,38537,193,68,140,130,47686,239,73,94,125,-46,5,51,152,275
65,den200n.map,334,199,61059,306,33,27,165,38331,192,75,141,123,114,42,156,1997,2424
66,den200n.map,334,199,48764,245,189,88,9,56823,285,90,48,108,-40,-99,139,2053,14171
67,den200n.map,334,199,51504,258,36,75,162,50697,254,47,79,151,4,11,15,16,16
68,den200n.map,334,199,57307,287,4,46,194,59207,297,94,36,104,-10,90,100,2642,1422
69,den200n.map,334,199,60093,301,4,32,194,7207,36,155,297,43,265,151,416,8051,2577
70,den200n.map,334,199,23123,116,159,217,39,61879,310,9,23,189,-194,-150,344,1502,8013
71,den200n.map,334,199,44013,221,164,112,34,35870,180,148,153,50,41,-16,57,2053,14171
72,den200n.map,334,199,59978,301,119,32,79,51574,259,165,74,33,42,46,88,14171,2053
73,den200n.map,334,199,40124,201,73,132,125,43854,220,124,113,74,-19,51,70,161,1318
74,den200n.map,334,199,21949,110,139,223,59,38462,193,143,140,55,-83,4,87,1327,1522
75,den200n.map,334,199,44307,222,69,111,129,43486,218,94,115,104,4,25,29,79,45
76,den200n.map,334,199,61410,308,80,25,118,49767,250,181,83,17,58,101,159,14171,2053
77,den200n.map,334,199,52148,262,188,71,10,42911,215,72,118,126,47,-116,163,2053,14171
78,den200n.map,334,199,11788,59,151,274,47,22742,114,142,219,56,-55,-9,64,67,65
79,den200n.map,334,199,23341,117,140,216,58,41126,206,66,127,132,-89,-74,163,3155,3861
80,den200n.map,334,199,63652,319,27,14,171,42894,215,89,118,109,104,62,166,537,2038
81,den200n.map,334,199,58489,293,16,40,182,58093,291,14,42,184,2,-2,4,5,5
82,den200n.map,334,199,25511,128,159,205,39,48239,242,117,91,81,-114,-42,156,2115,2386
83,den200n.map,334,199,37040,186,172,147,26,38230,192,176,141,22,-6,4,10,11,11
84,den200n.map,334,199,62963,316,119,17,79,55683,279,36,54,162,37,-83,120,1875,2017
85,den200n.map,334,199,56625,284,89,49,109,27470,138,190,195,8,146,101,247,405,593
86,den200n.map,334,199,63161,317,120,16,78,45257,227,114,106,84,90,-6,96,983,1123
87,den200n.map,334,199,36652,184,162,149,36,49853,250,95,83,103,-66,-67,133,166,134
88,den200n.map,334,199,37636,189,173,144,25,62775,315,108,18,90,-126,-65,191,2991,1361
89,den200n.map,334,199,47378,238,182,95,16,23534,118,146,215,52,120,-36,156,2053,14171
90,den200n.map,334,199,37656,189,153,144,45,61764,310,124,23,74,-121,-29,150,3070,1327
91,den200n.map,334,199,53091,266,41,67,157,13980,70,148,263,50,196,107,303,6508,2156
92,den200n.map,334,199,59827,300,71,33,127,17365,87,146,246,52,213,75,288,6218,6289
93,den200n.map,334,199,53307,267,24,66,174,36303,182,113,151,85,85,89,174,337,386
94,den200n.map,334,199,30259,152,187,181,11,36663,184,151,149,47,-32,-36,68,121,1052
95,den200n.map,334,199,36483,183,132,150,66,41839,210,149,123,49,-27,17,44,45,45
96,den200n.map,334,199,47258,237,103,96,95,56692,284,22,49,176,-47,-81,128,131,272
97,den200n.map,334,199,38842,195,161,138,37,27293,137,168,196,30,58,7,65,331,122
98,den200n.map,334,199,45393,228,177,105,21,36102,181,115,152,83,47,-62,109,2053,14171
99,den200n.map,334,199,35057,176,165,157,33,50946,256,196,77,2,-80,31,111,14171,2053
0,den201d.map,33,32,657,20,14,12,17,822,25,9,7,22,-5,-5,10,11,11
1,den201d.map,33,32,288,9,31,23,0,433,13,14,19,17,-4,-17,21,22,40
2,den201d.map,33,32,594,18,13,14,18,765,23,2,9,29,-5,-11,16,17,19
3,den201d.map,33,32,656,20,15,12,16,491,15,20,17,11,5,5,10,11,11
4,den201d.map,33,32,171,5,20,27,11,925,28,2,4,29,-23,-18,41,47,44
5,den201d.map,33,32,132,4,27,28,4,759,23,8,9,23,-19,-19,38,44,39
6,den201d.map,33,32,720,22,15,10,16,646,20,25,12,6,2,10,12,13,13
7,den201d.map,33,32,50,1,13,31,18,421,13,26,19,5,-12,13,25,62,28
8,den201d.map,33,32,489,15,22,17,9,918,28,9,4,22,-13,-13,26,27,27
9,den201d.map,33,32,261,8,26,24,5,861,26,2,6,29,-18,-24,42,47,277
10,den201d.map,33,32,257,8,30,24,1,949,29,10,3,21,-21,-20,41,43,75
11,den201d.map,33,32,224,7,31,25,0,617,19,22,13,9,-12,-9,21,25,22
12,den201d.map,33,32,580,18,27,14,4,742,23,25,9,6,-5,-2,7,8,8
13,den201d.map,33,32,108,3,19,29,12,678,21,25,11,6,-18,6,24,48,25
14,den201d.map,33,32,435,13,12,19,19,20,0,11,32,20,13,-1,14,23,19
15,den201d.map,33,32,275,8,12,24,19,518,16,25,16,6,-8,13,21,23,22
16,den201d.map,33,32,610,19,29,13,2,461,14,18,18,13,5,-11,16,17,17
17,den201d.map,33,32,659,20,12,12,19,718,22,17,10,14,-2,5,7,8,8
18,den201d.map,33,32,139,4,20,28,11,335,10,16,22,15,-6,-4,10,11,11
19,den201d.map,33,32,425,13,22,19,9,677,21,26,11,5,-8,4,12,13,13
20,den201d.map,33,32,796,24,3,8,28,991,30,0,2,31,-6,-3,9,10,10
21,den201d.map,33,32,337,10,14,22,17,481,15,30,17,1,-5,16,21,22,32
22,den201d.map,33,32,483,15,28,17,3,468,14,11,18,20,1,-17,18,19,19
23,den201d.map,33,32,849,26,14,6,17,457,14,22,18,9,12,8,20,21,21
24,den201d.map,33,32,402,12,13,20,18,130,4,29,28,2,8,16,24,25,25
25,den201d.map,33,32,990,30,1,2,30,622,19,17,13,14,11,16,27,32,28
26,den201d.map,33,32,129,4,30,28,1,550,17,25,15,6,-13,-5,18,28,19
27,den201d.map,33,32,50,1,13,31,18,855,26,8,6,23,-25,-5,30,41,31
28,den201d.map,33,32,195,6,28,26,3,660,20,11,12,20,-14,-17,31,37,85
29,den201d.map,33,32,304,9,15,23,16,484,15,27,17,4,-6,12,18,19,24
30,den201d.map,33,32,239,7,16,25,15,527,16,16,16,15,-9,0,9,10,10
31,den201d.map,33,32,550,17,25,15,6,335,10,16,22,15,7,-9,16,17,17
32,den201d.map,33,32,677,21,26,11,5,815,25,16,7,15,-4,-10,14,23,21
33,den201d.map,33,32,891,27,4,5,27,301,9,18,23,13,18,14,32,33,36
34,den201d.map,33,32,887,27,8,5,23,207,6,16,26,15,21,8,29,30,35
35,den201d.map,33,32,530,16,13,16,18,990,30,1,2,30,-14,-12,26,27,31
36,den201d.map,33,32,465,14,14,18,17,371,11,12,21,19,3,-2,5,6,6
37,den201d.map,33,32,402,12,13,20,18,955,29,4,3,27,-17,-9,26,27,27
38,den201d.map,33,32,707,22,28,10,3,766,23,1,9,30,-1,-27,28,42,76
39,den201d.map,33,32,657,20,14,12,17,622,19,17,13,14,1,3,4,5,5
40,den201d.map,33,32,649,20,22,12,9,494,15,17,17,14,5,-5,10,11,11
41,den201d.map,33,32,816,25,15,7,16,719,22,16,10,15,3,1,4,5,5
42,den201d.map,33,32,205,6,18,26,13,1015,31,8,1,23,-25,-10,35,41,36
43,den201d.map,33,32,40,1,23,31,8,106,3,21,29,10,-2,-2,4,5,5
44,den201d.map,33,32,880,27,15,5,16,244,7,11,25,20,20,-4,24,25,25
45,den201d.map,33,32,43,1,20,31,11,623,19,16,13,15,-18,-4,22,23,23
46,den201d.map,33,32,880,27,15,5,16,512,16,31,16,0,11,16,27,28,28
47,den201d.map,33,32,177,5,14,27,17,989,30,2,2,29,-25,-12,37,43,40
48,den201d.map,33,32,755,23,12,9,19,958,29,1,3,30,-6,-11,17,18,18
49,den201d.map,33,32,138,4,21,28,10,763,23,4,9,27,-19,-17,36,42,37
50,den201d.map,33,32,74,2,21,30,10,453,14,26,18,5,-12,5,17,33,39
51,den201d.map,33,32,576,18,31,14,0,105,3,22,29,9,15,-9,24,25,25
52,den201d.map,33,32,145,4,14,28,17,847,26,16,6,15,-22,2,24,25,25
53,den201d.map,33,32,435,13,12,19,19,590,18,17,14,14,-5,5,10,11,11
54,den201d.map,33,32,612,19,27,13,4,533,16,10,16,21,3,-17,20,21,21
55,den201d.map,33,32,238,7,17,25,14,519,16,24,16,7,-9,7,16,20,17
56,den201d.map,33,32,689,21,14,11,17,462,14,17,18,14,7,3,10,11,11
57,den201d.map,33,32,235,7,20,25,11,206,6,17,26,14,1,-3,4,5,5
58,den201d.map,33,32,225,7,30,25,1,586,18,21,14,10,-11,-9,20,24,21
59,den201d.map,33,32,9,0,22,32,9,332,10,19,22,12,-10,-3,13,14,14
60,den201d.map,33,32,984,30,7,2,24,522,16,21,16,10,14,14,28,29,29
61,den201d.map,33,32,105,3,22,29,9,953,29,6,3,25,-26,-16,42,49,43
62,den201d.map,33,32,337,10,14,22,17,486,15,25,17,6,-5,11,16,17,17
63,den201d.map,33,32,500,15,11,17,20,734,22,1,10,30,-7,-10,17,30,23
64,den201d.map,33,32,658,20,13,12,18,710,22,25,10,6,-2,12,14,15,15
65,den201d.map,33,32,795,24,4,8,27,579,18,28,14,3,6,24,30,31,31
66,den201d.map,33,32,923,28,4,4,27,919,28,8,4,23,0,4,4,5,5
67,den201d.map,33,32,520,16,23,16,8,19,0,12,32,19,16,-11,27,30,53
68,den201d.map,33,32,401,12,14,20,17,710,22,25,10,6,-10,11,21,22,22
69,den201d.map,33,32,626,19,13,13,18,733,22,2,10,29,-3,-11,14,29,20
70,den201d.map,33,32,394,12,21,20,10,595,18,12,14,19,-6,-9,15,16,16
71,den201d.map,33,32,322,10,29,22,2,420,13,27,19,4,-3,-2,5,6,6
72,den201d.map,33,32,372,11,11,21,20,743,23,24,9,7,-12,13,25,26,26
73,den201d.map,33,32,692,21,11,11,20,949,29,10,3,21,-8,-1,9,10,10
74,den201d.map,33,32,336,10,15,22,16,177,5,14,27,17,5,-1,6,7,7
75,den201d.map,33,32,517,16,26,16,5,959,29,0,3,31,-13,-26,39,40,46
76,den201d.map,33,32,988,30,3,2,28,767,23,0,9,31,7,-3,10,11,11
77,den201d.map,33,32,893,27,2,5,29,46,1,17,31,14,26,15,41,44,52
78,den201d.map,33,32,824,25,7,7,24,305,9,14,23,17,16,7,23,24,27
79,den201d.map,33,32,73,2,22,30,9,522,16,21,16,10,-14,-1,15,34,37
80,den201d.map,33,32,273,8,14,24,17,47,1,16,31,15,7,2,9,10,10
81,den201d.map,33,32,337,10,14,22,17,107,3,20,29,11,7,6,13,14,14
82,den201d.map,33,32,577,18,30,14,1,619,19,20,13,11,-1,-10,11,12,12
83,den201d.map,33,32,948,29,11,3,20,927,28,0,4,31,1,-11,12,13,13
84,den201d.map,33,32,578,18,29,14,2,431,13,16,19,15,5,-13,18,19,19
85,den201d.map,33,32,514,16,29,16,2,741,23,26,9,5,-7,-3,10,11,11
86,den201d.map,33,32,521,16,22,16,9,398,12,17,20,14,4,-5,9,10,10
87,den201d.map,33,32,50,1,13,31,18,308,9,11,23,20,-8,-2,10,16,11
88,den201d.map,33,32,304,9,15,23,16,689,21,14,11,17,-12,-1,13,14,14
89,den201d.map,33,32,323,10,28,22,3,20,0,11,32,20,10,-17,27,32,28
90,den201d.map,33,32,467,14,12,18,19,852,26,11,6,20,-12,-1,13,14,14
91,den201d.map,33,32,75,2,20,30,11,788,24,11,8,20,-22,-9,31,40,32
92,den201d.map,33,32,656,20,15,12,16,50,1,13,31,18,19,-2,21,22,22
93,den201d.map,33,32,129,4,30,28,1,209,6,14,26,17,-2,-16,18,19,19
94,den201d.map,33,32,817,25,14,7,17,325,10,26,22,5,15,12,27,40,28
95,den201d.map,33,32,416,13,31,19,0,565,17,10,15,21,-4,-21,25,26,26
96,den201d.map,33,32,586,18,21,14,10,827,25,4,7,27,-7,-17,24,25,25
97,den201d.map,33,32,178,5,13,27,18,830,25,1,7,30,-20,-12,32,38,37
98,den201d.map,33,32,136,4,23,28,8,559,17,16,15,15,-13,-7,20,21,21
99,den201d.map,33,32,178,5,13,27,18,235,7,20,25,11,-2,7,9,10,10
0,den202d.map,33,32,886,27,9,5,22,695,21,8,11,23,6,-1,7,8,8
1,den202d.map,33,32,787,24,12,8,19,310,9,9,23,22,15,-3,18,20,35
2,den202d.map,33,32,786,24,13,8,18,123,3,4,29,27,21,-9,30,139,77
3,den202d.map,33,32,56,1,7,31,24,659,20,12,12,19,-19,5,24,76,178
4,den202d.map,33,32,668,20,3,12,28,814,25,17,7,14,-5,14,19,20,20
5,den202d.map,33,32,840,26,23,6,8,437,13,10,19,21,13,-13,26,27,27
6,den202d.map,33,32,856,26,7,6,24,847,26,16,6,15,0,9,9,10,10
7,den202d.map,33,32,408,12,7,20,24,741,23,26,9,5,-11,19,30,34,31
8,den202d.map,33,32,843,26,20,6,11,755,23,12,9,19,3,-8,11,12,12
9,den202d.map,33,32,952,29,7,3,24,326,10,25,22,6,19,18,37,38,38
10,den202d.map,33,32,913,28,14,4,17,667,20,4,12,27,8,-10,18,19,19
11,den202d.map,33,32,881,27,14,5,17,527,16,16,16,15,11,2,13,14,14
12,den202d.map,33,32,618,19,21,13,10,437,13,10,19,21,6,-11,17,18,18
13,den202d.map,33,32,628,19,11,13,20,556,17,19,15,12,2,8,10,11,11
14,den202d.map,33,32,345,10,6,22,25,842,26,21,6,10,-16,15,31,32,32
15,den202d.map,33,32,714,22,21,10,10,882,27,13,5,18,-5,-8,13,14,14
16,den202d.map,33,32,788,24,11,8,20,614,19,25,13,6,5,14,19,20,20
17,den202d.map,33,32,929,29,30,3,1,809,25,22,7,9,4,-8,12,13,13
18,den202d.map,33,32,89,2,6,30,25,524,16,19,16,12,-14,13,27,60,188
19,den202d.map,33,32,910,28,17,4,14,847,26,16,6,15,2,-1,3,4,4
20,den202d.map,33,32,456,14,23,18,8,853,26,10,6,21,-12,-13,25,27,26
21,den202d.map,33,32,772,24,27,8,4,477,14,2,18,29,10,-25,35,78,37
22,den202d.map,33,32,865,27,30,5,1,91,2,4,30,27,25,-26,51,440,92
23,den202d.map,33,32,761,23,6,9,25,758,23,9,9,22,0,3,3,4,4
24,den202d.map,33,32,660,20,11,12,20,919,28,8,4,23,-8,-3,11,12,12
25,den202d.map,33,32,115,3,12,29,19,655,20,16,12,15,-17,4,21,61,381
26,den202d.map,33,32,865,27,30,5,1,469,14,10,18,21,13,-20,33,225,37
27,den202d.map,33,32,681,21,22,11,9,774,24,25,8,6,-3,3,6,7,7
28,den202d.map,33,32,24,0,7,32,24,313,9,6,23,25,-9,-1,10,30,32
29,den202d.map,33,32,752,23,15,9,16,365,11,18,21,13,12,3,15,16,16
30,den202d.map,33,32,275,8,12,24,19,815,25,16,7,15,-17,4,21,22,22
31,den202d.map,33,32,747,23,20,9,11,157,4,2,28,29,19,-18,37,42,38
32,den202d.map,33,32,804,25,27,7,4,391,12,24,20,7,13,-3,16,30,24
33,den202d.map,33,32,794,24,5,8,26,623,19,16,13,15,5,11,16,17,17
34,den202d.map,33,32,204,6,19,26,12,855,26,8,6,23,-20,-11,31,32,32
35,den202d.map,33,32,302,9,17,23,14,431,13,16,19,15,-4,-1,5,6,6
36,den202d.map,33,32,569,17,6,15,25,850,26,13,6,18,-9,7,16,17,19
37,den202d.map,33,32,829,25,2,7,29,773,24,26,8,5,1,24,25,26,26
38,den202d.map,33,32,880,27,15,5,16,222,6,1,26,30,21,-14,35,36,36
39,den202d.map,33,32,746,23,21,9,10,287,8,0,24,31,15,-21,36,37,37
40,den202d.map,33,32,489,15,22,17,9,838,26,25,6,6,-11,3,14,16,15
41,den202d.map,33,32,795,24,4,8,27,685,21,18,11,13,3,14,17,18,18
42,den202d.map,33,32,793,24,6,8,25,775,24,24,8,7,0,18,18,19,19
43,den202d.map,33,32,276,8,11,24,20,309,9,10,23,21,-1,-1,2,3,3
44,den202d.map,33,32,849,26,14,6,17,404,12,11,20,20,14,-3,17,50,23
45,den202d.map,33,32,771,24,28,8,3,380,11,3,21,28,13,-25,38,39,45
46,den202d.map,33,32,848,26,15,6,16,795,24,4,8,27,2,-11,13,14,14
47,den202d.map,33,32,114,3,13,29,18,796,24,3,8,28,-21,-10,31,35,181
48,den202d.map,33,32,328,10,23,22,8,265,8,22,24,9,2,-1,3,4,4
49,den202d.map,33,32,120,3,7,29,24,53,1,10,31,21,2,3,5,6,6
50,den202d.map,33,32,620,19,19,13,12,534,16,9,16,22,3,-10,13,28,14
51,den202d.map,33,32,203,6,20,26,11,159,4,0,28,31,2,-20,22,29,57
52,den202d.map,33,32,796,24,3,8,28,263,8,24,24,7,16,21,37,38,48
53,den202d.map,33,32,168,5,23,27,8,325,10,26,22,5,-5,3,8,9,9
54,den202d.map,33,32,189,5,2,27,29,567,17,8,15,23,-12,6,18,19,19
55,den202d.map,33,32,808,25,23,7,8,333,10,18,22,13,15,-5,20,21,21
56,den202d.map,33,32,443,13,4,19,27,87,2,8,30,23,11,4,15,46,22
57,den202d.map,33,32,715,22,20,10,11,85,2,10,30,21,20,-10,30,434,67
58,den202d.map,33,32,317,9,2,23,29,270,8,17,24,14,1,15,16,17,17
59,den202d.map,33,32,994,31,29,1,2,588,18,19,14,12,13,-10,23,24,24
60,den202d.map,33,32,339,10,12,22,19,567,17,8,15,23,-7,-4,11,12,12
61,den202d.map,33,32,729,22,6,10,25,252,7,3,25,28,15,-3,18,19,19
62,den202d.map,33,32,688,21,15,11,16,717,22,18,10,13,-1,3,4,5,5
63,den202d.map,33,32,653,20,18,12,13,918,28,9,4,22,-8,-9,17,18,18
64,den202d.map,33,32,856,26,7,6,24,190,5,1,27,30,21,-6,27,28,28
65,den202d.map,33,32,123,3,4,29,27,53,1,10,31,21,2,6,8,9,9
66,den202d.map,33,32,413,12,2,20,29,726,22,9,10,22,-10,7,17,18,18
67,den202d.map,33,32,560,17,15,15,16,534,16,9,16,22,1,-6,7,12,11
68,den202d.map,33,32,582,18,25,14,6,646,20,25,12,6,-2,0,2,3,3
69,den202d.map,33,32,331,10,20,22,11,414,12,1,20,30,-2,-19,21,22,22
70,den202d.map,33,32,858,26,5,6,26,525,16,18,16,13,10,13,23,34,24
71,den202d.map,33,32,254,7,1,25,30,279,8,8,24,23,-1,7,8,9,9
72,den202d.map,33,32,439,13,8,19,23,879,27,16,5,15,-14,8,22,23,23
73,den202d.map,33,32,624,19,15,13,16,380,11,3,21,28,8,-12,20,21,21
74,den202d.map,33,32,869,27,26,5,5,117,3,10,29,21,24,-16,40,507,91
75,den202d.map,33,32,603,18,4,14,27,907,28,20,4,11,-10,16,26,27,27
76,den202d.map,33,32,896,28,31,4,0,268,8,19,24,12,20,-12,32,33,47
77,den202d.map,33,32,490,15,21,17,10,741,23,26,9,5,-8,5,13,15,14
78,den202d.map,33,32,786,24,13,8,18,477,14,2,18,29,10,-11,21,24,23
79,den202d.map,33,32,793,24,6,8,25,474,14,5,18,26,10,-1,11,12,12
80,den202d.map,33,32,188,5,3,27,28,839,26,24,6,7,-21,21,42,49,54
81,den202d.map,33,32,370,11,13,21,18,699,21,4,11,27,-10,-9,19,20,20
82,den202d.map,33,32,843,26,20,6,11,508,15,3,17,28,11,-17,28,51,29
83,den202d.map,33,32,914,28,13,4,18,754,23,13,9,18,5,0,5,6,6
84,den202d.map,33,32,665,20,6,12,25,881,27,14,5,17,-7,8,15,16,16
85,den202d.map,33,32,434,13,13,19,18,630,19,9,13,22,-6,-4,10,11,11
86,den202d.map,33,32,348,10,3,22,28,902,28,25,4,6,-18,22,40,48,41
87,den202d.map,33,32,818,25,13,7,18,335,10,16,22,15,15,3,18,19,28
88,den202d.map,33,32,437,13,10,19,21,350,10,1,22,30,3,-9,12,13,13
89,den202d.map,33,32,865,27,30,5,1,556,17,19,15,12,10,-11,21,22,22
90,den202d.map,33,32,900,28,27,4,4,158,4,1,28,30,24,-26,50,62,65
91,den202d.map,33,32,276,8,11,24,20,284,8,3,24,28,0,-8,8,9,9
92,den202d.map,33,32,326,10,25,22,6,159,4,0,28,31,6,-25,31,46,32
93,den202d.map,33,32,666,20,5,12,26,756,23,11,9,20,-3,6,9,10,10
94,den202d.map,33,32,325,10,26,22,5,653,20,18,12,13,-10,-8,18,19,19
95,den202d.map,33,32,827,25,4,7,27,919,28,8,4,23,-3,4,7,8,8
96,den202d.map,33,32,794,24,5,8,26,813,25,18,7,13,-1,13,14,15,15
97,den202d.map,33,32,403,12,12,20,19,838,26,25,6,6,-14,13,27,31,28
98,den202d.map,33,32,860,26,3,6,28,478,14,1,18,30,12,-2,14,20,20
99,den202d.map,33,32,331,10,20,22,11,717,22,18,10,13,-12,-2,14,15,15
0,den203d.map,76,89,3012,33,13,42,75,6021,67,30,8,58,-34,17,51,361,625
1,den203d.map,76,89,2840,31,7,44,81,2204,24,20,51,68,7,13,20,21,21
2,den203d.map,76,89,1953,21,4,54,84,2833,31,14,44,74,-10,10,20,21,21
3,den203d.map,76,89,4190,47,81,28,7,3167,35,36,40,52,12,-45,57,346,362
4,den203d.map,76,89,4930,55,53,20,35,3564,40,84,35,4,15,31,46,156,270
5,den203d.map,76,89,4112,46,70,29,18,1574,17,27,58,61,29,-43,72,715,464
6,den203d.map,76,89,2662,29,7,46,81,5670,63,25,12,63,-34,18,52,417,416
7,den203d.map,76,89,4850,54,44,21,44,3451,38,19,37,69,16,-25,41,1489,797
8,den203d.map,76,89,3506,39,53,36,35,3244,36,48,39,40,3,-5,8,9,9
9,den203d.map,76,89,3881,43,34,32,54,2044,22,2,53,86,21,-32,53,324,403
10,den203d.map,76,89,2765,31,82,44,6,3878,43,37,32,51,-12,-45,57,60,294
11,den203d.map,76,89,3276,36,16,39,72,4509,50,29,25,59,-14,13,27,323,616
12,den203d.map,76,89,2440,27,51,48,37,2129,23,6,52,82,4,-45,49,789,693
13,den203d.map,76,89,739,8,61,67,27,5031,56,41,19,47,-48,-20,68,144,69
14,den203d.map,76,89,1642,18,48,57,40,2133,23,2,52,86,-5,-46,51,801,732
15,den203d.map,76,89,2552,28,28,47,60,5919,66,43,9,45,-38,15,53,459,505
16,den203d.map,76,89,4061,45,32,30,56,3965,44,39,31,49,1,7,8,9,9
17,den203d.map,76,89,2266,25,47,50,41,5402,60,26,15,62,-35,-21,56,184,147
18,den203d.map,76,89,2558,28,22,47,66,4135,46,47,29,41,-18,25,43,297,1098
19,den203d.map,76,89,2666,29,3,46,85,1485,16,27,59,61,13,24,37,208,143
20,den203d.map,76,89,3865,43,50,32,38,2501,28,79,47,9,15,29,44,86,45
21,den203d.map,76,89,1051,11,16,64,72,6461,72,35,3,53,-61,19,80,991,625
22,den203d.map,76,89,3752,42,74,33,14,5926,66,36,9,52,-24,-38,62,233,570
23,den203d.map,76,89,2012,22,34,53,54,2380,26,22,49,66,-4,-12,16,825,821
24,den203d.map,76,89,1137,12,19,63,69,5110,57,51,18,37,-45,32,77,78,304
25,den203d.map,76,89,2818,31,29,44,59,2251,25,62,50,26,6,33,39,362,320
26,den203d.map,76,89,3747,42,79,33,9,3710,41,27,34,61,1,-52,53,233,293
27,den203d.map,76,89,3272,36,20,39,68,2493,28,87,47,1,8,67,75,881,1867
28,den203d.map,76,89,3953,44,51,31,37,3013,33,12,42,76,11,-39,50,1256,359
29,den203d.map,76,89,6189,69,40,6,48,1629,18,61,57,27,51,21,72,73,151
30,den203d.map,76,89,2667,29,2,46,86,2443,27,48,48,40,2,46,48,690,916
31,den203d.map,76,89,6102,68,38,7,50,3487,39,72,36,16,29,34,63,429,181
32,den203d.map,76,89,6186,69,43,6,45,4868,54,26,21,62,15,-17,32,456,346
33,den203d.map,76,89,4330,48,30,27,58,3654,41,83,34,5,7,53,60,276,213
34,den203d.map,76,89,1761,19,18,56,70,2030,22,16,53,72,-3,-2,5,6,6
35,den203d.map,76,89,5196,58,54,17,34,4582,51,45,24,43,7,-9,16,17,17
36,den203d.map,76,89,6185,69,44,6,44,5290,59,49,16,39,10,5,15,16,16
37,den203d.map,76,89,1621,18,69,57,19,3166,35,37,40,51,-17,-32,49,304,552
38,den203d.map,76,89,4777,53,28,22,60,3965,44,39,31,49,9,11,20,21,21
39,den203d.map,76,89,5998,67,53,8,35,1047,11,20,64,68,56,-33,89,317,94
40,den203d.map,76,89,2300,25,13,50,75,2919,32,17,43,71,-7,4,11,12,12
41,den203d.map,76,89,5034,56,38,19,50,3620,40,28,35,60,16,-10,26,261,395
42,den203d.map,76,89,2752,30,6,45,82,2493,28,87,47,1,2,81,83,887,1748
43,den203d.map,76,89,2997,33,28,42,60,1063,11,4,64,84,22,-24,46,47,47
44,den203d.map,76,89,3888,43,27,32,61,2751,30,7,45,81,13,-20,33,358,393
45,den203d.map,76,89,5568,62,38,13,50,5044,56,28,19,60,6,-10,16,449,341
46,den203d.map,76,89,3153,35,50,40,38,3052,34,62,41,26,1,12,13,243,275
47,den203d.map,76,89,4101,46,81,29,7,1485,16,27,59,61,30,-54,84,977,480
48,den203d.map,76,89,2889,32,47,43,41,961,10,17,65,71,22,-30,52,468,550
49,den203d.map,76,89,1243,13,2,62,86,2509,28,71,47,17,-15,69,84,820,868
50,den203d.map,76,89,1860,20,8,55,80,3030,34,84,41,4,-14,76,90,856,1517
51,den203d.map,76,89,1786,20,82,55,6,294,3,61,72,27,17,-21,38,388,310
52,den203d.map,76,89,3041,34,73,41,15,2572,28,8,47,80,6,-65,71,1823,740
53,den203d.map,76,89,2090,23,45,52,43,3660,41,77,34,11,-18,32,50,404,515
54,den203d.map,76,89,1649,18,41,57,47,5047,56,25,19,63,-38,-16,54,242,441
55,den203d.map,76,89,2921,32,15,43,73,2073,23,62,52,26,9,47,56,906,1699
56,den203d.map,76,89,2652,29,17,46,71,5381,60,47,15,41,-31,30,61,771,1364
57,den203d.map,76,89,3185,35,18,40,70,1153,12,3,63,85,23,-15,38,216,84
58,den203d.map,76,89,3955,44,49,31,39,1939,21,18,54,70,23,-31,54,697,295
59,den203d.map,76,89,5730,64,54,11,34,5925,66,37,9,51,-2,-17,19,20,25
60,den203d.map,76,89,3432,38,38,37,50,4675,52,41,23,47,-14,3,17,236,152
61,den203d.map,76,89,1932,21,25,54,63,3924,44,80,31,8,-23,55,78,438,887
62,den203d.map,76,89,1641,18,49,57,39,3010,33,15,42,73,-15,-34,49,1018,733
63,den203d.map,76,89,3169,35,34,40,54,3789,42,37,33,51,-7,3,10,81,84
64,den203d.map,76,89,3509,39,50,36,38,4765,53,40,22,48,-14,-10,24,240,247
65,den203d.map,76,89,4496,50,42,25,46,2139,24,85,51,3,26,43,69,141,115
66,den203d.map,76,89,2651,29,18,46,70,2535,28,45,47,43,1,27,28,680,870
67,den203d.map,76,89,2251,25,62,50,26,2381,26,21,49,67,-1,-41,42,1512,864
68,den203d.map,76,89,2635,29,34,46,54,2503,28,77,47,11,1,43,44,502,491
69,den203d.map,76,89,1941,21,16,54,72,3966,44,38,31,50,-23,22,45,299,508
70,den203d.map,76,89,3521,39,38,36,50,1051,11,16,64,72,28,-22,50,358,637
71,den203d.map,76,89,5400,60,28,15,60,4668,52,48,23,40,8,20,28,206,401
72,den203d.map,76,89,6193,69,36,6,52,290,3,65,72,23,66,29,95,96,222
73,den203d.map,76,89,3547,39,12,36,76,3255,36,37,39,51,3,25,28,738,1194
74,den203d.map,76,89,3841,43,74,32,14,5289,59,50,16,38,-16,-24,40,133,273
75,den203d.map,76,89,2305,25,8,50,80,3453,38,17,37,71,-13,9,22,23,23
76,den203d.map,76,89,2780,31,67,44,21,2997,33,28,42,60,-2,-39,41,355,291
77,den203d.map,76,89,2088,23,47,52,41,3063,34,51,41,37,-11,4,15,16,16
78,den203d.map,76,89,952,10,26,65,62,2885,32,51,43,37,-22,25,47,394,467
79,den203d.map,76,89,4040,45,53,30,35,974,10,4,65,84,35,-49,84,313,85
80,den203d.map,76,89,2363,26,39,49,49,3062,34,52,41,36,-8,13,21,22,22
81,den203d.map,76,89,2453,27,38,48,50,383,4,61,71,27,23,23,46,464,298
82,den203d.map,76,89,2512,28,68,47,20,2894,32,42,43,46,-4,-26,30,294,435
83,den203d.map,76,89,2601,29,68,46,20,4330,48,30,27,58,-19,-38,57,58,223
84,den203d.map,76,89,2268,25,45,50,43,5557,62,49,13,39,-37,4,41,206,177
85,den203d.map,76,89,5109,57,52,18,36,1967,22,79,53,9,35,27,62,439,70
86,den203d.map,76,89,3178,35,25,40,63,2375,26,27,49,61,9,2,11,12,12
87,den203d.map,76,89,1936,21,21,54,67,961,10,17,65,71,11,-4,15,16,21
88,den203d.map,76,89,2684,30,74,45,14,1839,20,29,55,59,10,-45,55,784,374
89,den203d.map,76,89,2978,33,47,42,41,3351,37,30,38,58,-4,-17,21,230,99
90,den203d.map,76,89,3400,38,70,37,18,5224,58,26,17,62,-20,-44,64,111,310
91,den203d.map,76,89,741,8,59,67,29,1823,20,45,55,43,-12,-14,26,301,433
92,den203d.map,76,89,1066,11,1,64,87,4139,46,43,29,45,-35,42,77,78,275
93,den203d.map,76,89,3874,43,41,32,47,740,8,60,67,28,35,19,54,280,80
94,den203d.map,76,89,5027,56,45,19,43,2868,32,68,43,20,24,23,47,69,78
95,den203d.map,76,89,922,10,56,65,32,3006,33,19,42,69,-23,-37,60,1652,1116
96,den203d.map,76,89,3419,38,51,37,37,2654,29,15,46,73,9,-36,45,877,600
97,den203d.map,76,89,2261,25,52,50,36,735,8,65,67,23,17,13,30,439,533
98,den203d.map,76,89,2440,27,51,48,37,6372,71,35,4,53,-44,-16,60,585,526
99,den203d.map,76,89,5393,60,35,15,53,1414,15,9,60,79,45,-26,71,809,982
0,den204d.map,64,62,1368,22,57,41,4,699,11,44,52,17,11,-13,24,28,25
1,den204d.map,64,62,1970,31,13,32,48,2333,37,22,26,39,-6,9,15,16,16
2,den204d.map,64,62,2181,35,50,28,11,2022,32,23,31,38,3,-27,30,39,31
3,den204d.map,64,62,1321,21,42,42,19,2172,35,59,28,2,-14,17,31,32,32
4,den204d.map,64,62,955,15,36,48,25,2726,43,1,20,60,-28,-35,63,74,157
5,den204d.map,64,62,3297,53,50,10,11,1194,19,45,44,16,34,-5,39,40,106
6,den204d.map,64,62,2065,33,42,30,19,2741,44,48,19,13,-11,6,17,24,18
7,den204d.map,64,62,3368,54,41,9,20,3131,50,30,13,31,4,-11,15,16,16
8,den204d.map,64,62,3795,61,48,2,13,1247,20,54,43,7,41,6,47,172,149
9,den204d.map,64,62,1721,27,14,36,47,1895,30,26,33,35,-3,12,15,16,16
10,den204d.map,64,62,2994,48,43,15,18,2788,44,1,19,60,4,-42,46,47,47
11,den204d.map,64,62,3362,54,47,9,14,2821,45,30,18,31,9,-17,26,27,27
12,den204d.map,64,62,625,10,56,53,5,1178,19,61,44,0,-9,5,14,18,15
13,den204d.map,64,62,1777,28,20,35,41,2150,34,19,29,42,-6,-1,7,8,8
14,den204d.map,64,62,356,5,15,58,46,2182,35,49,28,12,-30,34,64,219,1111
15,den204d.map,64,62,1182,19,57,44,4,3551,57,44,6,17,-38,-13,51,122,52
16,den204d.map,64,62,1593,25,18,38,43,450,7,45,56,16,18,27,45,97,48
17,den204d.map,64,62,2970,47,5,16,56,3484,56,49,7,12,-9,44,53,54,166
18,den204d.map,64,62,1789,28,8,35,53,726,11,17,52,44,17,9,26,27,39
19,den204d.map,64,62,3152,50,9,13,52,694,11,49,52,12,39,40,79,227,80
20,den204d.map,64,62,2273,36,20,27,41,3179,51,44,12,17,-15,24,39,40,40
21,den204d.map,64,62,2998,48,39,15,22,3422,55,49,8,12,-7,10,17,18,18
22,den204d.map,64,62,1904,30,17,33,44,3677,59,42,4,19,-29,25,54,55,67
23,den204d.map,64,62,1136,18,41,45,20,3473,56,60,7,1,-38,19,57,58,58
24,den204d.map,64,62,1868,30,53,33,8,2685,43,42,20,19,-13,-11,24,25,37
25,den204d.map,64,62,1164,18,13,45,48,1037,16,16,47,45,2,3,5,6,6
26,den204d.map,64,62,108,1,15,62,46,1021,16,32,47,29,-15,17,32,393,490
27,den204d.map,64,62,3354,54,55,9,6,1623,26,50,37,11,28,-5,33,34,34
28,den204d.map,64,62,737,11,6,52,55,3178,51,45,12,16,-40,39,79,147,337
29,den204d.map,64,62,1120,18,57,45,4,2473,39,6,24,55,-21,-51,72,73,130
30,den204d.map,64,62,3568,57,27,6,34,2314,37,41,26,20,20,14,34,35,35
31,den204d.map,64,62,3603,58,54,5,7,739,11,4,52,57,47,-50,97,369,249
32,den204d.map,64,62,2618,42,47,21,14,1006,16,47,47,14,26,0,26,30,30
33,den204d.map,64,62,1539,24,10,39,51,2015,32,30,31,31,-8,20,28,29,34
34,den204d.map,64,62,3393,54,16,9,45,3506,56,27,7,34,-2,11,13,14,14
35,den204d.map,64,62,2284,36,9,27,52,3677,59,42,4,19,-23,33,56,57,83
36,den204d.map,64,62,3524,56,9,7,52,2084,33,23,30,38,23,14,37,54,38
37,den204d.map,64,62,3458,55,13,8,48,2708,43,19,20,42,12,6,18,19,27
38,den204d.map,64,62,1139,18,38,45,23,876,14,53,49,8,4,15,19,20,20
39,den204d.map,64,62,2520,40,21,23,40,1009,16,44,47,17,24,23,47,54,48
40,den204d.map,64,62,2316,37,39,26,22,2735,44,54,19,7,-7,15,22,23,23
41,den204d.map,64,62,360,5,11,58,50,2035,32,10,31,51,-27,-1,28,35,52
42,den204d.map,64,62,1395,22,30,41,31,2909,46,4,17,57,-24,-26,50,51,90
43,den204d.map,64,62,426,6,7,57,54,1206,19,33,44,28,-13,26,39,364,203
44,den204d.map,64,62,2666,43,61,20,0,2415,38,2,25,59,5,-59,64,173,65
45,den204d.map,64,62,2689,43,38,20,23,3195,51,28,12,33,-8,-10,18,19,19
46,den204d.map,64,62,3129,50,32,13,29,2793,45,58,18,3,5,26,31,32,32
47,den204d.map,64,62,368,5,3,58,58,1135,18,42,45,19,-13,39,52,428,348
48,den204d.map,64,62,2944,47,31,16,30,3368,54,41,9,20,-7,10,17,18,18
49,den204d.map,64,62,2525,40,16,23,45,871,14,58,49,3,26,42,68,87,77
50,den204d.map,64,62,3321,53,26,10,35,1270,20,31,43,30,33,5,38,39,39
51,den204d.map,64,62,3553,57,42,6,19,1122,18,55,45,6,39,13,52,53,77
52,den204d.map,64,62,2227,35,4,28,57,1372,22,53,41,8,13,49,62,102,63
53,den204d.map,64,62,1053,16,0,47,61,1103,17,12,46,49,-1,12,13,14,14
54,den204d.map,64,62,2426,39,53,24,8,1839,29,20,34,41,10,-33,43,44,89
55,den204d.map,64,62,3059,49,40,14,21,2860,46,53,17,8,3,13,16,17,17
56,den204d.map,64,62,2342,37,13,26,48,2687,43,40,20,21,-6,27,33,34,34
57,den204d.map,64,62,1794,28,3,35,58,2654,42,11,21,50,-14,8,22,23,23
58,den204d.map,64,62,2289,36,4,27,57,492,7,3,56,58,29,-1,30,164,177
59,den204d.map,64,62,1242,20,59,43,2,874,14,55,49,6,6,-4,10,11,11
60,den204d.map,64,62,2050,33,57,30,4,527,8,30,55,31,25,-27,52,98,53
61,den204d.map,64,62,1385,22,40,41,21,2623,42,42,21,19,-20,2,22,31,23
62,den204d.map,64,62,744,12,61,51,0,2616,42,49,21,12,-30,-12,42,183,43
63,den204d.map,64,62,1457,23,30,40,31,2228,35,3,28,58,-12,-27,39,40,70
64,den204d.map,64,62,649,10,32,53,29,2870,46,43,17,18,-36,11,47,82,49
65,den204d.map,64,62,1378,22,47,41,14,2974,47,1,16,60,-25,-46,71,82,111
66,den204d.map,64,62,3242,52,43,11,18,3251,52,34,11,27,0,-9,9,10,10
67,den204d.map,64,62,1084,17,31,46,30,637,10,44,53,17,7,13,20,45,21
68,den204d.map,64,62,1815,29,44,34,17,2631,42,34,21,27,-13,-10,23,27,24
69,den204d.map,64,62,2033,32,12,31,49,413,6,20,57,41,26,8,34,131,120
70,den204d.map,64,62,3225,52,60,11,1,1964,31,19,32,42,21,-41,62,102,63
71,den204d.map,64,62,2525,40,16,23,45,3014,48,23,15,38,-8,7,15,16,16
72,den204d.map,64,62,2882,46,31,17,30,1492,24,57,39,4,22,26,48,49,89
73,den204d.map,64,62,2209,35,22,28,39,106,1,17,62,44,34,-5,39,268,184
74,den204d.map,64,62,3042,49,57,14,4,1820,29,39,34,22,20,-18,38,39,39
75,den204d.map,64,62,2564,41,39,22,22,1511,24,38,39,23,17,-1,18,19,19
76,den204d.map,64,62,1249,20,52,43,9,3606,58,51,5,10,-38,-1,39,128,150
77,den204d.map,64,62,649,10,32,53,29,2850,45,1,18,60,-35,-31,66,77,199
78,den204d.map,64,62,2912,46,1,17,60,802,12,3,51,58,34,2,36,249,161
79,den204d.map,64,62,3538,57,57,6,4,899,14,30,49,31,43,-27,70,71,151
80,den204d.map,64,62,1010,16,43,47,18,2165,34,4,29,57,-18,-39,57,58,139
81,den204d.map,64,62,608,9,11,54,50,2991,48,46,15,15,-39,35,74,188,1223
82,den204d.map,64,62,2084,33,23,30,38,55,0,6,63,55,33,-17,50,58,188
83,den204d.map,64,62,1491,24,58,39,3,3447,55,24,8,37,-31,-34,65,106,66
84,den204d.map,64,62,1304,21,59,42,2,2706,43,21,20,40,-22,-38,60,61,67
85,den204d.map,64,62,3068,49,31,14,30,556,8,1,55,60,41,-30,71,83,205
86,den204d.map,64,62,1195,19,44,44,17,1925,31,58,32,3,-12,14,26,27,27
87,den204d.map,64,62,2452,39,27,24,34,2661,42,4,21,57,-3,-23,26,27,67
88,den204d.map,64,62,3002,48,35,15,26,2735,44,54,19,7,4,19,23,24,24
89,den204d.map,64,62,2484,40,57,23,4,2957,47,18,16,43,-7,-39,46,47,53
90,den204d.map,64,62,772,12,33,51,28,3125,50,36,13,25,-38,3,41,42,42
91,den204d.map,64,62,2676,43,51,20,10,3517,56,16,7,45,-13,-35,48,51,49
92,den204d.map,64,62,2226,35,5,28,56,484,7,11,56,50,28,6,34,113,96
93,den204d.map,64,62,2794,45,57,18,4,2973,47,2,16,59,-2,-55,57,144,80
94,den204d.map,64,62,977,15,14,48,47,2495,40,46,23,15,-25,32,57,127,902
95,den204d.map,64,62,3201,51,22,12,39,3148,50,13,13,48,1,-9,10,11,11
96,den204d.map,64,62,1904,30,17,33,44,3581,57,14,6,47,-27,-3,30,64,31
97,den204d.map,64,62,1993,32,52,31,9,2345,37,10,26,51,-5,-42,47,48,114
98,den204d.map,64,62,1240,20,61,43,0,2620,42,45,21,16,-22,-16,38,39,39
99,den204d.map,64,62,3673,59,46,4,15,3286,53,61,10,0,6,15,21,22,22
0,den206d.map,189,46,5925,128,8,60,37,6967,151,24,37,21,-23,16,39,797,293
1,den206d.map,189,46,8306,180,19,8,26,237,5,38,183,7,175,19,194,2067,2240
2,den206d.map,189,46,256,5,19,183,26,6725,146,36,42,9,-141,17,158,2084,2810
3,den206d.map,189,46,3166,68,7,120,38,5623,122,34,66,11,-54,27,81,160,127
4,den206d.map,189,46,7590,165,45,23,0,1295,28,38,160,7,137,-7,144,2144,1303
5,den206d.map,189,46,5194,112,3,76,42,3119,67,8,121,37,45,5,50,51,125
6,den206d.map,189,46,8409,182,8,6,37,1139,24,10,164,35,158,2,160,3687,1863
7,den206d.map,189,46,5765,125,30,63,15,8079,175,16,13,29,-50,-14,64,971,1112
8,den206d.map,189,46,5724,124,25,64,20,4821,104,8,84,37,20,-17,37,225,43
9,den206d.map,189,46,6792,147,15,41,30,8031,174,18,14,27,-27,3,30,214,764
10,den206d.map,189,46,5661,123,42,65,3,2237,48,16,140,29,75,-26,101,669,351
11,den206d.map,189,46,1889,41,42,147,3,4547,98,6,90,39,-57,-36,93,249,708
12,den206d.map,189,46,1849,40,36,148,9,8007,174,42,14,3,-134,6,140,1242,3468
13,den206d.map,189,46,2800,60,5,128,40,8095,175,0,13,45,-115,-5,120,285,261
14,den206d.map,189,46,8109,176,32,12,13,7951,172,6,16,39,4,-26,30,31,31
15,den206d.map,189,46,532,11,19,177,26,8357,181,14,7,31,-170,-5,175,2235,3574
16,den206d.map,189,46,609,13,34,175,11,1683,36,18,152,27,-23,-16,39,333,209
17,den206d.map,189,46,5578,121,33,67,12,5860,127,27,61,18,-6,-6,12,13,13
18,den206d.map,189,46,8184,177,3,11,42,411,8,2,180,43,169,-1,170,4007,1052
19,den206d.map,189,46,1256,27,31,161,14,5819,126,22,62,23,-99,-9,108,815,726
20,den206d.map,189,46,1660,36,41,152,4,8415,182,2,6,43,-146,-39,185,539,3435
21,den206d.map,189,46,4915,106,6,82,39,8108,176,33,12,12,-70,27,97,991,889
22,den206d.map,189,46,5939,129,40,59,5,141,3,42,185,3,126,2,128,1104,1472
23,den206d.map,189,46,7213,156,8,32,37,6462,140,23,48,22,16,15,31,302,321
24,den206d.map,189,46,5809,126,32,62,13,7557,164,32,24,13,-38,0,38,370,353
25,den206d.map,189,46,1632,35,23,153,22,652,14,37,174,8,21,14,35,106,165
26,den206d.map,189,46,401,8,12,180,33,7962,173,41,15,4,-165,29,194,2495,3628
27,den206d.map,189,46,179,3,4,185,41,663,14,26,174,19,-11,22,33,34,99
28,den206d.map,189,46,1826,39,13,149,32,5853,127,34,61,11,-88,21,109,488,623
29,den206d.map,189,46,8041,174,8,14,37,6746,146,15,42,30,28,7,35,420,109
30,den206d.map,189,46,4499,97,8,91,37,3671,79,8,109,37,18,0,18,19,19
31,den206d.map,189,46,8448,183,15,5,30,7150,155,25,33,20,28,10,38,39,39
32,den206d.map,189,46,650,14,39,174,6,6987,151,4,37,41,-137,-35,172,1129,175
33,den206d.map,189,46,977,21,34,167,11,1930,41,1,147,44,-20,-33,53,257,351
34,den206d.map,189,46,5873,127,14,61,31,7527,163,16,25,29,-36,2,38,419,426
35,den206d.map,189,46,7947,172,10,16,35,2660,57,7,131,38,115,-3,118,308,677
36,den206d.map,189,46,7858,170,7,18,38,8218,178,15,10,30,-8,8,16,17,17
37,den206d.map,189,46,7090,154,39,34,6,1749,38,44,150,1,116,5,121,3143,2789
38,den206d.map,189,46,7035,152,2,36,43,7141,155,34,33,11,-3,32,35,58,178
39,den206d.map,189,46,288,6,33,182,12,105,2,32,186,13,4,-1,5,6,6
40,den206d.map,189,46,643,13,0,175,45,7956,172,1,16,44,-159,1,160,1090,4174
41,den206d.map,189,46,7582,164,7,24,38,6062,131,9,57,36,33,2,35,140,143
42,den206d.map,189,46,1672,36,29,152,16,2295,49,4,139,41,-13,-25,38,41,39
43,den206d.map,189,46,6396,139,43,49,2,5806,126,35,62,10,13,-8,21,22,28
44,den206d.map,189,46,2109,45,6,143,39,8582,186,19,2,26,-141,13,154,1020,732
45,den206d.map,189,46,6738,146,23,42,22,8399,182,18,6,27,-36,-5,41,313,1120
46,den206d.map,189,46,924,20,41,168,4,4502,97,5,91,40,-77,-36,113,238,114
47,den206d.map,189,46,5956,129,23,59,22,189,4,40,184,5,125,17,142,856,1455
48,den206d.map,189,46,1768,38,25,150,20,7868,171,43,17,2,-133,18,151,882,2227
49,den206d.map,189,46,972,21,39,167,6,5926,128,7,60,38,-107,-32,139,183,140
50,den206d.map,189,46,3030,65,5,123,40,1039,22,18,166,27,43,13,56,716,614
51,den206d.map,189,46,7040,153,43,35,2,7692,167,35,21,10,-14,-8,22,23,40
52,den206d.map,189,46,1313,28,20,160,25,668,14,21,174,24,14,1,15,248,496
53,den206d.map,189,46,8312,180,13,8,32,1613,35,42,153,3,145,29,174,3422,1417
54,den206d.map,189,46,6466,140,19,48,26,6715,145,0,43,45,-5,-19,24,25,25
55,den206d.map,189,46,5955,129,24,59,21,8095,175,0,13,45,-46,-24,70,108,969
56,den206d.map,189,46,8001,173,2,15,43,5431,118,42,70,3,55,40,95,96,135
57,den206d.map,189,46,1881,40,4,148,41,6447,140,38,48,7,-100,34,134,393,194
58,den206d.map,189,46,5517,119,2,69,43,5519,119,0,69,45,0,-2,2,3,3
59,den206d.map,189,46,1400,30,25,158,20,255,5,20,183,25,25,-5,30,269,561
60,den206d.map,189,46,5408,117,19,71,26,5551,120,14,68,31,-3,-5,8,9,9
61,den206d.map,189,46,6746,146,15,42,30,901,19,18,169,27,127,3,130,2308,1571
62,den206d.map,189,46,7634,165,1,23,44,1822,39,17,149,28,126,16,142,143,368
63,den206d.map,189,46,7537,163,6,25,39,5786,125,9,63,36,38,3,41,122,165
64,den206d.map,189,46,7362,160,43,28,2,6631,144,38,44,7,16,-5,21,22,22
65,den206d.map,189,46,6689,145,26,43,19,743,16,38,172,7,129,12,141,1090,1748
66,den206d.map,189,46,7369,160,36,28,9,7237,157,30,31,15,3,-6,9,10,10
67,den206d.map,189,46,5768,125,27,63,18,604,13,39,175,6,112,12,124,846,1442
68,den206d.map,189,46,7696,167,31,21,14,7631,165,4,23,41,2,-27,29,30,30
69,den206d.map,189,46,6713,145,2,43,43,7986,173,17,15,28,-28,15,43,86,102
70,den206d.map,189,46,376,8,37,180,8,7206,156,15,32,30,-148,-22,170,2258,2459
71,den206d.map,189,46,979,21,32,167,13,8324,180,1,8,44,-159,-31,190,678,3039
72,den206d.map,189,46,7332,159,27,29,18,606,13,37,175,8,146,10,156,2770,2454
73,den206d.map,189,46,2190,47,17,141,28,6574,142,3,46,42,-95,-14,109,273,110
74,den206d.map,189,46,919,19,0,169,45,5319,115,16,73,29,-96,16,112,1520,2372
75,den206d.map,189,46,6400,139,39,49,6,5899,128,34,60,11,11,-5,16,17,17
76,den206d.map,189,46,8322,180,3,8,42,5181,112,16,76,29,68,13,81,97,122
77,den206d.map,189,46,725,15,10,173,35,8414,182,3,6,42,-167,-7,174,1002,3132
78,den206d.map,189,46,1820,39,19,149,26,630,13,13,175,32,26,-6,32,496,599
79,den206d.map,189,46,5658,123,45,65,0,5219,113,24,75,21,10,-21,31,50,33
80,den206d.map,189,46,6016,130,9,58,36,7323,159,36,29,9,-29,27,56,658,455
81,den206d.map,189,46,608,13,35,175,10,5280,114,9,74,36,-101,-26,127,1038,907
82,den206d.map,189,46,5688,123,15,65,30,7063,153,20,35,25,-30,5,35,879,413
83,den206d.map,189,46,1056,22,1,166,44,5785,125,10,63,35,-103,9,112,1278,2512
84,den206d.map,189,46,8257,179,22,9,23,7732,168,41,20,4,11,19,30,31,31
85,den206d.map,189,46,5192,112,5,76,40,5774,125,21,63,24,-13,16,29,30,42
86,den206d.map,189,46,5834,126,7,62,38,3950,85,5,103,40,41,-2,43,44,44
87,den206d.map,189,46,7242,157,25,31,20,5566,121,45,67,0,36,20,56,290,558
88,den206d.map,189,46,6745,146,16,42,29,8161,177,26,11,19,-31,10,41,338,1084
89,den206d.map,189,46,164,3,19,185,26,7996,173,7,15,38,-170,-12,182,1915,3198
90,den206d.map,189,46,7347,159,12,29,33,7605,165,30,23,15,-6,18,24,25,25
91,den206d.map,189,46,5291,115,44,73,1,8125,176,16,12,29,-61,-28,89,867,944
92,den206d.map,189,46,2936,63,7,125,38,8291,180,34,8,11,-117,27,144,1345,1063
93,den206d.map,189,46,6553,142,24,46,21,6324,137,23,51,22,5,-1,6,7,7
94,den206d.map,189,46,7588,164,1,24,44,964,20,1,168,44,144,0,144,3960,1012
95,den206d.map,189,46,8364,181,7,7,38,6319,137,28,51,17,44,21,65,961,319
96,den206d.map,189,46,8208,178,25,10,20,6587,143,36,45,9,35,11,46,632,257
97,den206d.map,189,46,2236,48,17,140,28,4687,101,4,87,41,-53,-13,66,151,67
98,den206d.map,189,46,5464,118,9,70,36,1390,30,35,158,10,88,26,114,347,467
99,den206d.map,189,46,411,8,2,180,43,7397,160,8,28,37,-152,6,158,1945,3967
0,den207d.map,46,36,1446,40,29,5,6,887,24,12,21,23,16,-17,33,34,52
1,den207d.map,46,36,89,2,18,43,17,1038,28,5,17,30,-26,-13,39,44,40
2,den207d.map,46,36,698,19,21,26,14,1215,33,8,12,27,-14,-13,27,37,28
3,den207d.map,46,36,1352,37,15,8,20,1429,39,10,6,25,-2,-5,7,8,8
4,den207d.map,46,36,1433,39,6,6,29,1308,36,23,9,12,3,17,20,21,21
5,den207d.map,46,36,8,0,27,45,8,152,4,27,41,8,-4,0,4,5,5
6,den207d.map,46,36,1321,36,10,9,25,1142,31,9,14,26,5,-1,6,7,7
7,den207d.map,46,36,1209,33,14,12,21,1444,40,31,5,4,-7,17,24,25,25
8,den207d.map,46,36,1147,31,4,14,31,1391,38,12,7,23,-7,8,15,16,16
9,den207d.map,46,36,19,0,16,45,19,165,4,14,41,21,-4,-2,6,7,7
10,den207d.map,46,36,714,19,5,26,30,1359,37,8,8,27,-18,3,21,22,23
11,den207d.map,46,36,528,14,11,31,24,1323,36,8,9,27,-22,-3,25,62,86
12,den207d.map,46,36,592,16,19,29,16,1209,33,14,12,21,-17,-5,22,23,23
13,den207d.map,46,36,1482,41,29,4,6,13,0,22,45,13,41,-7,48,210,300
14,den207d.map,46,36,1033,28,10,17,25,1507,41,4,4,31,-13,-6,19,20,22
15,den207d.map,46,36,763,21,28,24,7,447,12,20,33,15,9,-8,17,18,20
16,den207d.map,46,36,923,25,12,20,23,527,14,12,31,23,11,0,11,14,14
17,den207d.map,46,36,889,24,10,21,25,967,26,4,19,31,-2,-6,8,26,27
18,den207d.map,46,36,957,26,14,19,21,679,18,4,27,31,8,-10,18,72,44
19,den207d.map,46,36,1304,36,27,9,8,311,8,12,37,23,28,-15,43,44,205
20,den207d.map,46,36,924,25,11,20,24,1471,40,4,5,31,-15,-7,22,23,31
21,den207d.map,46,36,1442,40,33,5,2,1443,40,32,5,3,0,-1,1,2,2
22,den207d.map,46,36,1111,30,4,15,31,95,2,12,43,23,28,8,36,37,41
23,den207d.map,46,36,696,19,23,26,12,349,9,10,36,25,10,-13,23,24,28
24,den207d.map,46,36,1392,38,11,7,24,1175,32,12,13,23,6,1,7,8,8
25,den207d.map,46,36,451,12,16,33,19,227,6,24,39,11,6,8,14,15,15
26,den207d.map,46,36,659,18,24,27,11,997,27,10,18,25,-9,-14,23,33,24
27,den207d.map,46,36,1209,33,14,12,21,157,4,22,41,13,29,8,37,38,45
28,den207d.map,46,36,924,25,11,20,24,679,18,4,27,31,7,-7,14,63,68
29,den207d.map,46,36,303,8,20,37,15,1479,41,32,4,3,-33,12,45,249,202
30,den207d.map,46,36,370,10,25,35,10,1363,37,4,8,31,-27,-21,48,49,49
31,den207d.map,46,36,96,2,11,43,24,565,15,10,30,25,-13,-1,14,15,15
32,den207d.map,46,36,1385,38,18,7,17,1525,42,22,3,13,-4,4,8,9,9
33,den207d.map,46,36,1002,27,5,18,30,822,22,5,23,30,5,0,5,6,6
34,den207d.map,46,36,697,19,22,26,13,894,24,5,21,30,-5,-17,22,127,39
35,den207d.map,46,36,1109,30,6,15,29,87,2,20,43,15,28,14,42,43,150
36,den207d.map,46,36,410,11,21,34,14,1310,36,21,9,14,-25,0,25,159,69
37,den207d.map,46,36,310,8,13,37,22,239,6,12,39,23,2,-1,3,4,4
38,den207d.map,46,36,674,18,9,27,26,1326,36,5,9,30,-18,-4,22,34,102
39,den207d.map,46,36,1375,38,28,7,7,1559,43,24,2,11,-5,-4,9,10,10
40,den207d.map,46,36,377,10,18,35,17,743,20,12,25,23,-10,-6,16,17,17
41,den207d.map,46,36,52,1,19,44,16,605,16,6,29,29,-15,-13,28,33,29
42,den207d.map,46,36,1457,40,18,5,17,1491,41,20,4,15,-1,2,3,4,4
43,den207d.map,46,36,150,4,29,41,6,167,4,12,41,23,0,-17,17,31,43
44,den207d.map,46,36,1393,38,10,7,25,1458,40,17,5,18,-2,7,9,10,10
45,den207d.map,46,36,306,8,17,37,18,1300,36,31,9,4,-28,14,42,211,63
46,den207d.map,46,36,664,18,19,27,16,1527,42,20,3,15,-24,1,25,83,91
47,den207d.map,46,36,1557,43,26,2,9,79,2,28,43,7,41,2,43,254,288
48,den207d.map,46,36,1147,31,4,14,31,1447,40,28,5,7,-9,24,33,34,34
49,den207d.map,46,36,1136,31,15,14,20,690,19,29,26,6,12,14,26,27,27
50,den207d.map,46,36,520,14,19,31,16,923,25,12,20,23,-11,-7,18,26,19
51,den207d.map,46,36,496,13,7,32,28,1102,30,13,15,22,-17,6,23,24,24
52,den207d.map,46,36,1283,35,12,10,23,1244,34,15,11,20,1,3,4,5,5
53,den207d.map,46,36,1600,44,19,1,16,1352,37,15,8,20,7,-4,11,12,12
54,den207d.map,46,36,1458,40,17,5,18,1595,44,24,1,11,-4,7,11,12,12
55,den207d.map,46,36,1400,38,3,7,32,484,13,19,32,16,25,16,41,42,45
56,den207d.map,46,36,384,10,11,35,24,372,10,23,35,12,0,12,12,13,13
57,den207d.map,46,36,925,25,10,20,25,1494,41,17,4,18,-16,7,23,34,24
58,den207d.map,46,36,90,2,17,43,18,455,12,12,33,23,-10,-5,15,16,16
59,den207d.map,46,36,1369,38,34,7,1,1587,44,32,1,3,-6,-2,8,9,9
60,den207d.map,46,36,1312,36,19,9,16,1136,31,15,14,20,5,-4,9,10,10
61,den207d.map,46,36,962,26,9,19,26,204,5,11,40,24,21,2,23,37,81
62,den207d.map,46,36,10,0,25,45,10,116,3,27,42,8,-3,2,5,6,6
63,den207d.map,46,36,449,12,18,33,17,1497,41,14,4,21,-29,-4,33,34,34
64,den207d.map,46,36,451,12,16,33,19,742,20,13,25,22,-8,-3,11,12,12
65,den207d.map,46,36,1384,38,19,7,16,1319,36,12,9,23,2,-7,9,10,10
66,den207d.map,46,36,1632,45,23,0,12,411,11,20,34,15,34,-3,37,148,178
67,den207d.map,46,36,1064,29,15,16,20,1249,34,10,11,25,-5,-5,10,11,11
68,den207d.map,46,36,117,3,26,42,9,990,27,17,18,18,-24,-9,33,34,51
69,den207d.map,46,36,1360,37,7,8,28,484,13,19,32,16,24,12,36,37,79
70,den207d.map,46,36,1101,30,14,15,21,605,16,6,29,29,14,-8,22,23,23
71,den207d.map,46,36,1560,43,23,2,12,1148,31,3,14,32,12,-20,32,33,33
72,den207d.map,46,36,594,16,17,29,18,602,16,9,29,26,0,-8,8,9,9
73,den207d.map,46,36,1520,42,27,3,8,385,10,10,35,25,32,-17,49,50,187
74,den207d.map,46,36,153,4,26,41,9,235,6,16,39,19,-2,-10,12,13,27
75,den207d.map,46,36,1421,39,18,6,17,670,18,13,27,22,21,-5,26,27,61
76,den207d.map,46,36,1391,38,12,7,23,1599,44,20,1,15,-6,8,14,15,15
77,den207d.map,46,36,1636,45,19,0,16,1516,42,31,3,4,3,12,15,16,16
78,den207d.map,46,36,230,6,21,39,14,1031,28,12,17,23,-22,-9,31,57,32
79,den207d.map,46,36,88,2,19,43,16,528,14,11,31,24,-12,-8,20,21,21
80,den207d.map,46,36,1456,40,19,5,16,1641,45,14,0,21,-5,-5,10,11,11
81,den207d.map,46,36,21,0,14,45,21,670,18,13,27,22,-18,-1,19,32,27
82,den207d.map,46,36,60,1,11,44,24,1174,32,13,13,22,-31,2,33,44,34
83,den207d.map,46,36,786,21,5,24,30,1326,36,5,9,30,-15,0,15,16,16
84,den207d.map,46,36,1528,42,19,3,16,654,18,29,27,6,24,10,34,196,110
85,den207d.map,46,36,298,8,25,37,10,1030,28,13,17,22,-20,-12,32,39,33
86,den207d.map,46,36,661,18,22,27,13,1358,37,9,8,26,-19,-13,32,45,33
87,den207d.map,46,36,1458,40,17,5,18,307,8,16,37,19,32,-1,33,40,60
88,den207d.map,46,36,57,1,14,44,21,1294,35,1,10,34,-34,-13,47,58,48
89,den207d.map,46,36,1309,36,22,9,13,1039,28,4,17,31,8,-18,26,35,30
90,den207d.map,46,36,1531,42,16,3,19,1061,29,18,16,17,13,2,15,34,19
91,den207d.map,46,36,165,4,14,41,21,199,5,16,40,19,-1,2,3,4,4
92,den207d.map,46,36,274,7,13,38,22,1452,40,23,5,12,-33,10,43,180,44
93,den207d.map,46,36,258,7,29,38,6,1027,28,16,17,19,-21,-13,34,35,35
94,den207d.map,46,36,609,16,2,29,33,1491,41,20,4,15,-25,18,43,96,44
95,den207d.map,46,36,1137,31,14,14,21,1590,44,29,1,6,-13,15,28,29,29
96,den207d.map,46,36,1480,41,31,4,4,132,3,11,42,24,38,-20,58,59,282
97,den207d.map,46,36,672,18,11,27,24,1185,32,2,13,33,-14,-9,23,42,108
98,den207d.map,46,36,1320,36,11,9,24,1369,38,34,7,1,-2,23,25,26,26
99,den207d.map,46,36,413,11,18,34,17,1623,45,32,0,3,-34,14,48,189,205
0,den308d.map,86,94,6521,69,58,16,35,7441,79,78,6,15,-10,20,30,180,436
1,den308d.map,86,94,7955,84,34,1,59,2102,22,59,63,34,62,25,87,181,1616
2,den308d.map,86,94,5586,59,53,26,40,6035,64,74,21,19,-5,21,26,60,30
3,den308d.map,86,94,1178,12,43,73,50,6972,74,77,11,16,-62,34,96,189,107
4,den308d.map,86,94,331,3,44,82,49,3046,32,55,53,38,-29,11,40,51,47
5,den308d.map,86,94,5600,59,39,26,54,7791,82,10,3,83,-23,-29,52,143,57
6,den308d.map,86,94,1274,13,41,72,52,2207,23,48,62,45,-10,7,17,21,55
7,den308d.map,86,94,2395,25,48,60,45,5740,61,87,24,6,-36,39,75,145,87
8,den308d.map,86,94,892,9,47,76,46,3236,34,53,51,40,-25,6,31,32,32
9,den308d.map,86,94,4756,50,37,35,56,6614,70,59,15,34,-20,22,42,59,43
10,den308d.map,86,94,6340,67,51,18,42,7031,74,18,11,75,-7,-33,40,244,453
11,den308d.map,86,94,6530,69,49,16,44,2669,28,56,57,37,41,7,48,49,280
12,den308d.map,86,94,2770,29,49,56,44,2116,22,45,63,48,7,-4,11,12,12
13,den308d.map,86,94,2772,29,47,56,46,2116,22,45,63,48,7,-2,9,10,10
14,den308d.map,86,94,3429,36,48,49,45,6302,67,89,18,4,-31,41,72,114,84
15,den308d.map,86,94,5484,58,61,27,32,711,7,40,78,53,51,-21,72,106,89
16,den308d.map,86,94,6738,71,29,14,64,6883,73,72,12,21,-2,43,45,738,749
17,den308d.map,86,94,7632,81,75,4,18,3980,42,61,43,32,39,-14,53,59,71
18,den308d.map,86,94,1932,20,41,65,52,5471,58,74,27,19,-38,33,71,147,75
19,den308d.map,86,94,7584,80,29,5,64,3621,38,44,47,49,42,15,57,133,365
20,den308d.map,86,94,5393,57,58,28,35,5838,62,83,23,10,-5,25,30,31,31
21,den308d.map,86,94,7586,80,27,5,66,5886,62,35,23,58,18,8,26,136,33
22,den308d.map,86,94,5988,63,27,22,66,5908,62,13,23,80,1,-14,15,16,16
23,den308d.map,86,94,3424,36,53,49,40,6089,64,20,21,73,-28,-33,61,106,68
24,den308d.map,86,94,6475,68,10,17,83,5831,62,90,23,3,6,80,86,388,366
25,den308d.map,86,94,2404,25,39,60,54,5293,56,64,29,29,-31,25,56,73,57
26,den308d.map,86,94,2312,24,37,61,56,6340,67,51,18,42,-43,14,57,280,58
27,den308d.map,86,94,7052,75,91,10,2,6973,74,76,11,17,1,-15,16,17,17
28,den308d.map,86,94,2117,22,44,63,49,7190,76,47,9,46,-54,3,57,154,58
29,den308d.map,86,94,1906,20,67,65,26,6276,66,21,19,72,-46,-46,92,186,144
30,den308d.map,86,94,7825,83,70,2,23,2669,28,56,57,37,55,-14,69,215,627
31,den308d.map,86,94,1180,12,41,73,52,5198,55,65,30,28,-43,24,67,129,69
32,den308d.map,86,94,5929,63,86,22,7,7310,77,21,8,72,-14,-65,79,549,469
33,den308d.map,86,94,1927,20,46,65,47,7183,76,54,9,39,-56,8,64,485,91
34,den308d.map,86,94,1921,20,52,65,41,1642,17,49,68,44,3,-3,6,7,7
35,den308d.map,86,94,405,4,64,81,29,5015,53,60,32,33,-49,-4,53,154,466
36,den308d.map,86,94,2201,23,54,62,39,2483,26,54,59,39,-3,0,3,4,4
37,den308d.map,86,94,2288,24,61,61,32,5842,62,79,23,14,-38,18,56,128,68
38,den308d.map,86,94,3905,41,42,44,51,6999,74,50,11,43,-33,8,41,187,42
39,den308d.map,86,94,1828,19,51,66,42,509,5,54,80,39,14,3,17,18,18
40,den308d.map,86,94,6817,72,44,13,49,6844,72,17,13,76,0,-27,27,171,492
41,den308d.map,86,94,4474,47,37,38,56,4749,50,44,35,49,-3,7,10,11,11
42,den308d.map,86,94,5834,62,87,23,6,1074,11,53,74,40,51,-34,85,98,187
43,den308d.map,86,94,6945,73,10,12,83,5022,53,53,32,40,20,43,63,72,70
44,den308d.map,86,94,1909,20,64,65,29,4367,46,50,39,43,-26,-14,40,41,63
45,den308d.map,86,94,5019,53,56,32,37,4932,52,49,33,44,1,-7,8,9,9
46,den308d.map,86,94,898,9,41,76,52,2292,24,57,61,36,-15,16,31,39,48
47,den308d.map,86,94,2194,23,61,62,32,7357,78,68,7,25,-55,7,62,534,202
48,den308d.map,86,94,6179,65,24,20,69,6644,70,29,15,64,-5,5,10,11,11
49,den308d.map,86,94,4083,43,52,42,41,2771,29,48,56,45,14,-4,18,19,19
50,den308d.map,86,94,6417,68,68,17,25,3036,32,65,53,28,36,-3,39,165,341
51,den308d.map,86,94,2878,30,35,55,58,3535,37,36,48,57,-7,1,8,9,9
52,den308d.map,86,94,876,9,63,76,30,6951,73,4,12,89,-64,-59,123,1996,257
53,den308d.map,86,94,3514,37,57,48,36,6498,69,81,16,12,-32,24,56,94,68
54,den308d.map,86,94,6220,66,77,19,16,3055,32,46,53,47,34,-31,65,75,120
55,den308d.map,86,94,4368,46,49,39,44,6902,73,53,12,40,-27,4,31,191,68
56,den308d.map,86,94,6465,68,20,17,73,7788,82,13,3,80,-14,-7,21,49,22
57,den308d.map,86,94,6782,72,79,13,14,6215,66,82,19,11,6,3,9,10,10
58,den308d.map,86,94,700,7,51,78,42,495,5,68,80,25,2,17,19,20,20
59,den308d.map,86,94,4452,47,59,38,34,3900,41,47,44,46,6,-12,18,19,19
60,den308d.map,86,94,2113,22,48,63,45,6228,66,69,19,24,-44,21,65,1092,109
61,den308d.map,86,94,3788,40,65,45,28,3597,38,68,47,25,2,3,5,6,6
62,den308d.map,86,94,2584,27,47,58,46,3603,38,62,47,31,-11,15,26,27,27
63,den308d.map,86,94,6588,70,85,15,8,4734,50,59,35,34,20,-26,46,58,53
64,den308d.map,86,94,1920,20,53,65,40,6970,74,79,11,14,-54,26,80,156,92
65,den308d.map,86,94,6128,65,75,20,18,7305,77,26,8,67,-12,-49,61,397,429
66,den308d.map,86,94,7509,79,10,6,83,6126,65,77,20,16,14,67,81,761,543
67,den308d.map,86,94,5222,55,41,30,52,4759,50,34,35,59,5,-7,12,13,13
68,den308d.map,86,94,5864,62,57,23,36,7313,77,18,8,75,-15,-39,54,284,351
69,den308d.map,86,94,6188,65,15,20,78,5197,55,66,30,27,10,51,61,68,62
70,den308d.map,86,94,6832,72,29,13,64,6366,67,25,18,68,5,-4,9,10,10
71,den308d.map,86,94,6370,67,21,18,72,6530,69,49,16,44,-2,28,30,296,172
72,den308d.map,86,94,7886,83,9,2,84,4455,47,56,38,37,36,47,83,92,199
73,den308d.map,86,94,4074,43,61,42,32,4922,52,59,33,34,-9,-2,11,12,12
74,den308d.map,86,94,6872,73,83,12,10,6999,74,50,11,43,-1,-33,34,597,257
75,den308d.map,86,94,6096,64,13,21,80,6809,72,52,13,41,-8,39,47,476,206
76,den308d.map,86,94,590,6,67,79,26,2878,30,35,55,58,-24,-32,56,98,105
77,den308d.map,86,94,6481,68,4,17,89,5802,61,25,24,68,7,21,28,137,397
78,den308d.map,86,94,7633,81,74,4,19,6098,64,11,21,82,17,-63,80,357,832
79,den308d.map,86,94,2765,29,54,56,39,5485,58,60,27,33,-29,6,35,36,36
80,den308d.map,86,94,7026,74,23,11,70,5655,60,78,25,15,14,55,69,255,276
81,den308d.map,86,94,1941,20,32,65,61,5895,62,26,23,67,-42,-6,48,144,178
82,den308d.map,86,94,334,3,41,82,52,3807,40,46,45,47,-37,5,42,93,211
83,den308d.map,86,94,6995,74,54,11,39,6811,72,50,13,43,2,-4,6,7,7
84,den308d.map,86,94,5289,56,68,29,25,6380,67,11,18,82,-11,-57,68,69,77
85,den308d.map,86,94,6384,67,7,18,86,518,5,45,80,48,62,38,100,1087,1959
86,den308d.map,86,94,1186,12,35,73,58,6063,64,46,21,47,-52,11,63,182,623
87,den308d.map,86,94,1160,12,61,73,32,6034,64,75,21,18,-52,14,66,217,659
88,den308d.map,86,94,4181,44,48,41,45,7725,82,76,3,17,-38,28,66,84,74
89,den308d.map,86,94,7690,81,17,4,76,339,3,36,82,57,78,19,97,1187,325
90,den308d.map,86,94,605,6,52,79,41,6231,66,66,19,27,-60,14,74,1374,133
91,den308d.map,86,94,2947,31,60,54,33,3983,42,58,43,35,-11,-2,13,14,14
92,den308d.map,86,94,4265,45,58,40,35,7449,79,70,6,23,-34,12,46,322,182
93,den308d.map,86,94,4465,47,46,38,47,7794,82,7,3,86,-35,-39,74,190,100
94,den308d.map,86,94,2780,29,39,56,54,6021,64,88,21,5,-35,49,84,146,96
95,den308d.map,86,94,2480,26,57,59,36,5121,54,48,31,45,-28,-9,37,38,38
96,den308d.map,86,94,6337,67,54,18,39,6389,67,2,18,91,0,-52,52,986,684
97,den308d.map,86,94,6290,66,7,19,86,6212,66,85,19,8,0,78,78,837,1706
98,den308d.map,86,94,3322,35,61,50,32,5604,59,35,26,58,-24,-26,50,74,51
99,den308d.map,86,94,4080,43,55,42,38,6098,64,11,21,82,-21,-44,65,102,74
0,den312d.map,77,63,4589,72,9,4,53,3582,56,8,20,54,16,-1,17,879,571
1,den312d.map,77,63,3857,61,48,15,14,489,7,14,69,48,54,-34,88,103,377
2,den312d.map,77,63,4072,64,22,12,40,3405,54,59,22,3,10,37,47,50,250
3,den312d.map,77,63,4256,67,27,9,35,319,5,58,71,4,62,31,93,203,360
4,den312d.map,77,63,1329,21,56,55,6,4339,68,7,8,55,-47,-49,96,702,740
5,den312d.map,77,63,1249,19,10,57,52,3990,63,41,13,21,-44,31,75,164,117
6,den312d.map,77,63,1435,22,13,54,49,1468,23,43,53,19,-1,30,31,50,75
7,den312d.map,77,63,210,3,41,73,21,3483,55,44,21,18,-52,3,55,366,113
8,den312d.map,77,63,1739,27,24,49,38,653,10,39,66,23,17,15,32,67,65
9,den312d.map,77,63,1576,25,61,51,1,574,9,55,67,7,16,-6,22,23,27
10,den312d.map,77,63,3111,49,38,27,24,2095,33,46,43,16,16,8,24,30,92
11,den312d.map,77,63,2352,37,41,39,21,1615,25,22,51,40,12,-19,31,32,32
12,den312d.map,77,63,3682,58,34,18,28,319,5,58,71,4,53,24,77,184,103
13,den312d.map,77,63,4243,67,40,9,22,2413,38,43,38,19,29,3,32,143,88
14,den312d.map,77,63,1138,18,58,58,4,2229,35,38,41,24,-17,-20,37,38,38
15,den312d.map,77,63,3393,53,8,23,54,3994,63,37,13,25,-10,29,39,180,777
16,den312d.map,77,63,4275,67,8,9,54,3855,61,50,15,12,6,42,48,80,49
17,den312d.map,77,63,3243,51,32,25,30,4109,65,48,11,14,-14,16,30,34,33
18,den312d.map,77,63,3845,61,60,15,2,653,10,39,66,23,51,-21,72,259,393
19,den312d.map,77,63,745,11,10,65,52,2324,36,6,40,56,-25,-4,29,378,605
20,den312d.map,77,63,681,10,11,66,51,3546,56,44,20,18,-46,33,79,314,80
21,den312d.map,77,63,762,12,56,64,6,1605,25,32,51,30,-13,-24,37,43,83
22,den312d.map,77,63,3868,61,37,15,25,725,11,30,65,32,50,-7,57,58,58
23,den312d.map,77,63,2484,39,35,37,27,3245,51,30,25,32,-12,-5,17,40,18
24,den312d.map,77,63,2158,34,46,42,16,2446,38,10,38,52,-4,-36,40,41,56
25,den312d.map,77,63,2564,40,18,36,44,4660,73,1,3,61,-33,-17,50,580,401
26,den312d.map,77,63,4712,74,12,2,50,4053,64,41,12,21,10,29,39,59,40
27,den312d.map,77,63,113,1,12,75,50,245,3,6,73,56,-2,-6,8,10,9
28,den312d.map,77,63,680,10,12,66,50,4262,67,21,9,41,-57,9,66,640,424
29,den312d.map,77,63,1592,25,45,51,17,3867,61,38,15,24,-36,-7,43,165,96
30,den312d.map,77,63,1185,18,11,58,51,2193,34,11,42,51,-16,0,16,262,401
31,den312d.map,77,63,4760,75,27,1,35,4196,66,24,10,38,9,-3,12,13,13
32,den312d.map,77,63,1627,25,10,51,52,2109,33,32,43,30,-8,22,30,130,87
33,den312d.map,77,63,413,6,27,70,35,2511,39,8,37,54,-33,-19,52,379,415
34,den312d.map,77,63,4704,74,20,2,42,339,5,38,71,24,69,18,87,99,519
35,den312d.map,77,63,3280,52,58,24,4,1186,18,10,58,52,34,-48,82,143,233
36,den312d.map,77,63,3109,49,40,27,22,2494,39,25,37,37,10,-15,25,26,39
37,den312d.map,77,63,4178,66,42,10,20,1015,16,55,60,7,50,13,63,367,363
38,den312d.map,77,63,4137,65,20,11,42,666,10,26,66,36,55,6,61,265,574
39,den312d.map,77,63,332,5,45,71,17,1638,26,62,50,0,-21,17,38,46,190
40,den312d.map,77,63,3741,59,38,17,24,2567,40,15,36,47,19,-23,42,43,47
41,den312d.map,77,63,4707,74,17,2,45,678,10,14,66,48,64,-3,67,435,706
42,den312d.map,77,63,320,5,57,71,5,3708,58,8,18,54,-53,-49,102,240,223
43,den312d.map,77,63,4371,69,38,7,24,4743,75,44,1,18,-6,6,12,17,21
44,den312d.map,77,63,3569,56,21,20,41,4183,66,37,10,25,-10,16,26,27,27
45,den312d.map,77,63,2576,40,6,36,56,276,4,38,72,24,36,32,68,88,289
46,den312d.map,77,63,2298,36,32,40,30,3303,52,35,24,27,-16,3,19,20,20
47,den312d.map,77,63,4226,67,57,9,5,1372,21,13,55,49,46,-44,90,163,1037
48,den312d.map,77,63,1546,24,28,52,34,2479,39,40,37,22,-15,12,27,28,34
49,den312d.map,77,63,4532,71,3,5,59,4143,65,14,11,48,6,11,17,18,18
50,den312d.map,77,63,4508,71,27,5,35,3118,49,31,27,31,22,4,26,135,152
51,den312d.map,77,63,657,10,35,66,27,1029,16,41,60,21,-6,6,12,13,13
52,den312d.map,77,63,2449,38,7,38,55,4639,73,22,3,40,-35,15,50,563,414
53,den312d.map,77,63,3344,53,57,23,5,382,6,58,70,4,47,1,48,367,490
54,den312d.map,77,63,3286,52,52,24,10,1599,25,38,51,24,27,-14,41,59,175
55,den312d.map,77,63,323,5,54,71,8,4083,64,11,12,51,-59,-43,102,896,211
56,den312d.map,77,63,4744,75,43,1,19,1805,28,21,48,41,47,-22,69,488,194
57,den312d.map,77,63,632,10,60,66,2,2491,39,28,37,34,-29,-32,61,95,125
58,den312d.map,77,63,3993,63,38,13,24,2550,40,32,36,30,23,-6,29,30,34
59,den312d.map,77,63,2552,40,30,36,32,4743,75,44,1,18,-35,14,49,105,52
60,den312d.map,77,63,1600,25,37,51,25,366,5,11,71,51,20,-26,46,69,47
61,den312d.map,77,63,1626,25,11,51,51,370,5,7,71,55,20,-4,24,271,260
62,den312d.map,77,63,3746,59,33,17,29,4310,68,36,8,26,-9,3,12,16,28
63,den312d.map,77,63,1171,18,25,58,37,4111,65,46,11,16,-47,21,68,222,85
64,den312d.map,77,63,823,13,58,63,4,607,9,22,67,40,4,-36,40,133,200
65,den312d.map,77,63,530,8,36,68,26,3555,56,35,20,27,-48,-1,49,58,84
66,den312d.map,77,63,1801,28,25,48,37,2571,40,11,36,51,-12,-14,26,213,309
67,den312d.map,77,63,597,9,32,67,30,1030,16,40,60,22,-7,8,15,16,16
68,den312d.map,77,63,4491,71,44,5,18,132,2,56,74,6,69,12,81,625,525
69,den312d.map,77,63,4240,67,43,9,19,1726,27,37,49,25,40,-6,46,48,169
70,den312d.map,77,63,1972,31,43,45,19,1284,20,38,56,24,11,-5,16,17,17
71,den312d.map,77,63,2437,38,19,38,43,2254,35,13,41,49,3,-6,9,12,10
72,den312d.map,77,63,4372,69,37,7,25,3388,53,13,23,49,16,-24,40,841,183
73,den312d.map,77,63,2390,37,3,39,59,1095,17,38,59,24,20,35,55,78,168
74,den312d.map,77,63,2632,41,13,35,49,749,11,6,65,56,30,-7,37,646,354
75,den312d.map,77,63,4605,73,56,3,6,710,11,45,65,17,62,-11,73,439,768
76,den312d.map,77,63,4490,71,45,5,17,573,9,56,67,6,62,11,73,558,469
77,den312d.map,77,63,4485,71,50,5,12,239,3,12,73,50,68,-38,106,136,408
78,den312d.map,77,63,2545,40,37,36,25,3467,55,60,21,2,-15,23,38,64,54
79,den312d.map,77,63,1284,20,38,56,24,340,5,37,71,25,15,-1,16,17,17
80,den312d.map,77,63,613,9,16,67,46,4718,74,6,2,56,-65,-10,75,931,434
81,den312d.map,77,63,594,9,35,67,27,4350,69,59,7,3,-60,24,84,1014,129
82,den312d.map,77,63,4329,68,17,8,45,1375,21,10,55,52,47,-7,54,455,568
83,den312d.map,77,63,3312,52,26,24,36,4335,68,11,8,51,-16,-15,31,179,350
84,den312d.map,77,63,688,10,4,66,58,4163,66,57,10,5,-56,53,109,1332,156
85,den312d.map,77,63,260,4,54,72,8,4124,65,33,11,29,-61,-21,82,225,197
86,den312d.map,77,63,841,13,40,63,22,4563,72,35,4,27,-59,-5,64,152,65
87,den312d.map,77,63,613,9,16,67,46,543,8,23,68,39,1,7,8,9,9
88,den312d.map,77,63,1728,27,35,49,27,1821,28,5,48,57,-1,-30,31,32,32
89,den312d.map,77,63,4696,74,28,2,34,2550,40,32,36,30,34,4,38,128,201
90,den312d.map,77,63,4077,64,17,12,45,4477,71,58,5,4,-7,41,48,324,104
91,den312d.map,77,63,3616,57,37,19,25,1223,19,36,57,26,38,-1,39,40,40
92,den312d.map,77,63,1404,22,44,54,18,4109,65,48,11,14,-43,4,47,254,289
93,den312d.map,77,63,2225,35,42,41,20,3403,54,61,22,1,-19,19,38,128,173
94,den312d.map,77,63,403,6,37,70,25,652,10,40,66,22,-4,3,7,8,8
95,den312d.map,77,63,2481,39,38,37,24,730,11,25,65,37,28,-13,41,42,42
96,den312d.map,77,63,616,9,13,67,49,3305,52,33,24,29,-43,20,63,208,518
97,den312d.map,77,63,824,13,57,63,5,3579,56,11,20,51,-43,-46,89,185,140
98,den312d.map,77,63,3648,57,5,19,57,2546,40,36,36,26,17,31,48,49,75
99,den312d.map,77,63,4540,72,58,4,4,1852,29,37,47,25,43,-21,64,106,540
0,den400d.map,233,247,55947,226,121,6,125,9502,38,130,194,116,188,9,197,4284,6887
1,den400d.map,233,247,5176,20,10,212,236,30263,122,117,110,129,-102,107,209,270,1441
2,den400d.map,233,247,47128,190,48,42,198,31105,125,16,107,230,65,-32,97,6194,3097
3,den400d.map,233,247,21315,86,173,146,73,25061,101,132,131,114,-15,-41,56,57,57
4,den400d.map,233,247,44301,179,158,53,88,25750,104,184,128,62,75,26,101,102,146
5,den400d.map,233,247,34123,138,209,94,37,28741,116,157,116,89,22,-52,74,78,75
6,den400d.map,233,247,39418,159,101,73,145,50126,202,14,30,232,-43,-87,130,134,171
7,den400d.map,233,247,10986,44,128,188,118,6343,25,78,207,168,19,-50,69,848,621
8,den400d.map,233,247,2456,9,13,223,233,16340,66,208,166,38,-57,195,252,3060,4781
9,den400d.map,233,247,49217,199,182,33,64,24350,98,102,134,144,101,-80,181,182,356
10,den400d.map,233,247,39794,161,219,71,27,34359,139,220,93,26,22,1,23,24,24
11,den400d.map,233,247,9817,39,62,193,184,35942,145,119,87,127,-106,57,163,589,218
12,den400d.map,233,247,8577,34,67,198,179,13638,55,193,177,53,-21,126,147,874,2313
13,den400d.map,233,247,41275,167,220,65,26,20044,81,209,151,37,86,-11,97,2639,766
14,den400d.map,233,247,6416,25,5,207,241,24810,100,136,132,110,-75,131,206,262,2099
15,den400d.map,233,247,27026,109,143,123,103,55390,224,184,8,62,-115,41,156,157,157
16,den400d.map,233,247,10032,40,94,192,152,39656,160,110,72,136,-120,16,136,372,1389
17,den400d.map,233,247,22938,92,32,140,214,25823,104,111,128,135,-12,79,91,572,1517
18,den400d.map,233,247,19204,77,61,155,185,22790,92,180,140,66,-15,119,134,135,884
19,den400d.map,233,247,44729,181,224,51,22,36193,146,115,86,131,35,-109,144,438,145
20,den400d.map,233,247,55184,223,143,9,103,33484,135,107,97,139,88,-36,124,1515,2380
21,den400d.map,233,247,43300,175,171,57,75,42804,173,173,59,73,2,2,4,5,5
22,den400d.map,233,247,40355,163,152,69,94,51708,209,161,23,85,-46,9,55,56,56
23,den400d.map,233,247,26088,105,93,127,153,36187,146,121,86,125,-41,28,69,273,76
24,den400d.map,233,247,10587,42,33,190,213,49244,199,155,33,91,-157,122,279,351,9763
25,den400d.map,233,247,40513,164,241,68,5,5559,22,121,210,125,142,-120,262,380,1631
26,den400d.map,233,247,30040,121,93,111,153,38041,154,243,78,3,-33,150,183,224,2315
27,den400d.map,233,247,37496,151,47,81,199,11182,45,179,187,67,106,132,238,1252,462
28,den400d.map,233,247,56448,228,114,4,132,6542,26,126,206,120,202,12,214,3619,7796
29,den400d.map,233,247,43424,175,47,57,199,39049,158,223,74,23,17,176,193,194,194
30,den400d.map,233,247,12667,51,176,181,70,23604,95,107,137,139,-44,-69,113,282,267
31,den400d.map,233,247,25568,103,119,129,127,41820,169,169,63,77,-66,50,116,117,117
32,den400d.map,233,247,8395,33,2,199,244,24797,100,149,132,97,-67,147,214,269,1919
33,den400d.map,233,247,38578,156,200,76,46,24533,99,166,133,80,57,-34,91,95,122
34,den400d.map,233,247,22620,91,103,141,143,42246,171,237,61,9,-80,134,214,304,259
35,den400d.map,233,247,35353,143,214,89,32,42381,171,102,61,144,-28,-112,140,144,443
36,den400d.map,233,247,51712,209,157,23,89,32676,132,174,100,72,77,17,94,95,95
37,den400d.map,233,247,54680,221,153,11,93,56155,227,160,5,86,-6,7,13,14,14
38,den400d.map,233,247,43488,176,230,56,16,43141,174,83,58,163,2,-147,149,560,323
39,den400d.map,233,247,10121,40,5,192,241,12155,49,194,183,52,-9,189,198,1292,2805
40,den400d.map,233,247,24132,97,73,135,173,14445,58,127,174,119,39,54,93,789,127
41,den400d.map,233,247,53468,216,130,16,116,25999,105,182,127,64,111,52,163,164,1264
42,den400d.map,233,247,26240,106,188,126,58,11511,46,97,186,149,60,-91,151,3770,180
43,den400d.map,233,247,33161,134,183,98,63,23790,96,168,136,78,38,-15,53,54,54
44,den400d.map,233,247,8361,33,36,199,210,14445,58,127,174,119,-25,91,116,1344,805
45,den400d.map,233,247,23604,95,107,137,139,37071,150,225,82,21,-55,118,173,230,183
46,den400d.map,233,247,43053,174,171,58,75,27878,112,32,120,214,62,-139,201,13454,1417
47,den400d.map,233,247,28371,114,33,118,213,40862,165,139,67,107,-51,106,157,2150,9369
48,den400d.map,233,247,40572,164,182,68,64,43157,174,67,58,179,-10,-115,125,129,562
49,den400d.map,233,247,17481,70,55,162,191,8805,35,86,197,160,35,31,66,67,124
50,den400d.map,233,247,28324,114,80,118,166,55461,224,113,8,133,-110,33,143,8091,1847
51,den400d.map,233,247,20060,81,193,151,53,12836,51,7,181,239,30,-186,216,2865,3774
52,den400d.map,233,247,3193,12,17,220,229,5913,23,14,209,232,-11,-3,14,15,15
53,den400d.map,233,247,44237,179,222,53,24,24815,100,131,132,115,79,-91,170,307,183
54,den400d.map,233,247,47265,191,158,41,88,1612,6,116,226,130,185,-42,227,16519,860
55,den400d.map,233,247,7982,32,168,200,78,46519,188,163,44,83,-156,-5,161,709,2392
56,den400d.map,233,247,8587,34,57,198,189,19806,80,200,152,46,-46,143,189,1977,3701
57,den400d.map,233,247,5996,24,178,208,68,34254,138,78,94,168,-114,-100,214,215,527
58,den400d.map,233,247,40785,165,216,67,30,39914,161,99,71,147,4,-117,121,122,122
59,den400d.map,233,247,25994,105,187,127,59,17356,70,180,162,66,35,-7,42,43,43
60,den400d.map,233,247,42322,171,161,61,85,31822,128,40,104,206,43,-121,164,16065,1304
61,den400d.map,233,247,32681,132,169,100,77,15239,61,74,171,172,71,-95,166,888,169
62,den400d.map,233,247,32888,133,209,99,37,43792,177,173,55,73,-44,-36,80,81,81
63,den400d.map,233,247,11779,47,76,185,170,30198,122,182,110,64,-75,106,181,242,1772
64,den400d.map,233,247,44113,178,99,54,147,9252,37,133,195,113,141,34,175,185,689
65,den400d.map,233,247,42896,173,81,59,165,26845,108,77,124,169,65,-4,69,70,70
66,den400d.map,233,247,55419,224,155,8,91,31015,125,106,107,140,99,-49,148,373,166
67,den400d.map,233,247,9617,38,15,194,231,8215,33,182,199,64,5,167,172,1100,2848
68,den400d.map,233,247,34721,140,105,92,141,46933,190,243,42,3,-50,138,188,211,1080
69,den400d.map,233,247,48651,196,7,36,239,7486,30,170,202,76,166,163,329,613,4126
70,den400d.map,233,247,22611,91,112,141,134,33767,136,71,96,175,-45,-41,86,127,87
71,den400d.map,233,247,31417,127,198,105,48,18596,75,175,157,71,52,-23,75,77,351
72,den400d.map,233,247,28768,116,130,116,116,44354,179,105,53,141,-63,-25,88,181,1645
73,den400d.map,233,247,16969,68,73,164,173,35139,142,181,90,65,-74,108,182,183,1110
74,den400d.map,233,247,37930,153,107,79,139,49380,199,19,33,227,-46,-88,134,137,174
75,den400d.map,233,247,26912,108,10,124,236,31190,126,178,106,68,-18,168,186,1646,7773
76,den400d.map,233,247,20378,82,122,150,124,45259,183,188,49,58,-101,66,167,220,168
77,den400d.map,233,247,35109,142,211,90,35,39406,159,113,73,133,-17,-98,115,123,368
78,den400d.map,233,247,28296,114,108,118,138,24596,99,103,133,143,15,-5,20,21,21
79,den400d.map,233,247,24539,99,160,133,86,39935,161,78,71,168,-62,-82,144,145,252
80,den400d.map,233,247,8084,32,66,200,180,39405,159,114,73,132,-127,48,175,517,226
81,den400d.map,233,247,45892,185,49,47,197,23591,95,120,137,126,90,71,161,169,313
82,den400d.map,233,247,9753,39,126,193,120,5110,20,76,212,170,19,-50,69,779,773
83,den400d.map,233,247,1850,7,125,225,121,39815,161,198,71,48,-154,73,227,1038,305
84,den400d.map,233,247,49362,199,37,33,209,11414,46,194,186,52,153,157,310,1292,635
85,den400d.map,233,247,17075,69,214,163,32,5999,24,175,208,71,45,-39,84,91,85
86,den400d.map,233,247,38088,154,196,78,50,31974,129,135,103,111,25,-61,86,3775,254
87,den400d.map,233,247,47864,193,53,39,193,36685,148,117,84,129,45,64,109,110,147
88,den400d.map,233,247,13322,53,15,179,231,21941,88,41,144,205,-35,26,61,62,62
89,den400d.map,233,247,50596,204,38,28,208,21053,85,188,147,58,119,150,269,437,487
90,den400d.map,233,247,42204,170,32,62,214,26031,105,150,127,96,65,118,183,206,4215
91,den400d.map,233,247,12714,51,129,181,117,37557,152,233,80,13,-101,104,205,1343,5446
92,den400d.map,233,247,9513,38,119,194,127,29259,118,133,114,113,-80,14,94,446,96
93,den400d.map,233,247,24825,100,121,132,125,36387,147,168,85,78,-47,47,94,95,175
94,den400d.map,233,247,43379,175,92,57,154,23812,96,146,136,100,79,54,133,134,134
95,den400d.map,233,247,20314,82,186,150,60,15631,63,176,169,70,19,-10,29,30,30
96,den400d.map,233,247,14533,58,39,174,207,25805,104,129,128,117,-46,90,136,139,352
97,den400d.map,233,247,10990,44,124,188,122,40014,162,246,70,0,-118,122,240,1438,292
98,den400d.map,233,247,32949,133,148,99,98,30038,121,95,111,151,12,-53,65,769,2492
99,den400d.map,233,247,37816,153,221,79,25,35745,144,69,88,177,9,-152,161,581,162
0,den401d.map,109,254,14634,57,97,51,156,22535,88,70,20,183,-31,-27,58,129,280
1,den401d.map,109,254,23088,90,25,18,228,23330,91,37,17,216,-1,12,13,18,20
2,den401d.map,109,254,25416,100,237,8,16,13629,53,86,55,167,47,-151,198,383,351
3,den401d.map,109,254,10005,39,154,69,99,21071,82,10,26,243,-43,-144,187,1985,620
4,den401d.map,109,254,7666,30,207,78,46,17318,68,207,40,46,-38,0,38,39,39
5,den401d.map,109,254,17229,67,42,41,211,23886,94,243,14,10,-27,201,228,1651,3000
6,den401d.map,109,254,16186,63,69,45,184,24874,97,17,11,236,-34,-52,86,112,116
7,den401d.map,109,254,9765,38,140,70,113,2565,10,228,98,25,28,88,116,982,1889
8,den401d.map,109,254,9752,38,153,70,100,14524,57,207,51,46,-19,54,73,76,455
9,den401d.map,109,254,10029,39,130,69,123,5549,21,38,87,215,18,-92,110,1831,1759
10,den401d.map,109,254,17633,69,146,39,107,26646,104,23,4,230,-35,-123,158,659,1589
11,den401d.map,109,254,27242,107,189,1,64,5910,23,185,85,68,84,-4,88,1432,1019
12,den401d.map,109,254,4648,18,177,90,76,4276,16,41,92,212,2,-136,138,3656,5777
13,den401d.map,109,254,3496,13,59,95,194,21313,83,22,25,231,-70,-37,107,1542,910
14,den401d.map,109,254,22536,88,69,20,184,3982,15,81,93,172,73,12,85,86,86
15,den401d.map,109,254,22640,89,219,19,34,24865,97,26,11,227,-8,-193,201,3138,4681
16,den401d.map,109,254,14328,56,149,52,104,24566,96,71,12,182,-40,-78,118,812,336
17,den401d.map,109,254,1768,6,9,102,244,20628,81,199,27,54,-75,190,265,573,1512
18,den401d.map,109,254,4292,16,25,92,228,16812,66,205,42,48,-50,180,230,459,2821
19,den401d.map,109,254,12590,49,109,59,144,11982,47,209,61,44,2,100,102,537,483
20,den401d.map,109,254,22396,88,209,20,44,27239,107,192,1,61,-19,-17,36,259,39
21,den401d.map,109,254,20999,82,82,26,171,4871,19,208,89,45,63,126,189,1637,4945
22,den401d.map,109,254,17224,67,47,41,206,23143,91,224,17,29,-24,177,201,3395,2640
23,den401d.map,109,254,3025,11,22,97,231,19269,75,34,33,219,-64,12,76,1834,1753
24,den401d.map,109,254,12299,48,146,60,107,22067,86,30,22,223,-38,-116,154,213,423
25,den401d.map,109,254,11870,46,67,62,186,23623,93,252,15,1,-47,185,232,385,1265
26,den401d.map,109,254,2027,7,4,101,249,6542,25,61,83,192,-18,57,75,80,140
27,den401d.map,109,254,5417,21,170,87,83,16452,64,57,44,196,-43,-113,156,2221,5619
28,den401d.map,109,254,2363,9,176,99,77,9748,38,157,70,96,-29,-19,48,1525,2249
29,den401d.map,109,254,2234,8,51,100,202,24714,97,177,11,76,-89,126,215,3289,1543
30,den401d.map,109,254,17569,69,210,39,43,15341,60,152,48,101,9,-58,67,358,640
31,den401d.map,109,254,21256,83,79,25,174,10501,41,166,67,87,42,87,129,686,2377
32,den401d.map,109,254,26206,103,209,5,44,7294,28,71,80,182,75,-138,213,3545,245
33,den401d.map,109,254,24704,97,187,11,66,1466,5,57,103,196,92,-130,222,1596,3100
34,den401d.map,109,254,26588,104,81,4,172,4052,15,11,93,242,89,-70,159,160,548
35,den401d.map,109,254,13272,52,189,56,64,18358,72,183,36,70,-20,-6,26,27,27
36,den401d.map,109,254,2768,10,25,98,228,9503,37,148,71,105,-27,123,150,2181,924
37,den401d.map,109,254,26866,105,57,3,196,26357,103,58,5,195,2,1,3,4,4
38,den401d.map,109,254,11754,46,183,62,70,22895,90,218,18,35,-44,35,79,1056,203
39,den401d.map,109,254,25892,101,15,7,238,21621,85,222,23,31,16,207,223,5246,3180
40,den401d.map,109,254,1601,6,176,102,77,6089,23,6,85,247,-17,-170,187,4927,5806
41,den401d.map,109,254,17230,67,41,41,212,16806,66,211,42,42,1,170,171,739,554
42,den401d.map,109,254,27418,107,13,1,240,4575,18,250,90,3,89,237,326,4165,1019
43,den401d.map,109,254,6089,23,6,85,247,26743,105,180,3,73,-82,174,256,3632,4077
44,den401d.map,109,254,12872,50,81,58,172,4351,17,220,91,33,33,139,172,1966,1205
45,den401d.map,109,254,10211,40,202,68,51,15932,62,69,46,184,-22,-133,155,167,1225
46,den401d.map,109,254,15576,61,171,47,82,6826,26,31,82,222,35,-140,175,3497,441
47,den401d.map,109,254,14364,56,113,52,140,14854,58,131,50,122,-2,18,20,47,29
48,den401d.map,109,254,8570,33,65,75,188,17479,68,46,40,207,-35,-19,54,399,157
49,den401d.map,109,254,11776,46,161,62,92,7127,28,238,80,15,18,77,95,1997,1367
50,den401d.map,109,254,16467,64,42,44,211,836,3,179,105,74,61,137,198,5369,2400
51,den401d.map,109,254,17482,68,43,40,210,24660,97,231,11,22,-29,188,217,1715,2877
52,den401d.map,109,254,25904,101,3,7,250,18139,71,148,37,105,30,145,175,1778,721
53,den401d.map,109,254,23450,92,171,16,82,23948,94,181,14,72,-2,10,12,13,13
54,den401d.map,109,254,1345,5,178,103,75,3631,14,178,94,75,-9,0,9,10,10
55,den401d.map,109,254,1084,4,185,104,68,23135,91,232,17,21,-87,47,134,1104,263
56,den401d.map,109,254,21672,85,171,23,82,25670,101,237,7,16,-16,66,82,83,211
57,den401d.map,109,254,13100,51,107,57,146,21349,84,240,24,13,-33,133,166,3000,551
58,den401d.map,109,254,13628,53,87,55,166,26207,103,208,5,45,-50,121,171,172,172
59,den401d.map,109,254,16345,64,164,44,89,1322,5,201,103,52,59,37,96,1173,846
60,den401d.map,109,254,4338,17,233,91,20,10619,41,48,67,205,-24,-185,209,2626,3102
61,den401d.map,109,254,2362,9,177,99,76,4022,15,41,93,212,-6,-136,142,3004,5786
62,den401d.map,109,254,4018,15,45,93,208,22115,87,236,21,17,-72,191,263,4304,2363
63,den401d.map,109,254,561,2,200,106,53,7123,28,242,80,11,-26,42,68,72,111
64,den401d.map,109,254,1576,6,201,102,52,17612,69,167,39,86,-63,-34,97,843,1207
65,den401d.map,109,254,25660,101,247,7,6,17581,69,198,39,55,32,-49,81,359,128
66,den401d.map,109,254,25209,99,190,9,63,21066,82,15,26,238,17,-175,192,3094,3947
67,den401d.map,109,254,4369,17,202,91,51,11797,46,140,62,113,-29,-62,91,945,1403
68,den401d.map,109,254,12997,51,210,57,43,10351,40,62,68,191,11,-148,159,1369,520
69,den401d.map,109,254,16115,63,140,45,113,10487,41,180,67,73,22,40,62,201,63
70,den401d.map,109,254,15681,61,66,47,187,1953,7,78,101,175,54,12,66,67,120
71,den401d.map,109,254,9088,35,55,73,198,12773,50,180,58,73,-15,125,140,594,1205
72,den401d.map,109,254,12786,50,167,58,86,1314,5,209,103,44,45,42,87,444,1215
73,den401d.map,109,254,22835,89,24,19,229,5917,23,178,85,75,66,154,220,6257,883
74,den401d.map,109,254,21018,82,63,26,190,21043,82,38,26,215,0,-25,25,283,333
75,den401d.map,109,254,15677,61,70,47,183,24565,96,72,12,181,-35,2,37,70,38
76,den401d.map,109,254,2553,10,240,98,13,1750,6,27,102,226,4,-213,217,3409,3440
77,den401d.map,109,254,23193,91,174,17,79,9870,38,35,70,218,53,-139,192,1369,3245
78,den401d.map,109,254,1803,7,228,101,25,13789,54,180,54,73,-47,-48,95,358,286
79,den401d.map,109,254,24696,97,195,11,58,2551,10,242,98,11,87,47,134,153,761
80,den401d.map,109,254,11112,43,63,65,190,3271,12,30,96,223,31,-33,64,531,620
81,den401d.map,109,254,5113,20,220,88,33,25123,98,22,10,231,-78,-198,276,767,4207
82,den401d.map,109,254,14569,57,162,51,91,14885,58,100,50,153,-1,-62,63,172,140
83,den401d.map,109,254,3281,12,20,96,233,9770,38,135,70,118,-26,115,141,2207,686
84,den401d.map,109,254,7160,28,205,80,48,6309,24,40,84,213,4,-165,169,4725,3265
85,den401d.map,109,254,21096,83,239,25,14,13006,51,201,57,52,32,-38,70,300,883
86,den401d.map,109,254,14524,57,207,51,46,17324,68,201,40,52,-11,-6,17,18,18
87,den401d.map,109,254,15424,60,69,48,184,11626,45,57,63,196,15,-12,27,110,30
88,den401d.map,109,254,8171,32,210,76,43,2531,9,8,99,245,23,-202,225,2907,3370
89,den401d.map,109,254,27496,108,189,0,64,4873,19,206,89,47,89,17,106,107,845
90,den401d.map,109,254,2292,9,247,99,6,23645,93,230,15,23,-84,-17,101,1042,923
91,den401d.map,109,254,27393,107,38,1,215,4793,18,32,90,221,89,-6,95,2230,1690
92,den401d.map,109,254,14621,57,110,51,143,17981,70,52,38,201,-13,-58,71,268,306
93,den401d.map,109,254,21848,86,249,22,4,8587,33,48,75,205,53,-201,254,2013,4285
94,den401d.map,109,254,5042,19,37,89,216,13538,53,177,55,76,-34,140,174,358,2438
95,den401d.map,109,254,23450,92,171,16,82,5662,22,179,86,74,70,8,78,2094,896
96,den401d.map,109,254,1568,6,209,102,44,11283,44,146,64,107,-38,-63,101,1384,832
97,den401d.map,109,254,17085,67,186,41,67,6143,24,206,84,47,43,20,63,102,144
98,den401d.map,109,254,2290,9,249,99,4,23662,93,213,15,40,-84,-36,120,885,721
99,den401d.map,109,254,15649,61,98,47,155,12499,49,200,59,53,12,102,114,461,115
0,den403d.map,46,72,833,11,30,34,41,1479,20,32,25,39,-9,2,11,43,34
1,den403d.map,46,72,2301,31,2,14,69,487,6,16,39,55,25,14,39,40,74
2,den403d.map,46,72,1227,17,68,28,3,907,12,28,33,43,5,-40,45,106,46
3,den403d.map,46,72,2456,34,63,11,8,1884,26,59,19,12,8,-4,12,13,13
4,den403d.map,46,72,1596,22,59,23,12,1453,20,58,25,13,2,-1,3,4,4
5,den403d.map,46,72,2451,34,68,11,3,493,6,10,39,61,28,-58,86,948,367
6,den403d.map,46,72,844,11,19,34,52,1558,21,25,24,46,-10,6,16,418,177
7,den403d.map,46,72,1170,16,53,29,18,1143,15,8,30,63,1,-45,46,448,341
8,den403d.map,46,72,1552,21,31,24,40,1740,24,59,21,12,-3,28,31,112,490
9,den403d.map,46,72,2536,35,55,10,16,969,13,38,32,33,22,-17,39,55,40
10,den403d.map,46,72,2137,29,22,16,49,924,12,11,33,60,17,-11,28,116,66
11,den403d.map,46,72,2481,34,38,11,33,2023,28,64,17,7,6,26,32,33,33
12,den403d.map,46,72,712,9,7,36,64,1565,21,18,24,53,-12,11,23,24,24
13,den403d.map,46,72,1435,19,4,26,67,871,12,64,33,7,7,60,67,639,780
14,den403d.map,46,72,2153,29,6,16,65,1215,16,8,29,63,13,2,15,16,16
15,den403d.map,46,72,712,9,7,36,64,1505,20,6,25,65,-11,-1,12,13,13
16,den403d.map,46,72,1675,23,52,22,19,717,9,2,36,69,14,-50,64,411,431
17,den403d.map,46,72,2201,30,30,15,41,628,8,19,37,52,22,-11,33,221,382
18,den403d.map,46,72,713,9,6,36,65,1154,16,69,29,2,-7,63,70,288,397
19,den403d.map,46,72,891,12,44,33,27,1964,27,51,18,20,-15,7,22,23,31
20,den403d.map,46,72,2341,32,34,13,37,1839,25,32,20,39,7,-2,9,10,10
21,den403d.map,46,72,1659,23,68,22,3,1510,20,1,25,70,3,-67,70,1143,635
22,den403d.map,46,72,1509,20,2,25,69,1662,23,65,22,6,-3,63,66,632,1136
23,den403d.map,46,72,2846,39,33,6,38,1959,27,56,18,15,12,23,35,36,36
24,den403d.map,46,72,3280,45,31,0,40,261,3,26,42,45,42,-5,47,350,378
25,den403d.map,46,72,2392,33,55,12,16,349,4,10,41,61,29,-45,74,110,75
26,den403d.map,46,72,2392,33,55,12,16,2334,32,41,13,30,1,-14,15,16,16
27,den403d.map,46,72,1778,24,21,21,50,1903,26,40,19,31,-2,19,21,190,531
28,den403d.map,46,72,2238,31,65,14,6,831,11,32,34,39,20,-33,53,114,54
29,den403d.map,46,72,3298,45,13,0,58,2771,38,36,7,35,7,23,30,49,31
30,den403d.map,46,72,1737,24,62,21,9,3159,43,8,2,63,-19,-54,73,114,256
31,den403d.map,46,72,1474,20,37,25,34,2181,30,50,15,21,-10,13,23,24,24
32,den403d.map,46,72,2109,29,50,16,21,1669,23,58,22,13,6,8,14,15,15
33,den403d.map,46,72,3224,44,15,1,56,1572,21,11,24,60,23,-4,27,28,28
34,den403d.map,46,72,408,5,23,40,48,1323,18,44,27,27,-13,21,34,35,35
35,den403d.map,46,72,2152,29,7,16,64,732,10,59,35,12,19,52,71,893,1128
36,den403d.map,46,72,333,4,26,41,45,1822,25,49,20,22,-21,23,44,45,45
37,den403d.map,46,72,2488,34,31,11,40,2182,30,49,15,22,4,18,22,27,23
38,den403d.map,46,72,2085,28,2,17,69,821,11,42,34,29,17,40,57,423,549
39,den403d.map,46,72,2698,37,37,8,34,1679,23,48,22,23,14,11,25,26,26
40,den403d.map,46,72,2508,34,11,11,60,2860,39,19,6,52,-5,8,13,14,17
41,den403d.map,46,72,1698,23,29,22,42,1246,17,49,28,22,6,20,26,101,287
42,den403d.map,46,72,2129,29,30,16,41,417,5,14,40,57,24,-16,40,175,440
43,den403d.map,46,72,2420,33,27,12,44,1158,16,65,29,6,17,38,55,132,56
44,den403d.map,46,72,2298,31,5,14,66,1237,17,58,28,13,14,53,67,618,994
45,den403d.map,46,72,2282,31,21,14,50,2442,33,5,12,66,-2,-16,18,43,56
46,den403d.map,46,72,564,7,11,38,60,783,10,8,35,63,-3,-3,6,7,7
47,den403d.map,46,72,1325,18,42,27,29,1798,24,1,21,70,-6,-41,47,692,584
48,den403d.map,46,72,890,12,45,33,26,2274,31,29,14,42,-19,-16,35,198,101
49,den403d.map,46,72,1584,22,71,23,0,2454,34,65,11,6,-12,-6,18,19,19
50,den403d.map,46,72,1068,14,11,31,60,2685,37,50,8,21,-23,39,62,364,800
51,den403d.map,46,72,1141,15,10,30,61,1957,27,58,18,13,-12,48,60,541,981
52,den403d.map,46,72,2091,29,68,16,3,1803,25,68,20,3,4,0,4,5,5
53,den403d.map,46,72,1358,18,9,27,62,1887,26,56,19,15,-8,47,55,608,1001
54,den403d.map,46,72,2555,35,36,10,35,1995,27,20,18,51,8,-16,24,218,109
55,den403d.map,46,72,2720,37,15,8,56,563,7,12,38,59,30,-3,33,42,55
56,den403d.map,46,72,1083,15,68,30,3,195,2,20,43,51,13,-48,61,155,205
57,den403d.map,46,72,2641,36,22,9,49,851,11,12,34,59,25,-10,35,36,36
58,den403d.map,46,72,1230,17,65,28,6,2038,28,49,17,22,-11,-16,27,28,28
59,den403d.map,46,72,2937,40,14,5,57,3159,43,8,2,63,-3,-6,9,10,10
60,den403d.map,46,72,2188,30,43,15,28,997,13,10,32,61,17,-33,50,593,537
61,den403d.map,46,72,1770,24,29,21,42,1795,24,4,21,67,0,-25,25,377,755
62,den403d.map,46,72,1545,21,38,24,33,2164,30,67,15,4,-9,29,38,39,39
63,den403d.map,46,72,1456,20,55,25,16,1573,21,10,24,61,-1,-45,46,910,508
64,den403d.map,46,72,2049,28,38,17,33,945,13,62,32,9,15,24,39,79,40
65,den403d.map,46,72,2246,31,57,14,14,1447,20,64,25,7,11,7,18,19,19
66,den403d.map,46,72,1681,23,46,22,25,2035,28,52,17,19,-5,6,11,12,12
67,den403d.map,46,72,2346,32,29,13,42,411,5,20,40,51,27,-9,36,187,322
68,den403d.map,46,72,2698,37,37,8,34,3278,45,33,0,38,-8,-4,12,13,13
69,den403d.map,46,72,1162,16,61,29,10,2182,30,49,15,22,-14,-12,26,27,27
70,den403d.map,46,72,1667,23,60,22,11,3007,41,16,4,55,-18,-44,62,103,167
71,den403d.map,46,72,2685,37,50,8,21,1790,24,9,21,62,13,-41,54,529,233
72,den403d.map,46,72,841,11,22,34,49,2281,31,22,14,49,-20,0,20,21,21
73,den403d.map,46,72,1665,23,62,22,9,202,2,13,43,58,21,-49,70,138,71
74,den403d.map,46,72,1802,25,69,20,2,483,6,20,39,51,19,-49,68,566,148
75,den403d.map,46,72,2655,36,8,9,63,1303,18,64,27,7,18,56,74,420,795
76,den403d.map,46,72,1160,16,63,29,8,2343,32,32,13,39,-16,-31,47,48,62
77,den403d.map,46,72,2192,30,39,15,32,2676,37,59,8,12,-7,20,27,28,28
78,den403d.map,46,72,2330,32,45,13,26,2500,34,19,11,52,-2,-26,28,260,111
79,den403d.map,46,72,2250,31,53,14,18,723,10,68,35,3,21,15,36,54,37
80,den403d.map,46,72,656,9,63,36,8,773,10,18,35,53,-1,-45,46,397,407
81,den403d.map,46,72,2609,36,54,9,17,611,8,36,37,35,28,-18,46,82,47
82,den403d.map,46,72,1204,16,19,29,52,1278,17,17,28,54,-1,-2,3,4,4
83,den403d.map,46,72,2441,33,6,12,65,1893,26,50,19,21,7,44,51,363,484
84,den403d.map,46,72,1885,26,58,19,13,2846,39,33,6,38,-13,-25,38,39,39
85,den403d.map,46,72,422,5,9,40,62,2527,35,64,10,7,-30,55,85,86,161
86,den403d.map,46,72,2483,34,36,11,35,844,11,19,34,52,23,-17,40,425,226
87,den403d.map,46,72,1057,14,22,31,49,484,6,19,39,52,8,-3,11,12,12
88,den403d.map,46,72,1689,23,38,22,33,339,4,20,41,51,19,-18,37,46,147
89,den403d.map,46,72,2481,34,38,11,33,1434,19,5,26,66,15,-33,48,463,367
90,den403d.map,46,72,1061,14,18,31,53,199,2,16,43,55,12,-2,14,15,15
91,den403d.map,46,72,938,13,69,32,2,2429,33,18,12,53,-20,-51,71,1062,330
92,den403d.map,46,72,410,5,21,40,50,2487,34,32,11,39,-29,11,40,372,228
93,den403d.map,46,72,2128,29,31,16,40,1090,15,61,30,10,14,30,44,124,473
94,den403d.map,46,72,955,13,52,32,19,2239,31,64,14,7,-18,12,30,31,49
95,den403d.map,46,72,1202,16,21,29,50,998,13,9,32,62,3,-12,15,45,43
96,den403d.map,46,72,2803,38,4,7,67,2703,37,32,8,39,1,28,29,126,65
97,den403d.map,46,72,2355,32,20,13,51,2223,30,8,15,63,2,-12,14,54,49
98,den403d.map,46,72,2410,33,37,12,34,323,4,36,41,35,29,-1,30,56,60
99,den403d.map,46,72,849,11,14,34,57,1668,23,59,22,12,-12,45,57,279,581
0,den404d.map,30,21,17,0,3,29,17,509,24,15,5,5,-24,12,36,116,37
1,den404d.map,30,21,556,26,10,3,10,598,28,10,1,10,-2,0,2,3,3
2,den404d.map,30,21,403,19,16,10,4,44,2,18,27,2,17,2,19,149,141
3,den404d.map,30,21,561,26,5,3,15,78,3,5,26,15,23,0,23,50,37
4,den404d.map,30,21,8,0,12,29,8,94,4,10,25,10,-4,-2,6,7,7
5,den404d.map,30,21,451,21,10,8,10,527,25,18,4,2,-4,8,12,13,15
6,den404d.map,30,21,269,12,3,17,17,77,3,6,26,14,9,3,12,13,13
7,den404d.map,30,21,521,24,3,5,17,450,21,11,8,9,3,8,11,12,12
8,den404d.map,30,21,620,29,9,0,11,31,1,10,28,10,28,1,29,166,109
9,den404d.map,30,21,394,18,4,11,16,533,25,12,4,8,-7,8,15,16,16
10,den404d.map,30,21,61,2,1,27,19,406,19,13,10,7,-17,12,29,72,30
11,den404d.map,30,21,93,4,11,25,9,70,3,13,26,7,1,2,3,4,4
12,den404d.map,30,21,426,20,14,9,6,475,22,7,7,13,-2,-7,9,10,10
13,den404d.map,30,21,432,20,8,9,12,582,27,5,2,15,-7,-3,10,11,11
14,den404d.map,30,21,351,16,5,13,15,167,7,0,22,20,9,-5,14,15,15
15,den404d.map,30,21,473,22,9,7,11,534,25,11,4,9,-3,2,5,6,6
16,den404d.map,30,21,36,1,5,28,15,70,3,13,26,7,-2,8,10,11,11
17,den404d.map,30,21,17,0,3,29,17,405,19,14,10,6,-19,11,30,98,31
18,den404d.map,30,21,530,25,15,4,5,131,6,15,23,5,19,0,19,216,139
19,den404d.map,30,21,33,1,8,28,12,142,6,4,23,16,-5,-4,9,10,10
20,den404d.map,30,21,403,19,16,10,4,543,25,2,4,18,-6,-14,20,22,21
21,den404d.map,30,21,41,1,0,28,20,102,4,2,25,18,-3,2,5,6,6
22,den404d.map,30,21,193,9,16,20,4,43,2,19,27,1,7,3,10,11,11
23,den404d.map,30,21,90,4,14,25,6,396,18,2,11,18,-14,-12,26,27,27
24,den404d.map,30,21,532,25,13,4,7,86,4,18,25,2,21,5,26,184,136
25,den404d.map,30,21,312,14,2,15,18,118,5,7,24,13,9,5,14,15,15
26,den404d.map,30,21,76,3,7,26,13,437,20,3,9,17,-17,-4,21,22,22
27,den404d.map,30,21,545,25,0,4,20,539,25,6,4,14,0,6,6,7,7
28,den404d.map,30,21,473,22,9,7,11,434,20,6,9,14,2,-3,5,6,6
29,den404d.map,30,21,556,26,10,3,10,29,1,12,28,8,25,2,27,179,133
30,den404d.map,30,21,99,4,5,25,15,12,0,8,29,12,4,3,7,8,8
31,den404d.map,30,21,144,6,2,23,18,186,8,2,21,18,-2,0,2,3,3
32,den404d.map,30,21,538,25,7,4,13,143,6,3,23,17,19,-4,23,24,25
33,den404d.map,30,21,150,7,17,22,3,519,24,5,5,15,-17,-12,29,83,228
34,den404d.map,30,21,77,3,6,26,14,173,8,15,21,5,-5,9,14,15,15
35,den404d.map,30,21,292,13,1,16,19,44,2,18,27,2,11,17,28,29,29
36,den404d.map,30,21,290,13,3,16,17,415,19,4,10,16,-6,1,7,8,8
37,den404d.map,30,21,385,18,13,11,7,14,0,6,29,14,18,-7,25,74,112
38,den404d.map,30,21,57,2,5,27,15,39,1,2,28,18,1,-3,4,5,5
39,den404d.map,30,21,117,5,8,24,12,151,7,16,22,4,-2,8,10,15,15
40,den404d.map,30,21,6,0,14,29,6,511,24,13,5,7,-24,-1,25,145,181
41,den404d.map,30,21,229,10,1,19,19,86,4,18,25,2,6,17,23,24,24
42,den404d.map,30,21,77,3,6,26,14,103,4,1,25,19,-1,-5,6,7,7
43,den404d.map,30,21,430,20,10,9,10,79,3,4,26,16,17,-6,23,51,54
44,den404d.map,30,21,193,9,16,20,4,446,21,15,8,5,-12,-1,13,135,239
45,den404d.map,30,21,394,18,4,11,16,37,1,4,28,16,17,0,17,20,20
46,den404d.map,30,21,469,22,13,7,7,230,10,0,19,20,12,-13,25,26,26
47,den404d.map,30,21,346,16,10,13,10,139,6,7,23,13,10,-3,13,59,54
48,den404d.map,30,21,166,7,1,22,19,487,23,16,6,4,-16,15,31,33,32
49,den404d.map,30,21,386,18,12,11,8,117,5,8,24,12,13,-4,17,85,86
50,den404d.map,30,21,538,25,7,4,13,85,4,19,25,1,21,12,33,183,118
51,den404d.map,30,21,493,23,10,6,10,431,20,9,9,11,3,-1,4,5,5
52,den404d.map,30,21,2,0,18,29,2,556,26,10,3,10,-26,-8,34,144,189
53,den404d.map,30,21,32,1,9,28,11,466,22,16,7,4,-21,7,28,146,159
54,den404d.map,30,21,544,25,1,4,19,166,7,1,22,19,18,0,18,25,43
55,den404d.map,30,21,29,1,12,28,8,87,4,17,25,3,-3,5,8,9,9
56,den404d.map,30,21,432,20,8,9,12,476,22,6,7,14,-2,-2,4,5,5
57,den404d.map,30,21,389,18,9,11,11,478,22,4,7,16,-4,-5,9,10,10
58,den404d.map,30,21,49,2,13,27,7,63,3,20,26,0,-1,7,8,9,9
59,den404d.map,30,21,100,4,4,25,16,413,19,6,10,14,-15,2,17,30,27
60,den404d.map,30,21,103,4,1,25,19,383,18,15,11,5,-14,14,28,60,29
61,den404d.map,30,21,56,2,6,27,14,87,4,17,25,3,-2,11,13,14,14
62,den404d.map,30,21,504,24,20,5,0,355,16,1,13,19,8,-19,27,32,133
63,den404d.map,30,21,248,11,3,18,17,13,0,7,29,13,11,4,15,16,16
64,den404d.map,30,21,53,2,9,27,11,407,19,12,10,8,-17,3,20,121,110
65,den404d.map,30,21,73,3,10,26,10,425,20,15,9,5,-17,5,22,138,138
66,den404d.map,30,21,599,28,9,1,11,55,2,7,27,13,26,-2,28,130,81
67,den404d.map,30,21,17,0,3,29,17,539,25,6,4,14,-25,3,28,49,29
68,den404d.map,30,21,553,26,13,3,7,514,24,10,5,10,2,-3,5,6,6
69,den404d.map,30,21,365,17,12,12,8,15,0,5,29,15,17,-7,24,48,88
70,den404d.map,30,21,116,5,9,24,11,143,6,3,23,17,-1,-6,7,8,8
71,den404d.map,30,21,122,5,3,24,17,431,20,9,9,11,-15,6,21,34,22
72,den404d.map,30,21,69,3,14,26,6,405,19,14,10,6,-16,0,16,135,141
73,den404d.map,30,21,404,19,15,10,5,479,22,3,7,17,-3,-12,15,16,16
74,den404d.map,30,21,209,9,0,20,20,124,5,1,24,19,4,1,5,6,6
75,den404d.map,30,21,488,23,15,6,5,373,17,4,12,16,6,-11,17,18,18
76,den404d.map,30,21,75,3,8,26,12,93,4,11,25,9,-1,3,4,5,5
77,den404d.map,30,21,90,4,14,25,6,150,7,17,22,3,-3,3,6,7,7
78,den404d.map,30,21,249,11,2,18,18,517,24,7,5,13,-13,5,18,19,19
79,den404d.map,30,21,35,1,6,28,14,14,0,6,29,14,1,0,1,2,2
80,den404d.map,30,21,6,0,14,29,6,63,3,20,26,0,-3,6,9,10,10
81,den404d.map,30,21,449,21,12,8,8,58,2,4,27,16,19,-8,27,71,72
82,den404d.map,30,21,393,18,5,11,15,447,21,14,8,6,-3,9,12,13,13
83,den404d.map,30,21,448,21,13,8,7,522,24,2,5,18,-3,-11,14,15,15
84,den404d.map,30,21,577,27,10,2,10,516,24,8,5,12,3,-2,5,6,6
85,den404d.map,30,21,544,25,1,4,19,215,10,15,19,5,15,14,29,243,80
86,den404d.map,30,21,497,23,6,6,14,173,8,15,21,5,15,9,24,236,90
87,den404d.map,30,21,512,24,12,5,8,349,16,7,13,13,8,-5,13,14,14
88,den404d.map,30,21,313,14,1,15,19,350,16,6,13,14,-2,5,7,8,8
89,den404d.map,30,21,494,23,9,6,11,351,16,5,13,15,7,-4,11,12,12
90,den404d.map,30,21,1,0,19,29,1,68,3,15,26,5,-3,-4,7,8,8
91,den404d.map,30,21,51,2,11,27,9,516,24,8,5,12,-22,-3,25,97,157
92,den404d.map,30,21,185,8,3,21,17,150,7,17,22,3,1,14,15,36,36
93,den404d.map,30,21,85,4,19,25,1,70,3,13,26,7,1,-6,7,8,8
94,den404d.map,30,21,520,24,4,5,16,164,7,3,22,17,17,-1,18,19,19
95,den404d.map,30,21,291,13,2,16,18,37,1,4,28,16,12,2,14,15,15
96,den404d.map,30,21,353,16,3,13,17,370,17,7,12,13,-1,4,5,6,6
97,den404d.map,30,21,137,6,9,23,11,534,25,11,4,9,-19,2,21,92,181
98,den404d.map,30,21,100,4,4,25,16,366,17,11,12,9,-13,7,20,47,31
99,den404d.map,30,21,620,29,9,0,11,166,7,1,22,19,22,-8,30,31,31
0,den405d.map,40,69,989,14,45,25,23,310,4,34,35,34,10,-11,21,47,23
1,den405d.map,40,69,2592,37,29,2,39,516,7,35,32,33,30,6,36,134,141
2,den405d.map,40,69,672,9,17,30,51,657,9,32,30,36,0,15,15,16,16
3,den405d.map,40,69,186,2,20,37,48,2389,34,25,5,43,-32,5,37,119,92
4,den405d.map,40,69,363,5,50,34,18,711,10,47,29,21,-5,-3,8,9,9
5,den405d.map,40,69,889,12,7,27,61,2381,34,33,5,35,-22,26,48,147,280
6,den405d.map,40,69,707,10,51,29,17,654,9,35,30,33,1,-16,17,29,18
7,den405d.map,40,69,1283,18,27,21,41,2454,35,29,4,39,-17,2,19,26,20
8,den405d.map,40,69,2328,33,17,6,51,573,8,47,31,21,25,30,55,85,144
9,den405d.map,40,69,1008,14,26,25,42,435,6,47,33,21,8,21,29,67,31
10,den405d.map,40,69,184,2,22,37,46,958,13,7,26,61,-11,-15,26,27,41
11,den405d.map,40,69,2113,30,25,9,43,1278,18,32,21,36,12,7,19,20,23
12,den405d.map,40,69,49,0,19,39,49,46,0,22,39,46,0,3,3,4,4
13,den405d.map,40,69,424,6,58,33,10,1900,27,31,12,37,-21,-27,48,287,142
14,den405d.map,40,69,1418,20,30,19,38,654,9,35,30,33,11,5,16,17,17
15,den405d.map,40,69,104,1,33,38,35,1287,18,23,21,45,-17,-10,27,29,38
16,den405d.map,40,69,2114,30,24,9,44,439,6,43,33,25,24,19,43,81,67
17,den405d.map,40,69,825,11,2,28,66,463,6,19,33,49,5,17,22,40,23
18,den405d.map,40,69,712,10,46,29,22,1095,15,8,24,60,-5,-38,43,44,44
19,den405d.map,40,69,371,5,42,34,26,1980,28,20,11,48,-23,-22,45,115,266
20,den405d.map,40,69,744,10,14,29,54,508,7,43,32,25,3,29,32,93,33
21,den405d.map,40,69,783,11,44,28,24,679,9,10,30,58,2,-34,36,64,37
22,den405d.map,40,69,2118,30,20,9,48,719,10,39,29,29,20,19,39,40,107
23,den405d.map,40,69,795,11,32,28,36,567,8,53,31,15,3,21,24,38,25
24,den405d.map,40,69,1028,14,6,25,62,822,11,5,28,63,3,-1,4,5,5
25,den405d.map,40,69,516,7,35,32,33,2527,36,25,3,43,-29,-10,39,53,42
26,den405d.map,40,69,2313,33,32,6,36,869,12,27,27,41,21,-5,26,27,71
27,den405d.map,40,69,114,1,23,38,45,876,12,20,27,48,-11,-3,14,15,15
28,den405d.map,40,69,1032,14,2,25,66,922,13,43,26,25,1,41,42,75,57
29,den405d.map,40,69,281,4,63,35,5,879,12,17,27,51,-8,-46,54,56,169
30,den405d.map,40,69,504,7,47,32,21,1495,21,22,18,46,-14,-25,39,40,82
31,den405d.map,40,69,1835,26,27,13,41,2172,31,35,8,33,-5,8,13,14,14
32,den405d.map,40,69,1833,26,29,13,39,459,6,23,33,45,20,-6,26,28,53
33,den405d.map,40,69,2393,34,21,5,47,161,2,45,37,23,32,24,56,117,118
34,den405d.map,40,69,1219,17,22,22,46,646,9,43,30,25,8,21,29,47,30
35,den405d.map,40,69,611,8,9,31,59,163,2,43,37,25,6,34,40,178,104
36,den405d.map,40,69,294,4,50,35,18,2319,33,26,6,42,-29,-24,53,57,102
37,den405d.map,40,69,1707,24,17,15,51,934,13,31,26,37,11,14,25,33,157
38,den405d.map,40,69,709,10,49,29,19,869,12,27,27,41,-2,-22,24,25,25
39,den405d.map,40,69,259,3,16,36,52,1694,24,30,15,38,-21,14,35,75,37
40,den405d.map,40,69,1976,28,24,11,44,1145,16,27,23,41,12,3,15,16,26
41,den405d.map,40,69,1353,19,26,20,42,51,0,17,39,51,19,-9,28,29,30
42,den405d.map,40,69,592,8,28,31,40,1162,16,10,23,58,-8,-18,26,27,35
43,den405d.map,40,69,300,4,44,35,24,277,4,67,35,1,0,23,23,42,41
44,den405d.map,40,69,1913,27,18,12,50,437,6,45,33,23,21,27,48,90,134
45,den405d.map,40,69,1759,25,34,14,34,1695,24,29,15,39,1,-5,6,7,7
46,den405d.map,40,69,104,1,33,38,35,642,9,47,30,21,-8,14,22,54,71
47,den405d.map,40,69,1560,22,26,17,42,113,1,24,38,44,21,-2,23,50,26
48,den405d.map,40,69,665,9,24,30,44,243,3,32,36,36,6,8,14,17,15
49,den405d.map,40,69,1981,28,19,11,49,1199,17,42,22,26,11,23,34,327,131
50,den405d.map,40,69,2395,34,19,5,49,852,12,44,27,24,22,25,47,297,139
51,den405d.map,40,69,1034,14,0,25,68,1214,17,27,22,41,-3,27,30,85,110
52,den405d.map,40,69,1212,17,29,22,39,461,6,21,33,47,11,-8,19,22,20
53,den405d.map,40,69,656,9,33,30,35,1164,16,8,23,60,-7,-25,32,33,39
54,den405d.map,40,69,1141,16,31,23,37,1279,18,31,21,37,-2,0,2,3,3
55,den405d.map,40,69,736,10,22,29,46,1138,16,34,23,34,-6,12,18,19,19
56,den405d.map,40,69,1418,20,30,19,38,803,11,24,28,44,9,-6,15,16,16
57,den405d.map,40,69,2185,31,22,8,46,517,7,34,32,34,24,12,36,39,90
58,den405d.map,40,69,1913,27,18,12,50,603,8,17,31,51,19,-1,20,84,199
59,den405d.map,40,69,355,5,58,34,10,2179,31,28,8,40,-26,-30,56,226,172
60,den405d.map,40,69,1756,25,37,14,31,2391,34,23,5,45,-9,-14,23,24,24
61,den405d.map,40,69,516,7,35,32,33,1358,19,21,20,47,-12,-14,26,27,32
62,den405d.map,40,69,865,12,31,27,37,609,8,11,31,57,4,-20,24,57,25
63,den405d.map,40,69,2252,32,24,7,44,1421,20,27,19,41,12,3,15,16,18
64,den405d.map,40,69,2385,34,29,5,39,1010,14,24,25,44,20,-5,25,26,40
65,den405d.map,40,69,641,9,48,30,20,423,6,59,33,9,3,11,14,15,15
66,den405d.map,40,69,233,3,42,36,26,2457,35,26,4,42,-32,-16,48,51,325
67,den405d.map,40,69,377,5,36,34,32,367,5,46,34,22,0,10,10,46,68
68,den405d.map,40,69,681,9,8,30,60,1441,20,7,19,61,-11,-1,12,13,13
69,den405d.map,40,69,2258,32,18,7,50,748,10,10,29,58,22,-8,30,123,259
70,den405d.map,40,69,2386,34,28,5,40,1166,16,6,23,62,18,-22,40,339,104
71,den405d.map,40,69,2049,29,20,10,48,163,2,43,37,25,27,23,50,111,123
72,den405d.map,40,69,1896,27,35,12,33,2120,30,18,9,50,-3,-17,20,21,21
73,den405d.map,40,69,120,1,17,38,51,647,9,42,30,26,-8,25,33,99,88
74,den405d.map,40,69,603,8,17,31,51,230,3,45,36,23,5,28,33,146,66
75,den405d.map,40,69,395,5,18,34,50,567,8,53,31,15,-3,35,38,94,120
76,den405d.map,40,69,730,10,28,29,40,2173,31,34,8,34,-21,6,27,99,72
77,den405d.map,40,69,365,5,48,34,20,2181,31,26,8,42,-26,-22,48,51,91
78,den405d.map,40,69,738,10,20,29,48,1023,14,11,25,57,-4,-9,13,14,14
79,den405d.map,40,69,2256,32,20,7,48,710,10,48,29,20,22,28,50,51,118
80,den405d.map,40,69,1968,28,32,11,36,48,0,20,39,48,28,-12,40,42,106
81,den405d.map,40,69,2178,31,29,8,39,428,6,54,33,14,25,25,50,158,240
82,den405d.map,40,69,426,6,56,33,12,638,9,51,30,17,-3,-5,8,9,9
83,den405d.map,40,69,295,4,49,35,19,183,2,23,37,45,2,-26,28,139,122
84,den405d.map,40,69,809,11,18,28,50,2188,31,19,8,49,-20,1,21,149,109
85,den405d.map,40,69,241,3,34,36,34,2530,36,22,3,46,-33,-12,45,99,48
86,den405d.map,40,69,354,5,59,34,9,725,10,33,29,35,-5,-26,31,33,66
87,den405d.map,40,69,1968,28,32,11,36,814,11,13,28,55,17,-19,36,37,86
88,den405d.map,40,69,420,6,62,33,6,644,9,45,30,23,-3,-17,20,21,21
89,den405d.map,40,69,323,4,21,35,47,2454,35,29,4,39,-31,8,39,66,41
90,den405d.map,40,69,2320,33,25,6,43,592,8,28,31,40,25,3,28,29,42
91,den405d.map,40,69,296,4,48,35,20,1014,14,20,25,48,-10,-28,38,42,115
92,den405d.map,40,69,2464,35,19,4,49,2252,32,24,7,44,3,5,8,9,9
93,den405d.map,40,69,739,10,19,29,49,519,7,32,32,36,3,13,16,24,17
94,den405d.map,40,69,1218,17,23,22,45,747,10,11,29,57,7,-12,19,20,20
95,den405d.map,40,69,1980,28,20,11,48,684,9,5,30,63,19,-15,34,110,257
96,den405d.map,40,69,353,5,60,34,8,115,1,22,38,46,4,-38,42,191,143
97,den405d.map,40,69,734,10,24,29,44,1071,15,32,24,36,-5,8,13,14,14
98,den405d.map,40,69,90,1,47,38,21,284,4,60,35,8,-3,13,16,34,27
99,den405d.map,40,69,1441,20,7,19,61,869,12,27,27,41,8,20,28,57,109
0,den407d.map,54,28,1271,45,16,8,11,1415,50,12,3,15,-5,-4,9,10,10
1,den407d.map,54,28,700,25,27,28,0,1414,50,13,3,14,-25,-14,39,86,41
2,den407d.map,54,28,72,2,11,51,16,727,25,0,28,27,-23,-11,34,40,35
3,den407d.map,54,28,1386,49,13,4,14,494,17,9,36,18,32,-4,36,37,48
4,den407d.map,54,28,1040,37,23,16,4,439,15,8,38,19,22,-15,37,48,40
5,den407d.map,54,28,858,30,9,23,18,909,32,14,21,13,-2,5,7,8,8
6,den407d.map,54,28,859,30,8,23,19,1243,44,16,9,11,-14,8,22,39,23
7,den407d.map,54,28,467,16,8,37,19,1182,42,21,11,6,-26,13,39,41,46
8,den407d.map,54,28,1109,39,10,14,17,1165,41,10,12,17,-2,0,2,3,3
9,den407d.map,54,28,329,11,6,42,21,129,4,10,49,17,7,4,11,12,12
10,den407d.map,54,28,1394,49,5,4,22,1237,44,22,9,5,5,17,22,23,23
11,den407d.map,54,28,190,6,5,47,22,783,27,0,26,27,-21,-5,26,30,27
12,den407d.map,54,28,496,17,7,36,20,183,6,12,47,15,11,5,16,59,19
13,den407d.map,54,28,276,9,3,44,24,646,23,25,30,2,-14,22,36,191,47
14,den407d.map,54,28,465,16,10,37,17,235,8,16,45,11,8,6,14,15,15
15,den407d.map,54,28,1128,40,19,13,8,679,24,20,29,7,16,1,17,18,18
16,den407d.map,54,28,129,4,10,49,17,934,33,17,20,10,-29,7,36,85,112
17,den407d.map,54,28,1210,43,21,10,6,445,15,2,38,25,28,-19,47,54,50
18,den407d.map,54,28,352,12,11,41,16,679,24,20,29,7,-12,9,21,36,25
19,den407d.map,54,28,1178,42,25,11,2,379,13,12,40,15,29,-13,42,219,55
20,den407d.map,54,28,1444,51,11,2,16,237,8,14,45,13,43,3,46,47,47
21,den407d.map,54,28,762,27,21,26,6,580,20,7,33,20,7,-14,21,28,22
22,den407d.map,54,28,649,23,22,30,5,1247,44,12,9,15,-21,-10,31,32,36
23,den407d.map,54,28,723,25,4,28,23,1245,44,14,9,13,-19,10,29,66,206
24,den407d.map,54,28,736,26,19,27,8,1017,36,18,17,9,-10,-1,11,12,12
25,den407d.map,54,28,689,24,10,29,17,1282,45,5,8,22,-21,-5,26,27,27
26,den407d.map,54,28,1056,37,7,16,20,734,26,21,27,6,11,14,25,26,26
27,den407d.map,54,28,662,23,9,30,18,1015,36,20,17,7,-13,11,24,25,29
28,den407d.map,54,28,100,3,11,50,16,1006,35,1,18,26,-32,-10,42,230,47
29,den407d.map,54,28,1172,41,3,12,24,740,26,15,27,12,15,12,27,30,28
30,den407d.map,54,28,1041,37,22,16,5,467,16,8,37,19,21,-14,35,44,37
31,den407d.map,54,28,299,10,8,43,19,1027,36,8,17,19,-26,0,26,29,29
32,den407d.map,54,28,1016,36,19,17,8,858,30,9,23,18,6,-10,16,17,17
33,den407d.map,54,28,882,31,13,22,14,1366,48,5,5,22,-17,-8,25,26,26
34,den407d.map,54,28,363,12,0,41,27,526,18,5,35,22,-6,5,11,12,12
35,den407d.map,54,28,360,12,3,41,24,801,28,10,25,17,-16,7,23,24,24
36,den407d.map,54,28,192,6,3,47,24,1395,49,4,4,23,-43,1,44,234,160
37,den407d.map,54,28,381,13,10,40,17,903,32,20,21,7,-19,10,29,37,34
38,den407d.map,54,28,958,34,21,19,6,135,4,4,49,23,30,-17,47,54,94
39,den407d.map,54,28,947,33,4,20,23,971,34,8,19,19,-1,4,5,6,6
40,den407d.map,54,28,1217,43,14,10,13,1262,45,25,8,2,-2,11,13,14,14
41,den407d.map,54,28,1183,42,20,11,7,351,12,12,41,15,30,-8,38,156,50
42,den407d.map,54,28,903,32,20,21,7,1335,47,8,6,19,-15,-12,27,28,28
43,den407d.map,54,28,525,18,6,35,21,303,10,4,43,23,8,-2,10,11,11
44,den407d.map,54,28,1160,41,15,12,12,291,10,16,43,11,31,1,32,146,88
45,den407d.map,54,28,417,14,2,39,25,819,29,20,24,7,-15,18,33,38,38
46,den407d.map,54,28,348,12,15,41,12,1174,41,1,12,26,-29,-14,43,164,48
47,den407d.map,54,28,794,28,17,25,10,738,26,17,27,10,2,0,2,3,3
48,den407d.map,54,28,1361,48,10,5,17,1324,47,19,6,8,1,9,10,11,11
49,den407d.map,54,28,1070,38,21,15,6,1254,44,5,9,22,-6,-16,22,23,40
50,den407d.map,54,28,1018,36,17,17,10,750,26,5,27,22,10,-12,22,164,128
51,den407d.map,54,28,1145,40,2,13,25,218,7,5,46,22,33,3,36,117,217
52,den407d.map,54,28,469,16,6,37,21,741,26,14,27,13,-10,8,18,20,19
53,den407d.map,54,28,1322,47,21,6,6,850,30,17,23,10,17,-4,21,22,22
54,den407d.map,54,28,1073,38,18,15,9,725,25,2,28,25,13,-16,29,156,52
55,den407d.map,54,28,1060,37,3,16,24,238,8,13,45,14,29,10,39,47,126
56,den407d.map,54,28,553,19,6,34,21,1300,46,15,7,12,-27,9,36,66,37
57,den407d.map,54,28,217,7,6,46,21,386,13,5,40,22,-6,-1,7,8,8
58,den407d.map,54,28,21,0,6,53,21,919,32,4,21,23,-32,-2,34,240,57
59,den407d.map,54,28,1218,43,13,10,14,978,34,1,19,26,9,-12,21,22,22
60,den407d.map,54,28,210,7,13,46,14,822,29,17,24,10,-22,4,26,56,64
61,den407d.map,54,28,435,15,12,38,15,1367,48,4,5,23,-33,-8,41,96,43
62,den407d.map,54,28,1129,40,18,13,9,1165,41,10,12,17,-1,-8,9,10,10
63,den407d.map,54,28,1235,44,24,9,3,391,13,0,40,27,31,-24,55,66,66
64,den407d.map,54,28,1444,51,11,2,16,76,2,7,51,20,49,-4,53,54,63
65,den407d.map,54,28,765,27,18,26,9,46,1,9,52,18,26,-9,35,37,88
66,den407d.map,54,28,821,29,18,24,9,958,34,21,19,6,-5,3,8,9,9
67,den407d.map,54,28,1115,39,4,14,23,855,30,12,23,15,9,8,17,19,18
68,den407d.map,54,28,1042,37,21,16,6,911,32,12,21,15,5,-9,14,15,15
69,den407d.map,54,28,264,9,15,44,12,407,14,12,39,15,-5,-3,8,9,9
70,den407d.map,54,28,1107,39,12,14,15,531,18,0,35,27,21,-12,33,34,34
71,den407d.map,54,28,1166,41,9,12,18,327,11,8,42,19,30,-1,31,32,32
72,den407d.map,54,28,905,32,18,21,9,1188,42,15,11,12,-10,-3,13,21,14
73,den407d.map,54,28,410,14,9,39,18,797,28,14,25,13,-14,5,19,24,20
74,den407d.map,54,28,1368,48,3,5,24,473,16,2,37,25,32,-1,33,151,160
75,den407d.map,54,28,1138,40,9,13,18,997,35,10,18,17,5,1,6,7,7
76,den407d.map,54,28,1043,37,20,16,7,1166,41,9,12,18,-4,-11,15,16,29
77,den407d.map,54,28,752,26,3,27,24,1415,50,12,3,15,-24,9,33,56,295
78,den407d.map,54,28,326,11,9,42,18,447,15,0,38,27,-4,-9,13,14,14
79,den407d.map,54,28,48,1,7,52,20,491,17,12,36,15,-16,5,21,40,22
80,den407d.map,54,28,969,34,10,19,17,1051,37,12,16,15,-3,2,5,6,6
81,den407d.map,54,28,753,26,2,27,25,859,30,8,23,19,-4,6,10,45,50
82,den407d.map,54,28,678,24,21,29,6,943,33,8,20,19,-9,-13,22,23,29
83,den407d.map,54,28,163,5,4,48,23,1415,50,12,3,15,-45,8,53,64,54
84,den407d.map,54,28,1028,36,7,17,20,613,21,2,32,25,15,-5,20,63,70
85,den407d.map,54,28,555,19,4,34,23,935,33,16,20,11,-14,12,26,27,27
86,den407d.map,54,28,914,32,9,21,18,909,32,14,21,13,0,5,5,6,6
87,den407d.map,54,28,819,29,20,24,7,1117,39,2,14,25,-10,-18,28,29,32
88,den407d.map,54,28,995,35,12,18,15,109,3,2,50,25,32,-10,42,43,59
89,den407d.map,54,28,664,23,7,30,20,71,2,12,51,15,21,5,26,27,27
90,den407d.map,54,28,972,34,7,19,20,709,25,18,28,9,9,11,20,21,21
91,den407d.map,54,28,608,21,7,32,20,1025,36,10,17,17,-15,3,18,19,19
92,den407d.map,54,28,1443,51,12,2,15,973,34,6,19,21,17,-6,23,24,24
93,den407d.map,54,28,690,24,9,29,18,1271,45,16,8,11,-21,7,28,67,29
94,den407d.map,54,28,921,32,2,21,25,1415,50,12,3,15,-18,10,28,29,35
95,den407d.map,54,28,210,7,13,46,14,556,19,3,34,24,-12,-10,22,23,59
96,den407d.map,54,28,1026,36,9,17,18,132,4,7,49,20,32,-2,34,35,35
97,den407d.map,54,28,1140,40,7,13,20,644,23,27,30,0,17,20,37,48,38
98,den407d.map,54,28,1330,47,13,6,14,943,33,8,20,19,14,-5,19,20,21
99,den407d.map,54,28,1126,40,21,13,6,671,23,0,30,27,17,-21,38,45,39
0,den408d.map,42,31,406,13,27,28,3,998,32,24,9,6,-19,-3,22,46,46
1,den408d.map,42,31,624,20,26,21,4,840,27,27,14,3,-7,1,8,21,24
2,den408d.map,42,31,500,16,26,25,4,373,12,29,29,1,4,3,7,8,8
3,den408d.map,42,31,32,1,29,40,1,407,13,26,28,4,-12,-3,15,16,16
4,den408d.map,42,31,1006,32,16,9,14,1007,32,15,9,15,0,-1,1,2,2
5,den408d.map,42,31,624,20,26,21,4,535,17,22,24,8,3,-4,7,8,8
6,den408d.map,42,31,256,8,22,33,8,1216,39,23,2,7,-31,1,32,33,33
7,den408d.map,42,31,1089,35,26,6,4,1044,33,9,8,21,2,-17,19,20,20
8,den408d.map,42,31,409,13,24,28,6,189,6,27,35,3,7,3,10,11,11
9,den408d.map,42,31,816,26,20,15,10,539,17,18,24,12,9,-2,11,12,12
10,den408d.map,42,31,536,17,21,24,9,373,12,29,29,1,5,8,13,14,14
11,den408d.map,42,31,1010,32,12,9,18,220,7,27,34,3,25,15,40,42,58
12,den408d.map,42,31,844,27,23,14,7,629,20,21,21,9,7,-2,9,10,10
13,den408d.map,42,31,1258,40,12,1,18,692,22,20,19,10,18,8,26,28,29
14,den408d.map,42,31,251,8,27,33,3,284,9,25,32,5,-1,-2,3,4,4
15,den408d.map,42,31,1161,37,16,4,14,227,7,20,34,10,30,4,34,35,52
16,den408d.map,42,31,161,5,24,36,6,223,7,24,34,6,-2,0,2,3,3
17,den408d.map,42,31,817,26,19,15,11,501,16,25,25,5,10,6,16,17,17
18,den408d.map,42,31,314,10,26,31,4,1027,33,26,8,4,-23,0,23,72,61
19,den408d.map,42,31,624,20,26,21,4,661,21,20,20,10,-1,-6,7,8,8
20,den408d.map,42,31,1297,41,4,0,26,254,8,24,33,6,33,20,53,55,74
21,den408d.map,42,31,1060,34,24,7,6,942,30,18,11,12,4,-6,10,11,11
22,den408d.map,42,31,1232,39,7,2,23,496,16,30,25,0,23,23,46,48,57
23,den408d.map,42,31,918,29,11,12,19,230,7,17,34,13,22,6,28,61,50
24,den408d.map,42,31,163,5,22,36,8,534,17,23,24,7,-12,1,13,14,14
25,den408d.map,42,31,753,24,21,17,9,470,15,25,26,5,9,4,13,14,14
26,den408d.map,42,31,856,27,11,14,19,537,17,20,24,10,10,9,19,22,49
27,den408d.map,42,31,752,24,22,17,8,501,16,25,25,5,8,3,11,12,12
28,den408d.map,42,31,218,7,29,34,1,1099,35,16,6,14,-28,-13,41,59,42
29,den408d.map,42,31,753,24,21,17,9,1067,34,17,7,13,-10,-4,14,15,15
30,den408d.map,42,31,314,10,26,31,4,876,28,22,13,8,-18,-4,22,23,23
31,den408d.map,42,31,976,31,15,10,15,218,7,29,34,1,24,14,38,39,56
32,den408d.map,42,31,1105,35,10,6,20,1153,37,24,4,6,-2,14,16,17,17
33,den408d.map,42,31,1239,39,0,2,30,407,13,26,28,4,26,26,52,54,68
34,den408d.map,42,31,1202,38,6,3,24,1135,36,11,5,19,2,5,7,8,8
35,den408d.map,42,31,474,15,21,26,9,910,29,19,12,11,-14,-2,16,17,17
36,den408d.map,42,31,1290,41,11,0,19,501,16,25,25,5,25,14,39,41,49
37,den408d.map,42,31,1274,41,27,0,3,1291,41,10,0,20,0,-17,17,31,30
38,den408d.map,42,31,225,7,22,34,8,285,9,24,32,6,-2,2,4,5,5
39,den408d.map,42,31,786,25,19,16,11,971,31,20,10,10,-6,1,7,11,8
40,den408d.map,42,31,200,6,16,35,14,1057,34,27,7,3,-28,11,39,98,43
41,den408d.map,42,31,818,26,18,15,12,754,24,20,17,10,2,2,4,5,5
42,den408d.map,42,31,416,13,17,28,13,946,30,14,11,16,-17,-3,20,31,50
43,den408d.map,42,31,629,20,21,21,9,933,30,27,11,3,-10,6,16,23,17
44,den408d.map,42,31,125,4,29,37,1,869,28,29,13,1,-24,0,24,123,53
45,den408d.map,42,31,884,28,14,13,16,501,16,25,25,5,12,11,23,24,29
46,den408d.map,42,31,445,14,19,27,11,1159,37,18,4,12,-23,-1,24,29,25
47,den408d.map,42,31,473,15,22,26,8,1154,37,23,4,7,-22,1,23,24,24
48,den408d.map,42,31,724,23,19,18,11,998,32,24,9,6,-9,5,14,15,15
49,den408d.map,42,31,1185,38,23,3,7,1222,39,17,2,13,-1,-6,7,8,8
50,den408d.map,42,31,1186,38,22,3,8,1070,34,14,7,16,4,-8,12,13,13
51,den408d.map,42,31,938,30,22,11,8,916,29,13,12,17,1,-9,10,11,11
52,den408d.map,42,31,1213,39,26,2,4,199,6,17,35,13,33,-9,42,46,88
53,den408d.map,42,31,812,26,24,15,6,1029,33,24,8,6,-7,0,7,8,8
54,den408d.map,42,31,755,24,19,17,11,287,9,22,32,8,15,3,18,19,19
55,den408d.map,42,31,1105,35,10,6,20,1036,33,17,8,13,2,7,9,10,10
56,den408d.map,42,31,1130,36,16,5,14,157,5,28,36,2,31,12,43,44,61
57,den408d.map,42,31,498,16,28,25,2,663,21,18,20,12,-5,-10,15,18,16
58,den408d.map,42,31,225,7,22,34,8,1061,34,23,7,7,-27,1,28,29,29
59,den408d.map,42,31,1065,34,19,7,11,1071,34,13,7,17,0,-6,6,7,7
60,den408d.map,42,31,413,13,20,28,10,1223,39,16,2,14,-26,-4,30,41,31
61,den408d.map,42,31,848,27,19,14,11,414,13,19,28,11,14,0,14,15,15
62,den408d.map,42,31,476,15,19,26,11,966,31,25,10,5,-16,6,22,38,23
63,den408d.map,42,31,915,29,14,12,16,1069,34,15,7,15,-5,1,6,7,7
64,den408d.map,42,31,498,16,28,25,2,879,28,19,13,11,-12,-9,21,22,22
65,den408d.map,42,31,980,31,11,10,19,1132,36,14,5,16,-5,3,8,9,9
66,den408d.map,42,31,996,32,26,9,4,901,29,28,12,2,3,2,5,6,6
67,den408d.map,42,31,1298,41,3,0,27,446,14,18,27,12,27,15,42,159,54
68,den408d.map,42,31,756,24,18,17,12,1223,39,16,2,14,-15,-2,17,18,18
69,den408d.map,42,31,32,1,29,40,1,935,30,25,11,5,-29,-4,33,110,60
70,den408d.map,42,31,1101,35,14,6,16,598,19,21,22,9,16,7,23,24,27
71,den408d.map,42,31,721,23,22,18,8,916,29,13,12,17,-6,-9,15,17,16
72,den408d.map,42,31,1183,38,25,3,5,567,18,21,23,9,20,-4,24,25,34
73,den408d.map,42,31,465,15,30,26,0,222,7,25,34,5,8,-5,13,14,17
74,den408d.map,42,31,129,4,25,37,5,943,30,17,11,13,-26,-8,34,48,35
75,den408d.map,42,31,945,30,15,11,15,726,23,17,18,13,7,2,9,10,11
76,den408d.map,42,31,288,9,21,32,9,259,8,19,33,11,1,-2,3,4,4
77,den408d.map,42,31,352,11,19,30,11,722,23,21,18,9,-12,2,14,15,15
78,den408d.map,42,31,968,31,23,10,7,1197,38,11,3,19,-7,-12,19,21,20
79,den408d.map,42,31,1153,37,24,4,6,659,21,22,20,8,16,-2,18,19,21
80,den408d.map,42,31,914,29,15,12,15,187,6,29,35,1,23,14,37,38,55
81,den408d.map,42,31,289,9,20,32,10,1162,37,15,4,15,-28,-5,33,47,34
82,den408d.map,42,31,313,10,27,31,3,756,24,18,17,12,-14,-9,23,30,24
83,den408d.map,42,31,1194,38,14,3,16,965,31,26,10,4,7,12,19,20,20
84,den408d.map,42,31,473,15,22,26,8,503,16,23,25,7,-1,1,2,3,3
85,den408d.map,42,31,976,31,15,10,15,194,6,22,35,8,25,7,32,33,50
86,den408d.map,42,31,1185,38,23,3,7,1039,33,14,8,16,5,-9,14,15,15
87,den408d.map,42,31,595,19,24,22,6,1036,33,17,8,13,-14,-7,21,22,22
88,den408d.map,42,31,969,31,22,10,8,314,10,26,31,4,21,4,25,26,26
89,den408d.map,42,31,32,1,29,40,1,100,3,23,38,7,-2,-6,8,9,9
90,den408d.map,42,31,496,16,30,25,0,1060,34,24,7,6,-18,-6,24,43,60
91,den408d.map,42,31,467,15,28,26,2,846,27,21,14,9,-12,-7,19,20,20
92,den408d.map,42,31,160,5,25,36,5,129,4,25,37,5,1,0,1,2,2
93,den408d.map,42,31,467,15,28,26,2,949,30,11,11,19,-15,-17,32,39,35
94,den408d.map,42,31,406,13,27,28,3,447,14,17,27,13,-1,-10,11,12,12
95,den408d.map,42,31,472,15,23,26,7,413,13,20,28,10,2,-3,5,6,6
96,den408d.map,42,31,664,21,17,20,13,289,9,20,32,10,12,3,15,16,25
97,den408d.map,42,31,1002,32,20,9,10,1229,39,10,2,20,-7,-10,17,18,18
98,den408d.map,42,31,1259,40,11,1,19,694,22,18,19,12,18,7,25,27,32
99,den408d.map,42,31,129,4,25,37,5,476,15,19,26,11,-11,-6,17,18,18
0,den500d.map,417,287,26298,91,105,325,181,60890,212,240,204,46,-121,135,256,7789,4604
1,den500d.map,417,287,10493,36,125,380,161,59462,207,233,209,53,-171,108,279,8163,4263
2,den500d.map,417,287,23306,81,227,335,59,67307,234,137,182,149,-153,-90,243,3318,3972
3,den500d.map,417,287,25178,87,77,329,209,11067,38,125,378,161,49,48,97,219,1034
4,den500d.map,417,287,97088,338,204,78,82,97769,340,97,76,189,-2,-107,109,304,399
5,den500d.map,417,287,40876,142,164,274,122,49212,171,151,245,135,-29,-13,42,48,241
6,den500d.map,417,287,37152,129,157,287,129,97713,340,153,76,133,-211,-4,215,216,216
7,den500d.map,417,287,22444,78,228,338,58,43983,153,214,263,72,-75,-14,89,149,900
8,den500d.map,417,287,95189,331,94,85,192,38869,135,162,281,124,196,68,264,785,6139
9,den500d.map,417,287,118114,411,129,5,157,49119,171,244,245,42,240,115,355,16476,10910
10,den500d.map,417,287,102800,358,232,58,54,61740,215,251,201,35,143,19,162,16560,12572
11,den500d.map,417,287,23714,82,106,334,180,67175,234,269,182,17,-152,163,315,5656,5060
12,den500d.map,417,287,53713,187,242,229,44,96515,336,203,80,83,-149,-39,188,14152,16471
13,den500d.map,417,287,19739,68,63,348,223,97703,340,163,76,123,-272,100,372,2336,489
14,den500d.map,417,287,93172,324,102,92,184,79629,277,156,139,130,47,54,101,537,2108
15,den500d.map,417,287,30562,106,146,310,140,67582,235,149,181,137,-129,3,132,201,310
16,den500d.map,417,287,49429,172,221,244,65,24741,86,227,330,59,86,6,92,1931,656
17,den500d.map,417,287,16856,58,76,358,210,7636,26,112,390,174,32,36,68,1359,2110
18,den500d.map,417,287,97068,338,224,78,62,47423,165,218,251,68,173,-6,179,15176,13698
19,den500d.map,417,287,94185,328,237,88,49,38549,134,195,282,91,194,-42,236,15422,15726
20,den500d.map,417,287,44626,155,145,261,141,36003,125,158,291,128,30,13,43,44,125
21,den500d.map,417,287,31650,110,206,306,80,95997,334,147,82,139,-224,-59,283,5832,11687
22,den500d.map,417,287,22314,77,71,339,215,19702,68,100,348,186,9,29,38,85,39
23,den500d.map,417,287,67748,236,270,180,16,63158,220,268,196,18,16,-2,18,59,35
24,den500d.map,417,287,74376,259,243,157,43,77037,268,165,148,121,-9,-78,87,8970,18270
25,den500d.map,417,287,61467,214,237,202,49,77038,268,164,148,122,-54,-73,127,8906,18306
26,den500d.map,417,287,16602,57,43,359,243,6469,22,131,394,155,35,88,123,2460,2047
27,den500d.map,417,287,25104,87,151,329,135,33946,118,206,298,80,-31,55,86,1873,1504
28,den500d.map,417,287,53520,186,148,230,138,73810,257,235,159,51,-71,87,158,15981,7559
29,den500d.map,417,287,97136,338,156,78,130,101662,354,222,62,64,-16,66,82,88,248
30,den500d.map,417,287,77069,268,133,148,153,71214,248,248,168,38,20,115,135,16246,8331
31,den500d.map,417,287,71784,250,252,166,34,11928,41,125,375,161,209,-127,336,4972,1654
32,den500d.map,417,287,42837,149,212,267,74,104070,362,110,54,176,-213,-102,315,12875,15550
33,den500d.map,417,287,94778,330,218,86,68,80182,279,177,137,109,51,-41,92,5084,3199
34,den500d.map,417,287,40257,140,209,276,77,103094,359,225,57,61,-219,16,235,12586,14428
35,den500d.map,417,287,103956,362,224,54,62,20815,72,135,344,151,290,-89,379,957,6061
36,den500d.map,417,287,68937,240,229,176,57,57730,201,243,215,43,39,14,53,56,54
37,den500d.map,417,287,67280,234,164,182,122,47138,164,216,252,70,70,52,122,8566,8833
38,den500d.map,417,287,77592,270,184,146,102,77247,269,242,147,44,1,58,59,18443,10164
39,den500d.map,417,287,36512,127,223,289,63,118661,413,156,3,130,-286,-67,353,8372,14315
40,den500d.map,417,287,58875,205,246,211,40,2764,9,105,407,181,196,-141,337,1102,2255
41,den500d.map,417,287,33424,116,154,300,132,18881,65,60,351,226,51,-94,145,418,170
42,den500d.map,417,287,63856,222,144,194,142,70186,244,128,172,158,-22,-16,38,60,39
43,den500d.map,417,287,100306,349,143,67,143,2698,9,171,407,115,340,28,368,381,2045
44,den500d.map,417,287,66438,231,145,185,141,76062,265,279,151,7,-34,134,168,16390,7872
45,den500d.map,417,287,52947,184,147,232,139,17774,61,19,355,267,123,-128,251,586,2892
46,den500d.map,417,287,115528,402,132,14,154,65193,227,242,189,44,175,110,285,18446,10647
47,den500d.map,417,287,49500,172,150,244,136,22284,77,101,339,185,95,-49,144,145,145
48,den500d.map,417,287,69526,242,214,174,72,33119,115,172,301,114,127,-42,169,8152,14425
49,den500d.map,417,287,111472,388,170,28,116,96349,335,82,81,204,53,-88,141,343,396
50,den500d.map,417,287,18713,65,228,351,58,115210,401,163,15,123,-336,-65,401,6232,1442
51,den500d.map,417,287,17154,59,65,357,221,45964,160,242,256,44,-101,177,278,5912,974
52,den500d.map,417,287,20140,70,236,346,50,56380,196,158,220,128,-126,-78,204,3982,434
53,den500d.map,417,287,98512,343,215,73,71,51795,180,151,236,135,163,-64,227,616,3136
54,den500d.map,417,287,106896,372,154,44,132,10767,37,138,379,148,335,-16,351,12715,1528
55,den500d.map,417,287,15204,52,6,364,280,16887,58,45,358,241,-6,39,45,46,102
56,den500d.map,417,287,94227,328,195,88,91,9651,33,106,383,180,295,-89,384,770,10371
57,den500d.map,417,287,93915,327,220,89,66,31926,111,217,305,69,216,-3,219,11214,15856
58,den500d.map,417,287,18609,64,45,352,241,70356,245,245,171,41,-181,200,381,8000,4821
59,den500d.map,417,287,19683,68,119,348,167,65300,227,135,189,151,-159,16,175,1509,834
60,den500d.map,417,287,70916,247,259,169,27,59455,207,240,209,46,40,-19,59,60,60
61,den500d.map,417,287,100026,348,136,68,150,28483,99,216,317,70,249,80,329,10595,5552
62,den500d.map,417,287,11345,39,134,377,152,101401,353,196,63,90,-314,62,376,5555,13208
63,den500d.map,417,287,105463,367,152,49,134,100647,350,89,66,197,17,-63,80,398,571
64,den500d.map,417,287,81642,284,152,132,134,49127,171,236,245,50,113,84,197,13041,7467
65,den500d.map,417,287,1616,5,105,411,181,43759,152,151,264,135,-147,46,193,1021,244
66,den500d.map,417,287,57556,200,130,216,156,34214,119,225,297,61,81,95,176,4920,4646
67,den500d.map,417,287,4419,15,172,401,114,36223,126,225,290,61,-111,53,164,381,1983
68,den500d.map,417,287,70472,245,129,171,157,68982,240,184,176,102,5,55,60,145,61
69,den500d.map,417,287,75256,262,224,154,62,6756,23,131,393,155,239,-93,332,8754,14039
70,den500d.map,417,287,6172,21,141,395,145,93631,326,217,90,69,-305,76,381,13978,12639
71,den500d.map,417,287,112025,390,191,26,95,26870,93,107,323,179,297,-84,381,10490,5342
72,den500d.map,417,287,97480,339,99,77,187,63819,222,181,194,105,117,82,199,6577,5337
73,den500d.map,417,287,71617,249,132,167,154,31366,109,203,307,83,140,71,211,8386,5264
74,den500d.map,417,287,2461,8,121,408,165,17727,61,66,355,220,-53,-55,108,1576,1740
75,den500d.map,417,287,8188,28,134,388,152,73764,257,281,159,5,-229,147,376,2681,9637
76,den500d.map,417,287,95755,333,102,83,184,76743,267,172,149,114,66,70,136,3987,3930
77,den500d.map,417,287,114412,398,100,18,186,45189,157,156,259,130,241,56,297,423,4132
78,den500d.map,417,287,80515,280,131,136,155,98863,344,151,72,135,-64,20,84,455,3334
79,den500d.map,417,287,98792,344,222,72,64,63860,222,140,194,146,122,-82,204,741,3796
80,den500d.map,417,287,64992,226,156,190,130,115780,403,167,13,119,-177,11,188,1729,530
81,den500d.map,417,287,69456,242,284,174,2,20745,72,205,344,81,170,-79,249,328,1662
82,den500d.map,417,287,2128,7,167,409,119,112351,391,152,25,134,-384,-15,399,618,408
83,den500d.map,417,287,9616,33,141,383,145,67838,236,180,180,106,-203,39,242,2654,8156
84,den500d.map,417,287,25025,87,230,329,56,68078,237,227,179,59,-150,-3,153,3380,4755
85,den500d.map,417,287,116650,406,158,10,128,62383,217,182,199,104,189,24,213,6318,2261
86,den500d.map,417,287,33419,116,159,300,127,37719,131,164,285,122,-15,5,20,21,21
87,den500d.map,417,287,58881,205,240,211,46,99218,345,83,71,203,-140,-157,297,13699,18758
88,den500d.map,417,287,75625,263,142,153,144,114414,398,98,18,188,-135,-44,179,1715,863
89,den500d.map,417,287,26938,93,39,323,247,30215,105,206,311,80,-12,167,179,3010,1480
90,den500d.map,417,287,70155,244,159,172,127,74486,259,133,157,153,-15,-26,41,42,42
91,den500d.map,417,287,118090,411,153,5,133,118372,412,158,4,128,-1,5,6,7,7
92,den500d.map,417,287,111508,388,134,28,152,118951,414,153,2,133,-26,19,45,46,46
93,den500d.map,417,287,104659,364,95,52,191,100348,349,101,67,185,15,6,21,22,23
94,den500d.map,417,287,19576,68,226,348,60,76070,265,271,151,15,-197,45,242,1656,3353
95,den500d.map,417,287,82805,288,137,128,149,43407,151,216,265,70,137,79,216,11371,8171
96,den500d.map,417,287,106892,372,158,44,128,16574,57,71,359,215,315,-87,402,5906,1793
97,den500d.map,417,287,71465,249,284,167,2,69467,242,273,174,13,7,-11,18,19,19
98,den500d.map,417,287,104264,363,203,53,83,65187,227,248,189,38,136,45,181,16517,12548
99,den500d.map,417,287,42546,148,216,268,70,48293,168,209,248,77,-20,-7,27,38,28
0,den501d.map,337,271,64508,238,260,98,10,53191,196,195,140,75,42,-65,107,108,108
1,den501d.map,337,271,23156,85,149,251,121,78358,289,231,47,39,-204,82,286,2349,7857
2,den501d.map,337,271,77929,287,118,49,152,22587,83,176,253,94,204,58,262,376,263
3,den501d.map,337,271,66403,245,262,91,8,72047,265,38,71,232,-20,-224,244,4245,6683
4,den501d.map,337,271,15329,56,117,280,153,24209,89,180,247,90,-33,63,96,108,296
5,den501d.map,337,271,63710,235,245,101,25,54415,200,55,136,215,35,-190,225,10077,15741
6,den501d.map,337,271,50014,184,120,152,150,27847,102,65,234,205,82,-55,137,1976,336
7,den501d.map,337,271,70952,261,49,75,221,67485,249,264,87,6,12,215,227,5995,4574
8,den501d.map,337,271,57448,211,3,125,267,77449,285,56,51,214,-74,53,127,128,188
9,den501d.map,337,271,44884,165,101,171,169,56662,209,247,127,23,-44,146,190,6243,6944
10,den501d.map,337,271,67628,249,121,87,149,25860,95,155,241,115,154,34,188,383,579
11,den501d.map,337,271,79176,292,226,44,44,24300,89,89,247,181,203,-137,340,1468,1753
12,den501d.map,337,271,81144,299,155,37,115,67935,250,85,86,185,49,-70,119,306,217
13,den501d.map,337,271,29736,109,73,227,197,74607,275,188,61,82,-166,115,281,1606,8019
14,den501d.map,337,271,11809,43,114,293,156,56674,209,235,127,35,-166,121,287,10461,10718
15,den501d.map,337,271,34305,126,111,210,159,66166,244,228,92,42,-118,117,235,11363,7061
16,den501d.map,337,271,34299,126,117,210,153,56068,206,28,130,242,-80,-89,169,7104,4908
17,den501d.map,337,271,60710,224,264,112,6,15318,56,128,280,142,168,-136,304,11567,11254
18,den501d.map,337,271,21003,77,134,259,136,70323,259,136,77,134,-182,2,184,2399,1601
19,den501d.map,337,271,54178,199,21,137,249,57941,213,52,123,218,-14,31,45,46,46
20,den501d.map,337,271,73120,269,49,67,221,56889,209,20,127,250,60,-29,89,131,421
21,den501d.map,337,271,20736,76,130,260,140,73700,271,11,65,259,-195,-119,314,6151,7301
22,den501d.map,337,271,17480,64,134,272,136,77526,286,250,50,20,-222,116,338,2539,7351
23,den501d.map,337,271,74131,273,122,63,148,58159,214,105,122,165,59,-17,76,93,200
24,den501d.map,337,271,25850,95,165,241,105,74604,275,191,61,79,-180,26,206,2193,5656
25,den501d.map,337,271,53832,198,96,138,174,77259,285,246,51,24,-87,150,237,429,1301
26,den501d.map,337,271,75571,278,37,58,233,58461,215,74,121,196,63,37,100,105,291
27,den501d.map,337,271,51337,189,152,147,118,14522,53,111,283,159,136,-41,177,7277,8002
28,den501d.map,337,271,75290,277,47,59,223,62851,231,20,105,250,46,-27,73,82,148
29,den501d.map,337,271,34034,125,111,211,159,57141,210,39,126,231,-85,-72,157,7059,5342
30,den501d.map,337,271,35928,132,114,204,156,53409,197,248,139,22,-65,134,199,5991,7275
31,den501d.map,337,271,58298,215,237,121,33,66693,246,243,90,27,-31,6,37,85,143
32,den501d.map,337,271,64473,237,24,99,246,61830,228,228,108,42,9,204,213,11614,8767
33,den501d.map,337,271,75551,278,57,58,213,64391,237,106,99,164,41,49,90,2285,1227
34,den501d.map,337,271,28075,103,108,233,162,51107,188,111,148,159,-85,3,88,343,221
35,den501d.map,337,271,28064,103,119,233,151,38277,141,204,195,66,-38,85,123,8007,3918
36,den501d.map,337,271,77300,285,205,51,65,79709,294,235,42,35,-9,30,39,40,40
37,den501d.map,337,271,71411,263,132,73,138,66439,245,226,91,44,18,94,112,5837,2369
38,den501d.map,337,271,73941,272,41,64,229,58766,216,40,120,230,56,-1,57,351,360
39,den501d.map,337,271,62778,231,93,105,177,62599,230,1,106,269,1,-92,93,3822,6529
40,den501d.map,337,271,17750,65,135,271,135,54638,201,103,135,167,-136,-32,168,3837,477
41,den501d.map,337,271,73600,271,111,65,159,78030,287,17,49,253,-16,-94,110,112,585
42,den501d.map,337,271,63617,234,67,102,203,61397,226,119,110,151,8,52,60,2365,3296
43,den501d.map,337,271,71368,263,175,73,95,76474,282,218,54,52,-19,43,62,66,81
44,den501d.map,337,271,60659,223,44,113,226,62119,229,210,107,60,-6,166,172,13644,8937
45,den501d.map,337,271,47546,175,149,161,121,89211,329,218,7,52,-154,69,223,4444,622
46,den501d.map,337,271,75032,276,34,60,236,53957,199,242,137,28,77,208,285,3344,4900
47,den501d.map,337,271,75192,277,145,59,125,53669,198,259,138,11,79,114,193,241,361
48,den501d.map,337,271,22639,83,124,253,146,74055,273,198,63,72,-190,74,264,2022,2390
49,den501d.map,337,271,56490,208,148,128,122,72614,267,13,69,257,-59,-135,194,1922,5625
50,den501d.map,337,271,14240,52,122,284,148,41533,153,200,183,70,-101,78,179,7968,6990
51,den501d.map,337,271,37273,137,124,199,146,66980,247,227,89,43,-110,103,213,11041,7268
52,den501d.map,337,271,75041,276,25,60,245,67741,249,8,87,262,27,-17,44,45,45
53,den501d.map,337,271,66994,247,213,89,57,23671,87,176,249,94,160,-37,197,10532,14486
54,den501d.map,337,271,62489,230,111,106,159,72593,267,34,69,236,-37,-77,114,1990,3425
55,den501d.map,337,271,56204,207,163,129,107,88109,325,236,11,34,-118,73,191,3062,2931
56,den501d.map,337,271,59417,219,202,117,68,71478,263,65,73,205,-44,-137,181,5834,14810
57,den501d.map,337,271,64104,236,122,100,148,67806,250,214,86,56,-14,92,106,9144,5182
58,den501d.map,337,271,59102,218,246,118,24,54158,199,41,137,229,19,-205,224,12062,10341
59,den501d.map,337,271,68233,251,58,85,212,51876,191,155,145,115,60,97,157,3466,3791
60,den501d.map,337,271,66280,244,114,92,156,66652,245,13,91,257,-1,-101,102,2788,4742
61,den501d.map,337,271,24850,91,81,245,189,67252,248,226,88,44,-157,145,302,13278,7102
62,den501d.map,337,271,48656,179,123,157,147,77195,284,39,52,231,-105,-84,189,1381,2345
63,den501d.map,337,271,54489,201,252,135,18,60086,221,75,115,195,-20,-177,197,9301,3548
64,den501d.map,337,271,81880,302,232,34,38,88923,328,235,8,35,-26,3,29,30,30
65,den501d.map,337,271,75540,278,68,58,202,63886,235,69,101,201,43,1,44,45,45
66,den501d.map,337,271,73107,269,62,67,208,76742,283,221,53,49,-14,159,173,1469,2542
67,den501d.map,337,271,13170,48,108,288,162,85131,314,233,22,37,-266,125,391,3024,6440
68,den501d.map,337,271,88113,325,232,11,38,49718,183,145,153,125,142,-87,229,440,2342
69,den501d.map,337,271,49441,182,151,154,119,56135,207,232,129,38,-25,81,106,116,433
70,den501d.map,337,271,31856,117,121,219,149,55893,206,203,130,67,-89,82,171,7622,6233
71,den501d.map,337,271,63664,234,20,102,250,75381,278,227,58,43,-44,207,251,4001,5313
72,den501d.map,337,271,62482,230,118,106,152,17239,63,104,273,166,167,-14,181,1573,271
73,den501d.map,337,271,62936,232,206,104,64,31316,115,119,221,151,117,-87,204,7014,13314
74,den501d.map,337,271,71576,264,238,72,32,75245,277,92,59,178,-13,-146,159,161,271
75,den501d.map,337,271,53671,198,257,138,13,68503,252,59,84,211,-54,-198,252,7799,3501
76,den501d.map,337,271,34570,127,117,209,153,41795,154,209,182,61,-27,92,119,7662,3896
77,den501d.map,337,271,67184,247,23,89,247,18309,67,118,269,152,180,95,275,9684,8471
78,den501d.map,337,271,50826,187,121,149,149,78038,287,9,49,261,-100,-112,212,1228,4590
79,den501d.map,337,271,66788,246,148,90,122,45646,168,152,168,118,78,4,82,83,83
80,den501d.map,337,271,71552,264,262,72,8,36915,136,211,200,59,128,-51,179,6948,1349
81,den501d.map,337,271,89194,329,235,7,35,77519,286,257,50,13,43,22,65,233,86
82,den501d.map,337,271,43475,160,155,176,115,23495,86,81,250,189,74,-74,148,3996,8034
83,den501d.map,337,271,5030,18,118,318,152,75790,279,89,57,181,-261,-29,290,3352,3915
84,den501d.map,337,271,77152,284,82,52,188,74490,274,34,62,236,10,-48,58,153,59
85,den501d.map,337,271,75954,280,196,56,74,28118,103,65,233,205,177,-131,308,6997,1633
86,den501d.map,337,271,17774,65,111,271,159,74838,276,228,60,42,-211,117,328,2752,6210
87,den501d.map,337,271,58865,217,212,119,58,64937,239,102,97,168,-22,-110,132,4209,5076
88,den501d.map,337,271,67373,248,105,88,165,75574,278,34,58,236,-30,-71,101,999,2675
89,den501d.map,337,271,44017,162,155,174,115,4221,15,114,321,156,147,-41,188,7625,8032
90,den501d.map,337,271,24294,89,95,247,175,65383,241,198,95,72,-152,103,255,15130,7064
91,den501d.map,337,271,53762,198,166,138,104,26123,96,163,240,107,102,-3,105,8435,7237
92,den501d.map,337,271,53834,198,94,138,176,16139,59,120,277,150,139,26,165,2888,4688
93,den501d.map,337,271,70833,261,168,75,102,17493,64,121,272,149,197,-47,244,5066,3104
94,den501d.map,337,271,78361,289,228,47,42,88667,327,220,9,50,-38,-8,46,71,47
95,den501d.map,337,271,84864,313,229,23,41,39365,145,200,191,70,168,-29,197,6457,3724
96,den501d.map,337,271,51936,191,95,145,175,83234,307,233,29,37,-116,138,254,539,3470
97,den501d.map,337,271,39362,145,203,191,67,58278,215,257,121,13,-70,54,124,1292,4330
98,den501d.map,337,271,25573,94,171,242,99,2054,7,113,329,157,87,-58,145,337,252
99,den501d.map,337,271,76680,282,12,54,258,40714,150,206,186,64,132,194,326,5185,651
0,den502d.map,247,208,33241,159,38,87,169,7869,37,34,209,173,122,-4,126,1346,1740
1,den502d.map,247,208,33564,161,131,85,76,41927,201,88,45,119,-40,-43,83,3462,23773
2,den502d.map,247,208,30144,144,15,102,192,34981,168,170,78,37,-24,155,179,23773,3462
3,den502d.map,247,208,18997,91,138,155,69,39862,191,73,55,134,-100,-65,165,166,166
4,den502d.map,247,208,17714,85,173,161,34,44983,216,152,30,55,-131,-21,152,23773,3462
5,den502d.map,247,208,47307,227,116,19,91,9423,45,144,201,63,182,28,210,909,6636
6,den502d.map,247,208,8705,41,30,205,177,16299,78,132,168,75,-37,102,139,156,637
7,den502d.map,247,208,26300,126,115,120,92,1341,6,114,240,93,120,-1,121,122,122
8,den502d.map,247,208,40929,196,46,50,161,5084,24,115,222,92,172,69,241,480,1194
9,den502d.map,247,208,38008,182,55,64,152,15258,73,133,173,74,109,78,187,190,433
10,den502d.map,247,208,24892,119,67,127,140,7334,35,153,211,54,84,86,170,1020,220
11,den502d.map,247,208,8576,41,159,205,48,38746,186,149,60,58,-145,-10,155,23773,3462
12,den502d.map,247,208,41713,200,94,46,113,8483,40,44,206,163,160,-50,210,263,211
13,den502d.map,247,208,25850,124,149,122,58,27131,130,116,116,91,-6,-33,39,40,40
14,den502d.map,247,208,47305,227,118,19,89,27343,131,112,115,95,96,-6,102,4859,2584
15,den502d.map,247,208,15856,76,159,170,48,42697,205,150,41,57,-129,-9,138,23773,3462
16,den502d.map,247,208,40225,193,126,53,81,19802,95,165,151,42,98,39,137,3462,23773
17,den502d.map,247,208,11762,56,93,190,114,11909,57,154,189,53,-1,61,62,114,396
18,den502d.map,247,208,6692,32,171,214,36,41350,198,41,48,166,-166,-130,296,1260,1464
19,den502d.map,247,208,40905,196,70,50,137,10262,49,137,197,70,147,67,214,549,228
20,den502d.map,247,208,17153,82,110,164,97,15253,73,138,173,69,9,28,37,38,38
21,den502d.map,247,208,32986,158,85,88,122,41675,200,132,46,75,-42,47,89,23773,3462
22,den502d.map,247,208,34368,165,159,81,48,18170,87,133,159,74,78,-26,104,3462,23773
23,den502d.map,247,208,18168,87,135,159,72,17221,82,42,164,165,5,-93,98,99,99
24,den502d.map,247,208,18688,89,31,157,176,20887,100,120,146,87,-11,89,100,101,101
25,den502d.map,247,208,24834,119,125,127,82,12940,62,163,184,44,57,38,95,96,96
26,den502d.map,247,208,36977,177,46,69,161,14411,69,148,177,59,108,102,210,223,741
27,den502d.map,247,208,23368,112,135,134,72,9894,47,89,199,118,65,-46,111,469,119
28,den502d.map,247,208,25881,124,118,122,89,39179,188,132,58,75,-64,14,78,23773,3462
29,den502d.map,247,208,8379,40,148,206,59,37727,181,128,65,79,-141,-20,161,23773,3462
30,den502d.map,247,208,17979,86,116,160,91,13677,65,50,181,157,21,-66,87,88,88
31,den502d.map,247,208,31936,153,95,93,112,11487,55,160,191,47,98,65,163,181,166
32,den502d.map,247,208,20034,96,141,150,66,12156,58,115,188,92,38,-26,64,65,65
33,den502d.map,247,208,32848,157,15,89,192,38145,183,126,63,81,-26,111,137,23773,3462
34,den502d.map,247,208,25195,121,180,125,27,19699,94,60,152,147,27,-120,147,148,244
35,den502d.map,247,208,38393,184,86,62,121,18916,90,11,156,196,94,-75,169,170,170
36,den502d.map,247,208,15741,75,66,171,141,32191,154,48,92,159,-79,-18,97,486,107
37,den502d.map,247,208,44568,214,151,32,56,10450,50,157,196,50,164,6,170,3462,23773
38,den502d.map,247,208,37593,180,54,66,153,41101,197,82,49,125,-17,28,45,46,46
39,den502d.map,247,208,36462,175,145,71,62,5047,24,152,222,55,151,7,158,3462,23773
40,den502d.map,247,208,24162,116,173,130,34,44269,212,34,34,173,-96,-139,235,3874,7450
41,den502d.map,247,208,28616,137,87,109,120,22922,110,165,136,42,27,78,105,1400,2817
42,den502d.map,247,208,27769,133,102,113,105,31004,149,195,97,12,-16,93,109,2453,4204
43,den502d.map,247,208,39562,190,165,56,42,44362,213,149,33,58,-23,-16,39,40,40
44,den502d.map,247,208,15564,74,35,172,172,39391,189,128,57,79,-115,93,208,23773,3462
45,den502d.map,247,208,20083,96,92,150,115,6925,33,146,213,61,63,54,117,409,169
46,den502d.map,247,208,16705,80,142,166,65,38348,184,131,62,76,-104,-11,115,23773,3462
47,den502d.map,247,208,40193,193,158,53,49,27071,130,176,116,31,63,18,81,3462,23773
48,den502d.map,247,208,38189,183,82,63,125,8591,41,144,205,63,142,62,204,533,237
49,den502d.map,247,208,51067,245,100,1,107,12734,61,161,185,46,184,61,245,1027,5238
50,den502d.map,247,208,44777,215,150,31,57,13642,65,85,181,122,150,-65,215,3462,23773
51,den502d.map,247,208,27305,131,150,115,57,28334,136,161,110,46,-5,11,16,17,17
52,den502d.map,247,208,22192,106,63,140,144,18498,88,13,158,194,18,-50,68,103,69
53,den502d.map,247,208,24238,116,97,130,110,22750,109,129,137,78,7,32,39,443,1039
54,den502d.map,247,208,28203,135,84,111,123,29142,140,185,106,22,-5,101,106,2893,3707
55,den502d.map,247,208,45033,216,102,30,105,15101,72,82,174,125,144,-20,164,165,538
56,den502d.map,247,208,16277,78,154,168,53,28829,138,82,108,125,-60,-72,132,133,133
57,den502d.map,247,208,6281,30,166,216,41,26916,129,123,117,84,-99,-43,142,149,143
58,den502d.map,247,208,29472,141,63,105,144,23435,112,68,134,139,29,5,34,35,35
59,den502d.map,247,208,30713,147,70,99,137,22371,107,92,139,115,40,22,62,63,63
60,den502d.map,247,208,14179,68,172,178,35,27262,131,193,115,14,-63,21,84,311,111
61,den502d.map,247,208,16887,81,168,165,39,29711,142,32,104,175,-61,-136,197,8058,374
62,den502d.map,247,208,9907,47,76,199,131,8823,42,120,204,87,5,44,49,475,328
63,den502d.map,247,208,20241,97,142,149,65,6831,32,32,214,175,65,-110,175,1348,252
64,den502d.map,247,208,33474,160,13,86,194,40406,194,153,52,54,-34,140,174,23773,3462
65,den502d.map,247,208,15744,75,63,171,144,23271,111,24,135,183,-36,-39,75,140,82
66,den502d.map,247,208,1755,8,116,238,91,10894,52,129,194,78,-44,13,57,90,97
67,den502d.map,247,208,21952,105,95,141,112,40187,193,164,53,43,-88,69,157,23773,3462
68,den502d.map,247,208,44389,213,122,33,85,48790,234,89,12,118,-21,-33,54,3462,23773
69,den502d.map,247,208,10986,52,37,194,170,28727,138,184,108,23,-86,147,233,497,804
70,den502d.map,247,208,11979,57,84,189,123,25092,120,75,126,132,-63,-9,72,73,73
71,den502d.map,247,208,6733,32,130,214,77,24431,117,112,129,95,-85,-18,103,108,166
72,den502d.map,247,208,27381,131,74,115,133,10455,50,152,196,55,81,78,159,422,172
73,den502d.map,247,208,18280,87,23,159,184,37076,178,155,68,52,-91,132,223,23773,3462
74,den502d.map,247,208,21202,101,13,145,194,11190,53,41,193,166,48,28,76,105,338
75,den502d.map,247,208,33819,162,84,84,123,12020,57,43,189,164,105,-41,146,147,147
76,den502d.map,247,208,16369,78,62,168,145,23381,112,122,134,85,-34,60,94,95,95
77,den502d.map,247,208,27725,133,146,113,61,25399,122,184,124,23,11,38,49,50,50
78,den502d.map,247,208,16336,78,95,168,112,32190,154,49,92,158,-76,-46,122,450,131
79,den502d.map,247,208,38304,184,175,62,32,43846,210,41,36,166,-26,-134,160,3462,23773
80,den502d.map,247,208,40221,193,130,53,77,18582,89,137,157,70,104,7,111,3462,23773
81,den502d.map,247,208,45230,217,113,29,94,15319,73,72,173,135,144,-41,185,187,926
82,den502d.map,247,208,19429,93,122,153,85,19711,94,48,152,159,-1,-74,75,76,76
83,den502d.map,247,208,38440,184,39,62,168,39019,187,84,59,123,-3,45,48,49,49
84,den502d.map,247,208,26246,126,169,120,38,15119,72,64,174,143,54,-105,159,160,160
85,den502d.map,247,208,15220,73,171,173,36,40502,194,57,52,150,-121,-114,235,435,236
86,den502d.map,247,208,22998,110,89,136,118,28062,134,17,112,190,-24,-72,96,2136,1409
87,den502d.map,247,208,14298,68,53,178,154,24994,120,173,126,34,-52,120,172,218,173
88,den502d.map,247,208,42798,205,49,41,158,8911,42,32,204,175,163,-17,180,3332,2485
89,den502d.map,247,208,46064,221,111,25,96,28301,136,194,110,13,85,83,168,5413,5154
90,den502d.map,247,208,46899,225,108,21,99,32590,156,65,90,142,69,-43,112,114,114
91,den502d.map,247,208,26091,125,116,121,91,2813,13,98,233,109,112,-18,130,131,131
92,den502d.map,247,208,22928,110,159,136,48,45101,216,34,30,173,-106,-125,231,3075,6958
93,den502d.map,247,208,22735,109,144,137,63,17167,82,96,164,111,27,-48,75,76,76
94,den502d.map,247,208,44002,211,93,35,114,43628,209,51,37,156,2,-42,44,258,479
95,den502d.map,247,208,15675,75,132,171,75,21342,102,81,144,126,-27,-51,78,79,79
96,den502d.map,247,208,10153,48,38,198,169,23380,112,123,134,84,-64,85,149,156,325
97,den502d.map,247,208,31749,152,74,94,133,11470,55,177,191,30,97,103,200,344,203
98,den502d.map,247,208,38008,182,55,64,152,17845,85,42,161,165,97,-13,110,1082,639
99,den502d.map,247,208,10512,50,95,196,112,7194,34,85,212,122,16,-10,26,27,27
0,den504d.map,224,143,18909,132,109,91,33,16383,114,61,109,81,18,-48,66,3385,3944
1,den504d.map,224,143,9619,67,104,156,38,29845,208,41,15,101,-141,-63,204,3926,834
2,den504d.map,224,143,29569,206,31,17,111,12484,87,99,136,43,119,68,187,586,856
3,den504d.map,224,143,5624,39,95,184,47,5488,38,88,185,54,1,-7,8,9,9
4,den504d.map,224,143,18928,132,90,91,52,5326,37,107,186,35,95,17,112,284,2181
5,den504d.map,224,143,2332,16,98,207,44,765,5,92,218,50,11,-6,17,18,18
6,den504d.map,224,143,26944,188,82,35,60,6941,48,65,175,77,140,-17,157,2700,4968
7,den504d.map,224,143,22361,156,89,67,53,9091,63,60,160,82,93,-29,122,2247,3249
8,den504d.map,224,143,25811,180,71,43,71,27526,192,72,31,70,-12,1,13,14,14
9,den504d.map,224,143,6186,43,105,180,37,17971,125,46,98,96,-82,-59,141,6114,975
10,den504d.map,224,143,19051,133,110,90,32,25143,175,24,48,118,-42,-86,128,984,5732
11,den504d.map,224,143,8617,60,105,163,37,24046,168,120,55,22,-108,15,123,4052,2319
12,den504d.map,224,143,6513,45,64,178,78,30018,209,11,14,131,-164,-53,217,2644,4793
13,den504d.map,224,143,6070,42,78,181,64,775,5,82,218,60,37,4,41,42,42
14,den504d.map,224,143,19052,133,109,90,33,18909,132,109,91,33,1,0,1,2,2
15,den504d.map,224,143,18648,130,84,93,58,14085,98,71,125,71,32,-13,45,143,310
16,den504d.map,224,143,4349,30,83,193,59,13341,93,100,130,42,-63,17,80,925,154
17,den504d.map,224,143,5635,39,84,184,58,8803,61,62,162,80,-22,-22,44,45,45
18,den504d.map,224,143,23113,161,52,62,90,3474,24,100,199,42,137,48,185,1774,3168
19,den504d.map,224,143,18228,127,75,96,67,26526,185,71,38,71,-58,-4,62,201,367
20,den504d.map,224,143,23931,167,92,56,50,16630,116,100,107,42,51,8,59,1582,2449
21,den504d.map,224,143,17185,120,117,103,25,28839,201,46,22,96,-81,-71,152,3738,5457
22,den504d.map,224,143,28584,199,15,24,127,26277,183,34,40,108,16,19,35,241,104
23,den504d.map,224,143,3368,23,63,200,79,14190,99,109,124,33,-76,46,122,267,230
24,den504d.map,224,143,13209,92,89,131,53,8228,57,65,166,77,35,-24,59,101,77
25,den504d.map,224,143,26257,183,54,40,88,892,6,108,217,34,177,54,231,607,3720
26,den504d.map,224,143,24145,168,21,55,121,29022,202,6,21,136,-34,-15,49,135,125
27,den504d.map,224,143,23761,166,119,57,23,1327,9,102,214,40,157,-17,174,2323,5675
28,den504d.map,224,143,9225,64,69,159,73,25109,175,58,48,84,-111,-11,122,1390,2519
29,den504d.map,224,143,7181,50,111,173,31,17373,121,72,102,70,-71,-39,110,286,111
30,den504d.map,224,143,9953,69,56,154,86,22390,156,60,67,82,-87,4,91,1325,2135
31,den504d.map,224,143,31434,219,25,4,117,28589,199,10,24,132,20,-15,35,36,36
32,den504d.map,224,143,4512,31,63,192,79,5943,41,62,182,80,-10,-1,11,12,12
33,den504d.map,224,143,26688,186,52,37,90,1924,13,77,210,65,173,25,198,3882,3423
34,den504d.map,224,143,20488,143,103,80,39,13942,97,71,126,71,46,-32,78,1717,2827
35,den504d.map,224,143,19544,136,46,87,96,21951,153,70,70,72,-17,24,41,304,96
36,den504d.map,224,143,19209,134,95,89,47,19213,134,91,89,51,0,-4,4,5,5
37,den504d.map,224,143,16616,116,114,107,28,15918,111,97,112,45,5,-17,22,229,225
38,den504d.map,224,143,16466,115,121,108,21,30156,210,16,13,126,-95,-105,200,1494,5729
39,den504d.map,224,143,28712,200,30,23,112,3070,21,75,202,67,179,45,224,5042,3374
40,den504d.map,224,143,6521,45,56,178,86,27487,192,111,31,31,-147,55,202,5459,3656
41,den504d.map,224,143,17480,122,108,101,34,30009,209,20,14,122,-87,-88,175,1335,6203
42,den504d.map,224,143,15049,105,108,118,34,18466,129,123,94,19,-24,15,39,40,47
43,den504d.map,224,143,2048,14,96,209,46,7916,55,91,168,51,-41,-5,46,47,47
44,den504d.map,224,143,27208,190,104,33,38,10377,72,61,151,81,118,-43,161,3350,3719
45,den504d.map,224,143,23234,162,74,61,68,28426,198,30,25,112,-36,-44,80,175,81
46,den504d.map,224,143,27516,192,82,31,60,27668,193,73,30,69,-1,-9,10,18,19
47,den504d.map,224,143,10496,73,85,150,57,18970,132,48,91,94,-59,-37,96,4045,2095
48,den504d.map,224,143,7217,50,75,173,67,12773,89,96,134,46,-39,21,60,959,142
49,den504d.map,224,143,27873,194,11,29,131,30871,215,16,8,126,-21,5,26,94,166
50,den504d.map,224,143,4616,32,102,191,40,7182,50,110,173,32,-18,8,26,27,27
51,den504d.map,224,143,18472,129,117,94,25,27573,192,25,31,117,-63,-92,155,1264,6187
52,den504d.map,224,143,5637,39,82,184,60,30014,209,15,14,127,-170,-67,237,3100,5048
53,den504d.map,224,143,19632,137,101,86,41,31999,223,32,0,110,-86,-69,155,237,308
54,den504d.map,224,143,26040,182,128,41,14,4492,31,83,192,59,151,-45,196,3588,6154
55,den504d.map,224,143,29306,204,8,19,134,3187,22,101,201,41,182,93,275,705,5785
56,den504d.map,224,143,9649,67,74,156,68,28559,199,40,24,102,-132,-34,166,3263,4277
57,den504d.map,224,143,9090,63,61,160,81,26468,185,129,38,13,-122,68,190,4378,3827
58,den504d.map,224,143,25537,178,59,45,83,25777,180,105,43,37,-2,46,48,1285,956
59,den504d.map,224,143,24761,173,120,50,22,2324,16,106,207,36,157,-14,171,2366,5614
60,den504d.map,224,143,22829,159,50,64,92,11781,82,87,141,55,77,37,114,2102,821
61,den504d.map,224,143,25194,176,116,47,26,10474,73,107,150,35,103,-9,112,2301,3542
62,den504d.map,224,143,8948,62,60,161,82,16911,118,105,105,37,-56,45,101,1870,109
63,den504d.map,224,143,1800,12,58,211,84,21640,151,95,72,47,-139,37,176,5951,2187
64,den504d.map,224,143,15378,107,65,116,77,18933,132,85,91,57,-25,20,45,316,186
65,den504d.map,224,143,30024,209,5,14,137,8893,62,115,161,27,147,110,257,702,2013
66,den504d.map,224,143,488,3,83,220,59,31446,219,13,4,129,-216,-70,286,3971,5145
67,den504d.map,224,143,6344,44,90,179,52,5915,41,90,182,52,3,0,3,4,4
68,den504d.map,224,143,20538,143,53,80,89,18911,132,107,91,35,11,54,65,3904,2155
69,den504d.map,224,143,16658,116,72,107,70,27695,193,46,30,96,-77,-26,103,2688,3519
70,den504d.map,224,143,8778,61,87,162,55,14667,102,61,121,81,-41,-26,67,6612,2031
71,den504d.map,224,143,23392,163,59,60,83,1500,10,72,213,70,153,13,166,3053,3200
72,den504d.map,224,143,23665,165,72,58,70,2201,15,86,208,56,150,14,164,1941,3906
73,den504d.map,224,143,30154,210,18,13,124,16922,118,94,105,48,92,76,168,468,641
74,den504d.map,224,143,3318,23,113,200,29,22638,158,98,65,44,-135,-15,150,5458,1820
75,den504d.map,224,143,25339,177,114,46,28,24828,173,53,50,89,4,-61,65,1106,1212
76,den504d.map,224,143,16228,113,73,110,69,13783,96,87,127,55,17,14,31,32,32
77,den504d.map,224,143,20240,141,65,82,77,6652,46,68,177,74,95,3,98,1777,4473
78,den504d.map,224,143,4064,28,82,195,60,23241,162,67,61,75,-134,-15,149,2718,1950
79,den504d.map,224,143,31275,218,41,5,101,30862,215,25,8,117,3,-16,19,20,20
80,den504d.map,224,143,26792,187,91,36,51,18644,130,88,93,54,57,-3,60,1483,1880
81,den504d.map,224,143,7233,50,59,173,83,9775,68,91,155,51,-18,32,50,51,51
82,den504d.map,224,143,26331,184,123,39,19,6078,42,70,181,72,142,-53,195,3936,5613
83,den504d.map,224,143,16498,115,89,108,53,25663,179,76,44,66,-64,-13,77,813,557
84,den504d.map,224,143,18050,126,110,97,32,20396,142,52,81,90,-16,-58,74,2198,3500
85,den504d.map,224,143,16791,117,82,106,60,2479,17,94,206,48,100,12,112,565,1722
86,den504d.map,224,143,25624,179,115,44,27,14476,101,109,122,33,78,-6,84,2267,2552
87,den504d.map,224,143,18248,127,55,96,87,18944,132,74,91,68,-5,19,24,783,609
88,den504d.map,224,143,1468,10,104,213,38,13782,96,88,127,54,-86,-16,102,103,103
89,den504d.map,224,143,24177,169,132,54,10,1083,7,60,216,82,162,-72,234,3655,6631
90,den504d.map,224,143,22220,155,87,68,55,18485,129,104,94,38,26,17,43,4385,2180
91,den504d.map,224,143,11768,82,100,141,42,18324,128,122,95,20,-46,22,68,69,88
92,den504d.map,224,143,15672,109,57,114,85,16824,117,49,106,93,-8,-8,16,245,60
93,den504d.map,224,143,16764,117,109,106,33,24758,173,123,50,19,-56,14,70,2447,3905
94,den504d.map,224,143,30874,215,13,8,129,14523,101,62,122,80,114,49,163,212,1034
95,den504d.map,224,143,13769,96,101,127,41,11372,79,67,144,75,17,-34,51,231,58
96,den504d.map,224,143,21645,151,90,72,52,19086,133,75,90,67,18,-15,33,260,461
97,den504d.map,224,143,28005,195,22,28,120,7357,51,78,172,64,144,56,200,4932,2545
98,den504d.map,224,143,19946,139,73,84,69,24378,170,74,53,68,-31,1,32,119,243
99,den504d.map,224,143,19807,138,69,85,73,29431,205,26,18,116,-67,-43,110,320,256
0,den505d.map,432,287,65019,226,129,205,157,99662,347,213,84,73,-121,84,205,3221,7496
1,den505d.map,432,287,22282,77,103,354,183,19022,66,206,365,80,11,103,114,457,115
2,den505d.map,432,287,23035,80,211,351,75,100318,349,131,82,155,-269,-80,349,4860,7436
3,den505d.map,432,287,2416,8,166,423,120,108331,377,154,54,132,-369,-12,381,1016,422
4,den505d.map,432,287,70723,246,165,185,121,36855,128,167,303,119,118,2,120,1208,680
5,den505d.map,432,287,33116,115,175,316,111,14631,50,5,381,281,65,-170,235,876,579
6,den505d.map,432,287,19689,68,113,363,173,113227,394,137,37,149,-326,24,350,3709,1126
7,den505d.map,432,287,65259,227,176,204,110,102660,357,85,74,201,-130,-91,221,3280,7145
8,den505d.map,432,287,14896,51,27,380,259,56955,198,157,233,129,-147,130,277,717,709
9,den505d.map,432,287,27730,96,108,335,178,86510,301,163,130,123,-205,55,260,1421,7440
10,den505d.map,432,287,20621,71,42,360,244,61159,213,258,218,28,-142,216,358,2537,6067
11,den505d.map,432,287,79633,277,152,154,134,69893,243,134,188,152,34,-18,52,53,53
12,den505d.map,432,287,74450,259,169,172,117,96038,334,106,97,180,-75,-63,138,3813,3132
13,den505d.map,432,287,69298,241,155,190,131,103458,360,148,71,138,-119,-7,126,281,127
14,den505d.map,432,287,93451,325,110,106,176,66455,231,128,200,158,94,18,112,6893,5489
15,den505d.map,432,287,70744,246,144,185,142,47397,165,244,266,42,81,100,181,9912,7852
16,den505d.map,432,287,16865,58,67,373,219,73034,254,150,177,136,-196,83,279,304,608
17,den505d.map,432,287,55255,192,135,239,151,30495,106,213,325,73,86,78,164,3661,3800
18,den505d.map,432,287,4458,15,133,416,153,112039,390,177,41,109,-375,44,419,5367,12223
19,den505d.map,432,287,73537,256,221,175,65,18550,64,104,367,182,192,-117,309,2157,14895
20,den505d.map,432,287,67306,234,138,197,148,35711,124,163,307,123,110,25,135,188,406
21,den505d.map,432,287,100857,351,166,80,120,25025,87,230,344,56,264,64,328,9085,6528
22,den505d.map,432,287,20882,72,68,359,218,81923,285,158,146,128,-213,90,303,751,304
23,den505d.map,432,287,26784,93,193,338,93,56675,197,150,234,136,-104,-43,147,354,3155
24,den505d.map,432,287,31473,109,96,322,190,14892,51,31,380,255,58,-65,123,530,2228
25,den505d.map,432,287,72629,253,268,178,18,16574,57,71,374,215,196,-197,393,4699,2152
26,den505d.map,432,287,37160,129,149,302,137,62615,218,237,213,49,-89,88,177,10707,6749
27,den505d.map,432,287,7289,25,172,406,114,97150,338,142,93,144,-313,-30,343,2072,356
28,den505d.map,432,287,29633,103,214,328,72,84523,294,141,137,145,-191,-73,264,3800,8056
29,den505d.map,432,287,19945,69,144,362,142,24028,83,79,348,207,-14,-65,79,854,108
30,den505d.map,432,287,93353,325,208,106,78,116097,404,137,27,149,-79,-71,150,370,409
31,den505d.map,432,287,51699,180,247,251,39,20309,70,67,361,219,110,-180,290,350,1443
32,den505d.map,432,287,85652,298,160,133,126,31413,109,156,322,130,189,-4,193,1131,588
33,den505d.map,432,287,115528,402,132,29,154,86526,301,147,130,139,101,15,116,517,680
34,den505d.map,432,287,112931,393,146,38,140,32220,112,210,319,76,281,64,345,13658,6553
35,den505d.map,432,287,7355,25,106,406,180,26012,90,104,341,182,-65,-2,67,708,630
36,den505d.map,432,287,70170,244,144,187,142,73508,256,250,175,36,-12,106,118,16386,7850
37,den505d.map,432,287,94764,330,232,101,54,2190,7,105,424,181,323,-127,450,1379,13725
38,den505d.map,432,287,54091,188,151,243,135,15037,52,173,379,113,136,22,158,169,195
39,den505d.map,432,287,15092,52,118,379,168,64719,225,142,206,144,-173,24,197,1358,825
40,den505d.map,432,287,113776,396,162,35,124,69202,241,251,190,35,155,89,244,16823,10283
41,den505d.map,432,287,25208,87,47,344,239,12494,43,133,388,153,44,86,130,3789,1105
42,den505d.map,432,287,80794,281,139,150,147,113774,396,164,35,122,-115,25,140,809,144
43,den505d.map,432,287,72109,251,214,180,72,33701,117,164,314,122,134,-50,184,7679,13472
44,den505d.map,432,287,110626,385,155,46,131,112063,390,153,41,133,-5,-2,7,8,8
45,den505d.map,432,287,17627,61,166,370,120,42902,149,147,282,139,-88,-19,107,322,120
46,den505d.map,432,287,61155,213,262,218,24,98343,342,97,89,189,-129,-165,294,13186,16923
47,den505d.map,432,287,16477,57,168,374,118,73903,257,142,174,144,-200,-26,226,786,240
48,den505d.map,432,287,56285,196,253,235,33,69295,241,158,190,128,-45,-95,140,8249,12689
49,den505d.map,432,287,24904,86,64,345,222,112912,393,165,38,121,-307,101,408,3445,10074
50,den505d.map,432,287,74473,259,146,172,140,28831,100,155,331,131,159,9,168,169,450
51,den505d.map,432,287,102593,357,152,74,134,76197,265,144,166,142,92,-8,100,101,101
52,den505d.map,432,287,11314,39,165,392,121,42830,149,219,282,67,-110,54,164,404,303
53,den505d.map,432,287,7609,26,139,405,147,70710,246,178,185,108,-220,39,259,2638,8100
54,den505d.map,432,287,56667,197,158,234,128,55245,192,145,239,141,5,-13,18,19,19
55,den505d.map,432,287,70169,244,145,187,141,26259,91,144,340,142,153,-1,154,729,539
56,den505d.map,432,287,53232,185,149,246,137,14274,49,75,382,211,136,-74,210,2451,1499
57,den505d.map,432,287,15137,52,73,379,213,115207,401,166,30,120,-349,93,442,3228,8076
58,den505d.map,432,287,23474,81,59,350,227,36806,128,216,303,70,-47,157,204,727,1684
59,den505d.map,432,287,98265,342,175,89,111,97181,338,111,93,175,4,-64,68,245,69
60,den505d.map,432,287,52363,182,157,249,129,80228,279,131,152,155,-97,-26,123,517,126
61,den505d.map,432,287,39392,137,213,294,73,93618,326,230,105,56,-189,17,206,15878,13603
62,den505d.map,432,287,39114,136,204,295,82,67571,235,160,196,126,-99,-44,143,7643,8610
63,den505d.map,432,287,19480,67,35,364,251,103741,361,152,70,134,-294,117,411,1390,7850
64,den505d.map,432,287,118394,412,136,19,150,24483,85,198,346,88,327,62,389,9927,3197
65,den505d.map,432,287,72059,251,264,180,22,24735,86,233,345,53,165,-31,196,5063,1807
66,den505d.map,432,287,11912,41,141,390,145,2476,8,106,423,180,33,-35,68,203,149
67,den505d.map,432,287,64162,223,125,208,161,101934,355,237,76,49,-132,112,244,3253,7671
68,den505d.map,432,287,43182,150,154,281,132,67559,235,172,196,114,-85,18,103,409,660
69,den505d.map,432,287,78747,274,177,157,109,99125,345,176,86,110,-71,-1,72,1790,4204
70,den505d.map,432,287,64043,223,244,208,42,30035,104,99,327,187,119,-145,264,5661,7072
71,den505d.map,432,287,16291,56,67,375,219,2414,8,168,423,118,48,101,149,976,1228
72,den505d.map,432,287,44624,155,147,276,139,76377,266,251,165,35,-111,104,215,11754,7461
73,den505d.map,432,287,113785,396,153,35,133,29411,102,149,329,137,294,-4,298,299,299
74,den505d.map,432,287,66170,230,126,201,160,21660,75,151,356,135,155,25,180,183,754
75,den505d.map,432,287,24487,85,194,346,92,59559,207,136,224,150,-122,-58,180,920,3093
76,den505d.map,432,287,93641,326,207,105,79,122404,426,144,5,142,-100,-63,163,544,407
77,den505d.map,432,287,46266,161,227,270,59,58011,202,249,229,37,-41,22,63,64,72
78,den505d.map,432,287,79037,275,174,156,112,17167,59,52,372,234,216,-122,338,677,1695
79,den505d.map,432,287,54377,189,152,242,134,4418,15,173,416,113,174,21,195,204,375
80,den505d.map,432,287,21416,74,108,357,178,100299,349,150,82,136,-275,42,317,318,318
81,den505d.map,432,287,114086,397,139,34,147,67783,236,235,195,51,161,96,257,19528,9747
82,den505d.map,432,287,84787,295,164,136,122,67028,233,129,198,157,62,-35,97,98,98
83,den505d.map,432,287,68984,240,182,191,104,54390,189,139,242,147,51,-43,94,95,458
84,den505d.map,432,287,13321,46,167,385,119,16477,57,168,374,118,-11,1,12,13,13
85,den505d.map,432,287,112616,392,174,39,112,41974,146,214,285,72,246,40,286,15370,12139
86,den505d.map,432,287,41978,146,210,285,76,53229,185,152,246,134,-39,-58,97,4351,6420
87,den505d.map,432,287,112360,391,143,40,143,75352,262,128,169,158,129,-15,144,3727,1651
88,den505d.map,432,287,24359,84,35,347,251,2735,9,134,422,152,75,99,174,3196,1579
89,den505d.map,432,287,75266,262,214,169,72,121815,424,159,7,127,-162,-55,217,9836,20617
90,den505d.map,432,287,9298,32,172,399,114,50260,175,251,256,35,-143,79,222,1482,2823
91,den505d.map,432,287,75494,263,273,168,13,26927,93,50,338,236,170,-223,393,6235,2892
92,den505d.map,432,287,76680,267,235,164,51,60118,209,151,222,135,58,-84,142,7318,18376
93,den505d.map,432,287,21773,75,38,356,248,74790,260,116,171,170,-185,78,263,4943,5344
94,den505d.map,432,287,54092,188,150,243,136,34781,121,232,310,54,67,82,149,4231,3738
95,den505d.map,432,287,100633,350,103,81,183,99086,345,215,86,71,5,112,117,118,118
96,den505d.map,432,287,118384,412,146,19,140,73063,254,121,177,165,158,-25,183,2249,1389
97,den505d.map,432,287,59434,207,261,224,25,110343,384,151,47,135,-177,-110,287,7493,16911
98,den505d.map,432,287,22043,76,55,355,231,62116,216,162,215,124,-140,107,247,1350,2375
99,den505d.map,432,287,9081,31,102,400,184,2463,8,119,423,167,23,17,40,41,41
0,den510d.map,451,290,99683,343,76,107,213,103815,357,4,93,285,-14,-72,86,799,143
1,den510d.map,451,290,127704,440,185,10,104,47124,162,145,288,144,278,-40,318,16827,42968
2,den510d.map,451,290,35201,121,178,329,111,78237,269,62,181,227,-148,-116,264,3804,11866
3,den510d.map,451,290,23928,82,141,368,148,31377,108,232,342,57,-26,91,117,118,218
4,den510d.map,451,290,60064,207,255,243,34,34852,120,237,330,52,87,-18,105,106,119
5,den510d.map,451,290,45362,156,167,294,122,69613,240,276,210,13,-84,109,193,1595,6284
6,den510d.map,451,290,24848,85,91,365,198,47664,164,185,286,104,-79,94,173,2179,419
7,den510d.map,451,290,22195,76,134,374,155,89245,307,74,143,215,-231,-60,291,22522,12497
8,den510d.map,451,290,32075,110,114,340,175,64958,223,1,227,288,-113,-113,226,1766,3372
9,den510d.map,451,290,77881,268,128,182,161,93331,321,48,129,241,-53,-80,133,4829,6829
10,den510d.map,451,290,69355,239,244,211,45,48533,167,186,283,103,72,-58,130,6979,1185
11,den510d.map,451,290,80925,279,274,171,15,94142,324,107,126,182,-45,-167,212,3760,8270
12,den510d.map,451,290,128353,442,116,8,173,17549,60,140,390,149,382,24,406,27884,44524
13,den510d.map,451,290,123736,426,93,24,196,22177,76,152,374,137,350,59,409,28918,42873
14,den510d.map,451,290,31301,107,18,343,271,54518,187,1,263,288,-80,-17,97,98,98
15,den510d.map,451,290,97960,337,59,113,230,48887,168,122,282,167,169,63,232,8063,12892
16,den510d.map,451,290,92760,319,39,131,250,120548,415,91,35,198,-96,52,148,6209,3878
17,den510d.map,451,290,83384,287,135,163,154,56698,195,141,255,148,92,6,98,379,258
18,den510d.map,451,290,127844,440,45,10,244,50389,173,70,277,219,267,25,292,45586,35672
19,den510d.map,451,290,48760,168,249,282,40,77547,267,172,183,117,-99,-77,176,244,507
20,den510d.map,451,290,30720,105,19,345,270,29940,103,219,347,70,2,200,202,4263,18515
21,den510d.map,451,290,17544,60,145,390,144,56426,194,123,256,166,-134,-22,156,157,157
22,den510d.map,451,290,56712,195,127,255,162,29270,100,19,350,270,95,-108,203,10738,3083
23,den510d.map,451,290,73160,252,209,198,80,32284,111,195,339,94,141,-14,155,9819,2948
24,den510d.map,451,290,101931,351,148,99,141,41300,142,169,308,120,209,21,230,3886,3947
25,den510d.map,451,290,42778,147,141,303,148,50031,172,138,278,151,-25,-3,28,29,29
26,den510d.map,451,290,44794,154,155,296,134,77357,266,72,184,217,-112,-83,195,2363,394
27,den510d.map,451,290,122899,423,60,27,229,127868,440,21,10,268,-17,-39,56,1937,2245
28,den510d.map,451,290,63745,219,54,231,235,73940,254,9,196,280,-35,-45,80,979,649
29,den510d.map,451,290,62768,216,161,234,128,57726,199,273,251,16,17,112,129,217,130
30,den510d.map,451,290,51060,176,269,274,20,48630,167,89,283,200,9,-180,189,27290,2189
31,den510d.map,451,290,95278,328,131,122,158,82511,284,138,166,151,44,7,51,1924,1695
32,den510d.map,451,290,62602,215,37,235,252,47591,164,258,286,31,51,221,272,3252,359
33,den510d.map,451,290,49904,172,265,278,24,80643,278,266,172,23,-106,1,107,1057,666
34,den510d.map,451,290,78804,271,75,179,214,39300,135,139,315,150,136,64,200,333,2633
35,den510d.map,451,290,114146,393,113,57,176,101925,351,154,99,135,42,41,83,7005,14075
36,den510d.map,451,290,121210,417,9,33,280,61935,213,124,237,165,204,115,319,16037,12434
37,den510d.map,451,290,49617,171,262,279,27,81063,279,136,171,153,-108,-126,234,876,705
38,den510d.map,451,290,82775,285,164,165,125,58199,200,90,250,199,85,-74,159,426,160
39,den510d.map,451,290,82545,284,104,166,185,56254,193,5,257,284,91,-99,190,1418,3818
40,den510d.map,451,290,60123,207,196,243,93,31876,109,23,341,266,98,-173,271,12206,2316
41,den510d.map,451,290,52588,181,191,269,98,92079,317,140,133,149,-136,-51,187,4677,5681
42,den510d.map,451,290,69652,240,237,210,52,102615,353,44,97,245,-113,-193,306,3991,910
43,den510d.map,451,290,77894,268,115,182,174,28550,98,159,352,130,170,44,214,216,508
44,den510d.map,451,290,94146,324,103,126,186,79748,274,1,176,288,50,-102,152,725,227
45,den510d.map,451,290,125659,433,200,17,89,101750,350,39,100,250,83,-161,244,7047,10398
46,den510d.map,451,290,25801,88,8,362,281,56934,196,195,254,94,-108,187,295,3603,10830
47,den510d.map,451,290,97296,335,143,115,146,30919,106,110,344,179,229,-33,262,3399,12689
48,den510d.map,451,290,101360,349,139,101,150,42252,145,87,305,202,204,-52,256,36008,16983
49,den510d.map,451,290,65590,226,239,224,50,18438,63,121,387,168,163,-118,281,786,5728
50,den510d.map,451,290,122836,423,123,27,166,59087,203,72,247,217,220,-51,271,14879,29457
51,den510d.map,451,290,101992,351,87,99,202,26284,90,105,360,184,261,18,279,8234,19094
52,den510d.map,451,290,100467,346,162,104,127,72575,250,214,200,75,96,52,148,149,493
53,den510d.map,451,290,47730,164,119,286,170,32302,111,177,339,112,53,58,111,2419,412
54,den510d.map,451,290,69037,238,272,212,17,37679,129,20,321,269,109,-252,361,18556,1655
55,den510d.map,451,290,99611,343,148,107,141,48637,167,82,283,207,176,-66,242,36932,16098
56,den510d.map,451,290,55753,192,216,258,73,101188,348,21,102,268,-156,-195,351,7714,1319
57,den510d.map,451,290,58264,200,25,250,264,79003,272,166,178,123,-72,141,213,214,1022
58,den510d.map,451,290,121699,419,100,31,189,60469,208,140,242,149,211,40,251,17131,32225
59,den510d.map,451,290,71445,246,184,204,105,26502,91,177,359,112,155,-7,162,10574,5144
60,den510d.map,451,290,115024,396,105,54,184,41589,143,170,307,119,253,65,318,17556,42258
61,den510d.map,451,290,38901,134,248,316,41,31959,110,230,340,59,24,-18,42,43,43
62,den510d.map,451,290,76105,262,164,188,125,54361,187,158,263,131,75,-6,81,385,90
63,den510d.map,451,290,28775,99,224,351,65,85351,294,198,156,91,-195,-26,221,2407,5360
64,den510d.map,451,290,26540,91,139,359,150,29287,100,2,350,287,-9,-137,146,14480,4227
65,den510d.map,451,290,38262,131,17,319,272,13903,47,16,403,273,84,-1,85,86,86
66,den510d.map,451,290,58626,202,243,248,46,104604,360,85,90,204,-158,-158,316,6153,469
67,den510d.map,451,290,108308,373,151,77,138,54518,187,1,263,288,186,-150,336,970,4686
68,den510d.map,451,290,39716,136,13,314,276,124502,429,197,21,92,-293,184,477,30637,11065
69,den510d.map,451,290,20186,69,113,381,176,61523,212,246,238,43,-143,133,276,5792,874
70,den510d.map,451,290,106263,366,166,84,123,61135,210,54,240,235,156,-112,268,6206,5124
71,den510d.map,451,290,38176,131,103,319,186,23419,80,70,370,219,51,-33,84,758,1319
72,den510d.map,451,290,122264,421,115,29,174,104604,360,85,90,204,61,-30,91,5369,7810
73,den510d.map,451,290,49101,169,198,281,91,101734,350,55,100,234,-181,-143,324,11629,10674
74,den510d.map,451,290,74610,257,209,193,80,47311,163,248,287,41,94,39,133,2190,225
75,den510d.map,451,290,116820,402,49,48,240,73230,252,139,198,150,150,90,240,16306,20000
76,den510d.map,451,290,27617,95,222,355,67,64413,222,256,228,33,-127,34,161,182,164
77,den510d.map,451,290,97076,334,73,116,216,127118,438,191,12,98,-104,118,222,10145,6941
78,den510d.map,451,290,25072,86,157,364,132,19421,66,8,384,281,20,-149,169,15854,4218
79,den510d.map,451,290,85875,296,254,154,35,80557,277,62,173,227,19,-192,211,1384,9873
80,den510d.map,451,290,85187,293,72,157,217,62239,214,110,236,179,79,38,117,3592,14329
81,den510d.map,451,290,35650,122,19,328,270,37333,128,76,322,213,-6,57,63,16101,16177
82,den510d.map,451,290,80417,277,202,173,87,46801,161,178,289,111,116,-24,140,5165,1301
83,den510d.map,451,290,107865,371,14,79,275,82823,285,116,165,173,86,102,188,13230,4983
84,den510d.map,451,290,107256,369,43,81,246,105397,363,162,87,127,6,119,125,600,1138
85,den510d.map,451,290,64466,222,203,228,86,75383,259,16,191,273,-37,-187,224,12221,952
86,den510d.map,451,290,59395,204,54,246,235,45995,158,114,292,175,46,60,106,917,1487
87,den510d.map,451,290,60665,209,234,241,55,61637,212,132,238,157,-3,-102,105,106,106
88,den510d.map,451,290,123068,424,181,26,108,34052,117,167,333,122,307,-14,321,35139,48942
89,den510d.map,451,290,93827,323,132,127,157,100573,346,56,104,233,-23,-76,99,100,100
90,den510d.map,451,290,103737,357,82,93,207,48572,167,147,283,142,190,65,255,5862,11196
91,den510d.map,451,290,30208,104,241,346,48,27903,96,226,354,63,8,-15,23,26,24
92,den510d.map,451,290,58098,200,191,250,98,56918,196,211,254,78,4,20,24,25,25
93,den510d.map,451,290,81916,282,153,168,136,62133,214,216,236,73,68,63,131,133,438
94,den510d.map,451,290,83029,286,200,164,89,66287,228,122,222,167,58,-78,136,764,142
95,den510d.map,451,290,59510,205,229,245,60,109158,376,171,74,118,-171,-58,229,230,230
96,den510d.map,451,290,28691,98,18,352,271,76172,262,97,188,192,-164,79,243,5861,9590
97,den510d.map,451,290,42522,146,107,304,182,69093,238,216,212,73,-92,109,201,1462,473
98,den510d.map,451,290,120057,413,2,37,287,123531,425,8,25,281,-12,6,18,19,19
99,den510d.map,451,290,28536,98,173,352,116,100026,344,23,106,266,-246,-150,396,18883,19476
0,den520d.map,239,250,13988,55,11,183,238,33831,135,168,103,81,-80,157,237,10775,698
1,den520d.map,239,250,22835,91,164,147,85,10995,43,4,195,245,48,-160,208,915,3340
2,den520d.map,239,250,12064,48,185,190,64,16182,64,67,174,182,-16,-118,134,757,612
3,den520d.map,239,250,12080,48,169,190,80,10575,42,174,196,75,6,5,11,12,12
4,den520d.map,239,250,16060,64,189,174,60,22119,88,130,150,119,-24,-59,83,99,240
5,den520d.map,239,250,26411,105,88,133,161,22356,89,143,149,106,16,55,71,133,72
6,den520d.map,239,250,12241,48,8,190,241,37141,148,108,90,141,-100,100,200,616,410
7,den520d.map,239,250,41106,164,143,74,106,51571,206,178,32,71,-42,35,77,78,78
8,den520d.map,239,250,35051,140,198,98,51,14678,58,71,180,178,82,-127,209,1194,6172
9,den520d.map,239,250,57358,229,141,9,108,11607,46,142,192,107,183,1,184,9617,11258
10,den520d.map,239,250,39652,158,97,80,152,48719,194,30,44,219,-36,-67,103,109,144
11,den520d.map,239,250,27925,111,74,127,175,12885,51,114,187,135,60,40,100,2676,236
12,den520d.map,239,250,26352,105,147,133,102,45978,183,21,55,228,-78,-126,204,247,258
13,den520d.map,239,250,10929,43,70,195,179,39674,158,75,80,174,-115,5,120,418,345
14,den520d.map,239,250,14929,59,70,179,179,41613,166,136,72,113,-107,66,173,1163,189
15,den520d.map,239,250,40162,160,87,78,162,13679,54,70,184,179,106,-17,123,127,124
16,den520d.map,239,250,48974,195,25,43,224,3239,12,10,226,239,183,-15,198,3689,5094
17,den520d.map,239,250,39917,159,82,79,167,7382,29,117,209,132,130,35,165,4572,646
18,den520d.map,239,250,25580,102,169,136,80,40919,163,80,75,169,-61,-89,150,151,151
19,den520d.map,239,250,24347,97,152,141,97,3979,15,20,223,229,82,-132,214,1367,282
20,den520d.map,239,250,50209,200,40,38,209,10643,42,106,196,143,158,66,224,253,1640
21,den520d.map,239,250,19937,79,62,159,187,40143,160,106,78,143,-81,44,125,466,126
22,den520d.map,239,250,25345,101,154,137,95,48085,192,164,46,85,-91,10,101,3176,7208
23,den520d.map,239,250,17676,70,73,168,176,26670,106,79,132,170,-36,6,42,43,43
24,den520d.map,239,250,43418,173,81,65,168,18955,75,44,163,205,98,-37,135,136,189
25,den520d.map,239,250,8331,33,168,205,81,20862,83,137,155,112,-50,-31,81,1976,1113
26,den520d.map,239,250,52753,211,246,27,3,29974,119,25,119,224,92,-221,313,12307,3731
27,den520d.map,239,250,11593,46,156,192,93,47262,189,237,49,12,-143,81,224,7048,11317
28,den520d.map,239,250,20858,83,141,155,108,13671,54,78,184,171,29,-63,92,375,1139
29,den520d.map,239,250,35392,141,107,97,142,26467,105,32,133,217,36,-75,111,3022,1653
30,den520d.map,239,250,11401,45,98,193,151,13549,54,200,184,49,-9,102,111,781,115
31,den520d.map,239,250,51720,206,29,32,220,49699,198,50,40,199,8,21,29,34,30
32,den520d.map,239,250,3994,15,5,223,244,21959,87,40,151,209,-72,35,107,146,136
33,den520d.map,239,250,46002,184,247,54,2,9988,39,11,199,238,145,-236,381,2328,2382
34,den520d.map,239,250,18672,74,77,164,172,11226,44,23,194,226,30,-54,84,1363,90
35,den520d.map,239,250,12056,48,193,190,56,41181,164,68,74,181,-116,-125,241,914,1254
36,den520d.map,239,250,28465,113,34,125,215,53970,215,29,23,220,-102,-5,107,3636,5144
37,den520d.map,239,250,20168,80,81,158,168,12921,51,78,187,171,29,-3,32,33,33
38,den520d.map,239,250,24660,98,89,140,160,36021,144,228,94,21,-46,139,185,3232,1512
39,den520d.map,239,250,15465,61,34,177,215,37123,148,126,90,123,-87,92,179,917,187
40,den520d.map,239,250,37561,150,188,88,61,45828,183,171,55,78,-33,-17,50,51,51
41,den520d.map,239,250,16725,66,24,172,225,41302,165,197,73,52,-99,173,272,2196,1116
42,den520d.map,239,250,21368,85,131,153,118,20332,81,167,157,82,4,36,40,114,41
43,den520d.map,239,250,39099,156,150,82,99,38333,153,166,85,83,3,16,19,20,20
44,den520d.map,239,250,26235,104,14,134,235,27901,111,98,127,151,-7,84,91,1447,1692
45,den520d.map,239,250,2731,10,18,228,231,45719,182,30,56,219,-172,12,184,5076,3610
46,den520d.map,239,250,36664,146,85,92,164,44136,176,113,62,136,-30,28,58,59,59
47,den520d.map,239,250,6476,25,23,213,226,52893,211,106,27,143,-186,83,269,16511,9154
48,den520d.map,239,250,38567,154,182,84,67,44023,176,226,62,23,-22,44,66,67,67
49,den520d.map,239,250,25968,103,31,135,218,21485,85,14,153,235,18,-17,35,36,46
50,den520d.map,239,250,40361,161,138,77,111,9557,38,192,200,57,123,54,177,6239,6699
51,den520d.map,239,250,24400,97,99,141,150,6486,25,13,213,236,72,-86,158,948,214
52,den520d.map,239,250,23118,92,131,146,118,17767,71,232,167,17,21,101,122,277,132
53,den520d.map,239,250,14728,58,21,180,228,20687,82,62,156,187,-24,41,65,66,66
54,den520d.map,239,250,43073,172,176,66,73,21054,84,195,154,54,88,19,107,8470,5760
55,den520d.map,239,250,25659,102,90,136,159,10868,43,131,195,118,59,41,100,101,101
56,den520d.map,239,250,9093,36,156,202,93,14942,59,57,179,192,-23,-99,122,123,466
57,den520d.map,239,250,13676,54,73,184,176,34333,137,166,101,83,-83,93,176,6936,602
58,den520d.map,239,250,51088,204,161,34,88,40275,161,224,77,25,43,63,106,107,107
59,den520d.map,239,250,10877,43,122,195,127,33245,132,4,106,245,-89,-118,207,465,595
60,den520d.map,239,250,8233,32,16,206,233,27971,111,28,127,221,-79,12,91,112,92
61,den520d.map,239,250,38120,152,129,86,120,37178,148,71,90,178,4,-58,62,63,63
62,den520d.map,239,250,38688,154,61,84,188,42314,169,185,69,64,-15,124,139,140,140
63,den520d.map,239,250,13848,55,151,183,98,45713,182,36,56,213,-127,-115,242,2261,8477
64,den520d.map,239,250,22829,91,170,147,79,22837,91,162,147,87,0,-8,8,9,9
65,den520d.map,239,250,50829,203,170,35,79,46279,185,220,53,29,18,50,68,905,172
66,den520d.map,239,250,21838,87,161,151,88,25094,100,155,138,94,-13,-6,19,20,20
67,den520d.map,239,250,482,1,17,237,232,8195,32,54,206,195,-31,37,68,1945,1260
68,den520d.map,239,250,8408,33,91,205,158,10423,41,76,197,173,-8,-15,23,24,24
69,den520d.map,239,250,24371,97,128,141,121,54581,218,168,20,81,-121,40,161,2895,6848
70,den520d.map,239,250,9131,36,118,202,131,44548,178,201,60,48,-142,83,225,6539,7432
71,den520d.map,239,250,12379,49,120,189,129,28231,112,18,126,231,-63,-102,165,240,3682
72,den520d.map,239,250,44090,176,159,62,90,38357,153,142,85,107,23,-17,40,41,41
73,den520d.map,239,250,21920,87,79,151,170,50885,203,114,35,135,-116,35,151,12037,1544
74,den520d.map,239,250,38422,153,77,85,172,57135,228,114,10,135,-75,37,112,5501,1496
75,den520d.map,239,250,22633,90,116,148,133,27125,108,124,130,125,-18,8,26,27,27
76,den520d.map,239,250,8984,35,15,203,234,53708,214,41,24,208,-179,26,205,5067,3389
77,den520d.map,239,250,41828,167,171,71,78,55108,220,141,18,108,-53,-30,83,255,84
78,den520d.map,239,250,50970,203,29,35,220,12412,49,87,189,162,154,58,212,253,2564
79,den520d.map,239,250,11992,47,7,191,242,29113,116,136,122,113,-69,129,198,228,567
80,den520d.map,239,250,9172,36,77,202,172,38509,154,240,84,9,-118,163,281,2372,4491
81,den520d.map,239,250,43311,173,188,65,61,33711,134,38,104,211,39,-150,189,12786,3298
82,den520d.map,239,250,33171,132,78,106,171,54879,219,120,19,129,-87,42,129,6008,1589
83,den520d.map,239,250,51892,207,107,31,142,8614,34,135,204,114,173,28,201,8962,16490
84,den520d.map,239,250,13480,53,19,185,230,38919,155,80,83,169,-102,61,163,164,212
85,den520d.map,239,250,47960,191,39,47,210,40601,162,148,76,101,29,109,138,142,144
86,den520d.map,239,250,13953,55,46,183,203,25478,101,21,137,228,-46,-25,71,72,72
87,den520d.map,239,250,11425,45,74,193,175,49588,198,161,40,88,-153,87,240,1830,470
88,den520d.map,239,250,20600,82,149,156,100,39608,158,141,80,108,-76,-8,84,2916,3407
89,den520d.map,239,250,36176,144,73,94,176,21736,86,13,152,236,58,-60,118,508,1825
90,den520d.map,239,250,8352,33,147,205,102,25906,103,93,135,156,-70,-54,124,1197,1444
91,den520d.map,239,250,10064,40,185,198,64,45778,183,221,55,28,-143,36,179,6848,8905
92,den520d.map,239,250,47218,188,31,50,218,21914,87,85,151,164,101,54,155,193,329
93,den520d.map,239,250,38861,155,138,83,111,33814,135,185,103,64,20,47,67,70,68
94,den520d.map,239,250,27893,111,106,127,143,45295,181,204,57,45,-70,98,168,1121,4911
95,den520d.map,239,250,37596,150,153,88,96,29709,118,40,120,209,32,-113,145,7066,4649
96,den520d.map,239,250,48258,193,241,45,8,35419,141,80,97,169,52,-161,213,1245,217
97,den520d.map,239,250,44400,177,99,61,150,37271,149,228,89,21,28,129,157,260,192
98,den520d.map,239,250,4135,16,114,222,135,45159,180,90,58,159,-164,-24,188,1005,5360
99,den520d.map,239,250,31400,125,99,113,150,50262,201,237,37,12,-76,138,214,231,5597
0,den600d.map,167,352,33843,96,300,70,51,16356,46,187,120,164,50,-113,163,5412,6193
1,den600d.map,167,352,9474,26,29,140,322,57422,163,305,3,46,-137,276,413,6249,7942
2,den600d.map,167,352,4548,12,27,154,324,26367,74,32,92,319,-62,5,67,330,346
3,den600d.map,167,352,43657,124,342,42,9,20322,57,93,109,258,67,-249,316,7393,8241
4,den600d.map,167,352,24440,69,199,97,152,7650,21,93,145,258,48,-106,154,249,601
5,den600d.map,167,352,21640,61,183,105,168,32029,90,2,76,349,-29,-181,210,6013,5784
6,den600d.map,167,352,22651,64,228,102,123,11917,33,50,133,301,31,-178,209,2249,2846
7,den600d.map,167,352,14716,41,67,125,284,45101,128,306,38,45,-87,239,326,9751,6434
8,den600d.map,167,352,14008,39,71,127,280,24287,68,0,98,351,-29,-71,100,1468,1715
9,den600d.map,167,352,23920,67,15,99,336,39903,113,224,53,127,-46,209,255,9444,7744
10,den600d.map,167,352,34121,96,22,70,329,17343,49,256,117,95,47,234,281,8154,7576
11,den600d.map,167,352,27085,76,18,90,333,28334,80,177,86,174,-4,159,163,5840,5440
12,den600d.map,167,352,12606,35,65,131,286,14975,42,160,124,191,-7,95,102,1528,314
13,den600d.map,167,352,32729,92,6,74,345,14269,40,162,126,189,52,156,208,4447,5168
14,den600d.map,167,352,43040,122,255,44,96,34493,97,2,69,349,25,-253,278,9061,6314
15,den600d.map,167,352,9476,26,27,140,324,7999,22,96,144,255,4,69,73,1189,928
16,den600d.map,167,352,21025,59,94,107,257,45086,128,321,38,30,-69,227,296,8149,7484
17,den600d.map,167,352,24033,68,254,98,97,21557,61,266,105,85,7,12,19,20,20
18,den600d.map,167,352,17573,49,26,117,325,32719,92,16,74,335,-43,-10,53,226,54
19,den600d.map,167,352,34597,98,250,68,101,20887,59,232,107,119,39,-18,57,82,80
20,den600d.map,167,352,38760,110,311,56,40,39470,112,305,54,46,-2,-6,8,9,9
21,den600d.map,167,352,19460,55,251,111,100,32788,93,299,73,52,-38,48,86,4610,2953
22,den600d.map,167,352,25270,71,73,95,278,33143,94,296,72,55,-23,223,246,12611,6676
23,den600d.map,167,352,19273,54,86,112,265,40578,115,253,51,98,-61,167,228,2579,4257
24,den600d.map,167,352,26737,75,14,91,337,1337,3,70,163,281,72,56,128,488,214
25,den600d.map,167,352,28834,81,29,85,322,39116,111,307,55,44,-30,278,308,12585,10813
26,den600d.map,167,352,13977,39,102,127,249,17763,50,188,116,163,-11,86,97,779,942
27,den600d.map,167,352,26648,75,103,91,248,23414,66,169,100,182,9,66,75,2387,3136
28,den600d.map,167,352,22634,64,245,102,106,11911,33,56,133,295,31,-189,220,2665,2797
29,den600d.map,167,352,18558,52,97,114,254,23855,67,80,99,271,-15,-17,32,37,33
30,den600d.map,167,352,9372,26,131,140,220,16007,45,184,121,167,-19,53,72,821,611
31,den600d.map,167,352,22264,63,263,103,88,7611,21,132,145,219,42,-131,173,855,620
32,den600d.map,167,352,7912,22,183,144,168,17854,50,97,116,254,-28,-86,114,1907,234
33,den600d.map,167,352,38062,108,305,58,46,12271,34,48,132,303,74,-257,331,5915,12590
34,den600d.map,167,352,54983,156,280,10,71,21599,61,224,105,127,95,-56,151,166,564
35,den600d.map,167,352,25340,71,3,95,348,7991,22,104,144,247,49,101,150,2402,2722
36,den600d.map,167,352,27452,77,3,89,348,41638,118,249,48,102,-41,246,287,6212,8109
37,den600d.map,167,352,29186,82,29,84,322,35589,101,314,65,37,-19,285,304,11987,10814
38,den600d.map,167,352,26209,74,190,92,161,14369,40,62,126,289,34,-128,162,1661,2868
39,den600d.map,167,352,27058,76,45,90,306,26199,74,200,92,151,2,155,157,6097,7608
40,den600d.map,167,352,22689,64,190,102,161,18942,53,65,113,286,11,-125,136,1836,2844
41,den600d.map,167,352,14675,41,108,125,243,25597,72,98,94,253,-31,-10,41,199,498
42,den600d.map,167,352,11564,32,51,134,300,30031,85,240,81,111,-53,189,242,5543,3136
43,den600d.map,167,352,21020,59,99,107,252,40229,114,250,52,101,-55,151,206,2478,5491
44,den600d.map,167,352,16120,45,71,121,280,27087,76,16,90,335,-31,-55,86,1657,2212
45,den600d.map,167,352,46852,133,315,33,36,26750,75,1,91,350,58,-314,372,10136,11956
46,den600d.map,167,352,18931,53,76,113,275,26909,76,194,90,157,-23,118,141,2727,1897
47,den600d.map,167,352,6651,18,36,148,315,13982,39,97,127,254,-21,61,82,251,326
48,den600d.map,167,352,42345,120,246,46,105,32356,91,27,75,324,29,-219,248,8746,6189
49,den600d.map,167,352,9395,26,108,140,243,41997,119,242,47,109,-93,134,227,2759,1884
50,den600d.map,167,352,13005,36,18,130,333,685,1,18,165,333,35,0,35,70,189
51,den600d.map,167,352,19811,56,252,110,99,7911,22,184,144,167,34,-68,102,1616,1153
52,den600d.map,167,352,39517,112,258,54,93,4511,12,64,154,287,100,-194,294,6029,5892
53,den600d.map,167,352,33836,96,307,70,44,3805,10,66,156,285,86,-241,327,8658,12600
54,den600d.map,167,352,13320,37,55,129,296,23725,67,210,99,141,-30,155,185,2880,1651
55,den600d.map,167,352,11800,33,167,133,184,21932,62,243,104,108,-29,76,105,372,376
56,den600d.map,167,352,5946,16,37,150,314,33061,93,26,73,325,-77,-11,88,447,324
57,den600d.map,167,352,39534,112,241,54,110,46479,132,336,34,15,-20,95,115,2631,1933
58,den600d.map,167,352,42640,121,303,45,48,23515,66,68,100,283,55,-235,290,6676,11304
59,den600d.map,167,352,54265,154,294,12,57,30723,87,252,79,99,67,-42,109,909,1400
60,den600d.map,167,352,9818,27,37,139,314,25694,72,1,94,350,-45,-36,81,98,82
61,den600d.map,167,352,43681,124,318,42,33,20515,58,252,108,99,66,-66,132,2993,3016
62,den600d.map,167,352,26370,74,29,92,322,23484,66,99,100,252,8,70,78,2783,2978
63,den600d.map,167,352,35595,101,308,65,43,45101,128,306,38,45,-27,-2,29,256,175
64,den600d.map,167,352,7930,22,165,144,186,40236,114,243,52,108,-92,78,170,1986,774
65,den600d.map,167,352,54956,156,307,10,44,24031,68,256,98,95,88,-51,139,2781,1885
66,den600d.map,167,352,23705,67,230,99,121,6302,17,33,149,318,50,-197,247,2969,4096
67,den600d.map,167,352,1352,3,55,163,296,50378,143,309,23,42,-140,254,394,10442,7672
68,den600d.map,167,352,3107,8,60,158,291,19655,55,56,111,295,-47,-4,51,889,608
69,den600d.map,167,352,24104,68,183,98,168,31786,90,245,76,106,-22,62,84,803,365
70,den600d.map,167,352,10450,29,109,137,242,22074,62,101,104,250,-33,-8,41,430,385
71,den600d.map,167,352,10104,28,103,138,248,20190,57,225,109,126,-29,122,151,1958,1161
72,den600d.map,167,352,45162,128,245,38,106,24884,70,107,96,244,58,-138,196,5962,3973
73,den600d.map,167,352,3130,8,37,158,314,7700,21,43,145,308,-13,6,19,20,20
74,den600d.map,167,352,50425,143,262,23,89,56036,159,283,7,68,-16,21,37,38,38
75,den600d.map,167,352,57780,164,299,2,52,36292,103,315,63,36,61,16,77,80,464
76,den600d.map,167,352,26369,74,30,92,321,52498,149,301,17,50,-75,271,346,11596,10623
77,den600d.map,167,352,10887,30,24,136,327,26311,74,88,92,263,-44,64,108,1571,1816
78,den600d.map,167,352,11451,32,164,134,187,20589,58,178,108,173,-26,14,40,189,41
79,den600d.map,167,352,10726,30,185,136,166,53230,151,273,15,78,-121,88,209,1068,3306
80,den600d.map,167,352,4539,12,36,154,315,27358,77,97,89,254,-65,61,126,366,314
81,den600d.map,167,352,20681,58,86,108,265,8319,23,128,143,223,35,42,77,78,164
82,den600d.map,167,352,21067,59,52,107,299,18743,53,264,113,87,6,212,218,4531,3333
83,den600d.map,167,352,2387,6,76,160,275,2068,5,43,161,308,1,-33,34,516,213
84,den600d.map,167,352,8395,23,52,143,299,4885,13,42,153,309,10,-10,20,40,21
85,den600d.map,167,352,33082,93,5,73,346,22662,64,217,102,134,29,212,241,6032,7326
86,den600d.map,167,352,18132,51,171,115,180,5916,16,67,150,284,35,-104,139,3081,2441
87,den600d.map,167,352,8755,24,44,142,307,1700,4,59,162,292,20,15,35,64,49
88,den600d.map,167,352,22458,63,69,103,282,50020,142,315,24,36,-79,246,325,8128,6672
89,den600d.map,167,352,20884,59,235,107,116,28614,81,249,85,102,-22,14,36,52,61
90,den600d.map,167,352,17351,49,248,117,103,17879,50,72,116,279,-1,-176,177,3027,4507
91,den600d.map,167,352,44387,126,316,40,35,38453,109,266,57,85,17,-50,67,2749,1752
92,den600d.map,167,352,33436,94,3,72,348,3492,9,27,157,324,85,24,109,110,684
93,den600d.map,167,352,16874,47,21,119,330,22629,64,250,102,101,-17,229,246,5631,5921
94,den600d.map,167,352,52176,148,271,18,80,37373,106,290,60,61,42,19,61,2163,1624
95,den600d.map,167,352,23920,67,15,99,336,9125,25,26,141,325,42,11,53,54,82
96,den600d.map,167,352,43678,124,321,42,30,7934,22,161,144,190,102,-160,262,2420,5438
97,den600d.map,167,352,33057,93,30,73,321,12607,35,64,131,287,58,34,92,2259,1994
98,den600d.map,167,352,33129,94,310,72,41,37087,105,224,61,127,-11,-86,97,1941,3525
99,den600d.map,167,352,22981,65,250,101,101,9373,26,130,140,221,39,-120,159,1372,739
0,den601d.map,182,370,22761,61,178,120,191,62404,168,125,13,244,-107,-53,160,1072,3959
1,den601d.map,182,370,11066,29,33,152,336,687,1,52,180,317,28,19,47,54,104
2,den601d.map,182,370,49764,134,185,47,184,51238,138,191,43,178,-4,6,10,11,11
3,den601d.map,182,370,27323,73,56,108,313,53951,145,68,36,301,-72,12,84,1125,3510
4,den601d.map,182,370,44702,120,67,61,302,64558,174,191,7,178,-54,124,178,4387,3796
5,den601d.map,182,370,41355,111,84,70,285,49071,132,138,49,231,-21,54,75,2271,623
6,den601d.map,182,370,18850,50,19,131,350,27470,74,279,107,90,-24,260,284,14665,10243
7,den601d.map,182,370,62752,169,147,12,222,54002,145,17,36,352,24,-130,154,1422,265
8,den601d.map,182,370,51657,139,142,42,227,51018,137,41,44,328,2,-101,103,728,2590
9,den601d.map,182,370,49189,132,20,49,349,44221,119,178,62,191,13,158,171,4828,3324
10,den601d.map,182,370,52794,142,115,39,254,36444,98,185,83,184,44,70,114,823,3119
11,den601d.map,182,370,5160,13,19,168,350,11057,29,42,152,327,-16,23,39,166,332
12,den601d.map,182,370,62784,169,115,12,254,7747,20,22,161,347,149,-93,242,1525,1220
13,den601d.map,182,370,29633,80,336,101,33,56548,152,61,29,308,-72,-275,347,9729,13282
14,den601d.map,182,370,43885,118,144,63,225,63207,170,62,11,307,-52,-82,134,3935,5900
15,den601d.map,182,370,15132,40,37,141,332,66038,178,191,3,178,-138,154,292,7728,9204
16,den601d.map,182,370,10874,29,225,152,144,14550,39,249,142,120,-10,24,34,107,184
17,den601d.map,182,370,53952,145,67,36,302,24891,67,268,114,101,78,201,279,12577,8307
18,den601d.map,182,370,27347,73,32,108,337,3694,9,5,172,364,64,-27,91,100,172
19,den601d.map,182,370,24804,67,355,114,14,8125,21,14,160,355,46,-341,387,10285,15888
20,den601d.map,182,370,50227,135,92,46,277,59052,159,147,22,222,-24,55,79,534,396
21,den601d.map,182,370,5504,14,45,167,324,3650,9,49,172,320,5,4,9,10,10
22,den601d.map,182,370,55494,149,5,32,364,15711,42,198,139,171,107,193,300,11184,6834
23,den601d.map,182,370,56907,153,72,28,297,42470,114,79,67,290,39,7,46,47,47
24,den601d.map,182,370,14561,39,238,142,131,26009,70,260,111,109,-31,22,53,54,62
25,den601d.map,182,370,3654,9,45,172,324,59143,159,56,22,313,-150,11,161,2235,2063
26,den601d.map,182,370,12530,33,49,148,320,50901,137,158,44,211,-104,109,213,6678,8786
27,den601d.map,182,370,60209,162,100,19,269,20125,54,224,127,145,108,124,232,8685,7948
28,den601d.map,182,370,10337,27,22,154,347,52374,141,165,40,204,-114,143,257,7103,4608
29,den601d.map,182,370,59756,161,183,20,186,54015,145,4,36,365,16,-179,195,3067,5214
30,den601d.map,182,370,62755,169,144,12,225,29635,80,334,101,35,89,190,279,7523,4889
31,den601d.map,182,370,63873,172,136,9,233,35316,95,203,86,166,77,67,144,409,412
32,den601d.map,182,370,43577,117,82,64,287,29405,79,194,102,175,38,112,150,2654,4842
33,den601d.map,182,370,52429,141,110,40,259,9950,26,39,155,330,115,-71,186,2988,1436
34,den601d.map,182,370,12729,34,220,147,149,57171,154,178,27,191,-120,-42,162,2636,2545
35,den601d.map,182,370,49938,134,11,47,358,26965,72,44,109,325,62,33,95,1650,410
36,den601d.map,182,370,50617,136,72,45,297,24123,65,296,116,73,71,224,295,13965,8366
37,den601d.map,182,370,59433,160,136,21,233,15349,41,190,140,179,119,54,173,2977,1417
38,den601d.map,182,370,25115,67,44,114,325,39365,106,224,75,145,-39,180,219,9712,10613
39,den601d.map,182,370,15140,40,29,141,340,27838,75,281,106,88,-35,252,287,14680,11209
40,den601d.map,182,370,62400,168,129,13,240,51717,139,82,42,287,29,-47,76,77,77
41,den601d.map,182,370,36992,99,7,82,362,60119,162,190,19,179,-63,183,246,5758,5579
42,den601d.map,182,370,2914,7,45,174,324,49119,132,90,49,279,-125,45,170,2907,3034
43,den601d.map,182,370,54297,146,92,35,277,58668,158,161,23,208,-12,69,81,4439,2134
44,den601d.map,182,370,42011,113,168,68,201,53949,145,70,36,299,-32,-98,130,3615,4731
45,den601d.map,182,370,27318,73,61,108,308,41263,111,176,70,193,-38,115,153,7800,11478
46,den601d.map,182,370,38655,104,194,77,175,47695,128,34,53,335,-24,-160,184,4676,4829
47,den601d.map,182,370,59755,161,184,20,185,34391,92,18,89,351,69,-166,235,5707,6221
48,den601d.map,182,370,20136,54,213,127,156,59454,160,115,21,254,-106,-98,204,2333,6616
49,den601d.map,182,370,49558,133,21,48,348,57983,156,106,25,263,-23,85,108,109,423
50,den601d.map,182,370,18233,49,266,132,103,38092,102,17,79,352,-53,-249,302,9711,13537
51,den601d.map,182,370,33651,90,18,91,351,20683,55,36,126,333,35,18,53,54,245
52,den601d.map,182,370,11797,31,42,150,327,45790,123,89,58,280,-92,47,139,3992,2863
53,den601d.map,182,370,36426,98,203,83,166,24955,67,204,114,165,31,1,32,465,312
54,den601d.map,182,370,51279,138,150,43,219,45407,122,102,59,267,16,-48,64,2243,1666
55,den601d.map,182,370,41337,111,102,70,267,16823,45,196,136,173,66,94,160,5995,8215
56,den601d.map,182,370,38698,104,151,77,218,57604,155,115,26,254,-51,-36,87,2083,2898
57,den601d.map,182,370,54292,146,97,35,272,28687,77,172,104,197,69,75,144,4266,3510
58,den601d.map,182,370,59760,161,179,20,190,16010,43,269,138,100,118,90,208,3765,3548
59,den601d.map,182,370,46809,126,180,55,189,35674,96,215,85,154,30,35,65,103,66
60,den601d.map,182,370,54387,146,2,35,367,19718,53,261,128,108,93,259,352,13346,8315
61,den601d.map,182,370,49476,133,103,48,266,11437,30,32,151,337,103,-71,174,2221,2303
62,den601d.map,182,370,28440,76,49,105,320,21560,58,269,123,100,18,220,238,14006,14607
63,den601d.map,182,370,30416,82,293,99,76,50525,136,164,45,205,-54,-129,183,4044,5929
64,den601d.map,182,370,59833,161,106,20,263,30044,81,295,100,74,80,189,269,9399,4337
65,den601d.map,182,370,15904,42,5,139,364,46228,124,21,57,348,-82,16,98,406,894
66,den601d.map,182,370,16099,43,180,138,189,43133,116,156,65,213,-73,-24,97,890,1636
67,den601d.map,182,370,33458,90,211,91,158,1831,4,18,177,351,86,-193,279,7698,8305
68,den601d.map,182,370,35335,95,184,86,185,53631,144,18,37,351,-49,-166,215,4216,5233
69,den601d.map,182,370,11664,31,175,150,194,58026,156,63,25,306,-125,-112,237,6448,5999
70,den601d.map,182,370,15680,42,229,139,140,47582,128,147,53,222,-86,-82,168,4161,3908
71,den601d.map,182,370,44396,119,3,62,366,54583,147,176,34,193,-28,173,201,4887,3563
72,den601d.map,182,370,50914,137,145,44,224,55452,149,47,32,322,-12,-98,110,1659,2894
73,den601d.map,182,370,49858,134,91,47,278,3669,9,30,172,339,125,-61,186,2114,2514
74,den601d.map,182,370,61225,165,194,16,175,11631,31,208,150,161,134,14,148,2465,2060
75,den601d.map,182,370,52752,142,157,39,212,40134,108,195,73,174,34,38,72,81,203
76,den601d.map,182,370,66801,180,168,1,201,44363,119,36,62,333,61,-132,193,5781,6849
77,den601d.map,182,370,25120,67,39,114,330,32745,88,184,93,185,-21,145,166,7920,9978
78,den601d.map,182,370,24521,66,268,115,101,15503,41,36,140,333,25,-232,257,12365,14439
79,den601d.map,182,370,53248,143,31,38,338,57548,155,171,26,198,-12,140,152,6206,2903
80,den601d.map,182,370,53602,144,47,37,322,16383,44,266,137,103,100,219,319,11829,8032
81,den601d.map,182,370,11088,29,11,152,358,11261,30,208,151,161,-1,197,198,11932,9296
82,den601d.map,182,370,28138,76,351,105,18,14622,39,177,142,192,37,-174,211,2088,1077
83,den601d.map,182,370,11435,30,34,151,335,45405,122,104,59,265,-92,70,162,3852,2429
84,den601d.map,182,370,23274,62,35,119,334,51797,139,2,42,367,-77,-33,110,500,111
85,den601d.map,182,370,45450,122,59,59,310,26668,72,341,109,28,50,282,332,13277,9093
86,den601d.map,182,370,47712,128,17,53,352,66477,179,122,2,247,-51,105,156,157,856
87,den601d.map,182,370,14218,38,211,143,158,10524,28,205,153,164,10,-6,16,17,17
88,den601d.map,182,370,33812,91,227,90,142,37597,101,142,80,227,-10,-85,95,1069,1017
89,den601d.map,182,370,46806,126,183,55,186,27838,75,281,106,88,51,98,149,4974,3490
90,den601d.map,182,370,10870,29,229,152,140,18455,49,44,132,325,-20,-185,205,13044,12155
91,den601d.map,182,370,24218,65,201,116,168,43182,116,107,65,262,-51,-94,145,7236,2515
92,den601d.map,182,370,8488,22,21,159,348,62014,167,145,14,224,-145,124,269,1247,1892
93,den601d.map,182,370,14553,39,246,142,123,50681,136,8,45,361,-97,-238,335,7157,12987
94,den601d.map,182,370,46989,126,0,55,369,44702,120,67,61,302,6,67,73,708,888
95,den601d.map,182,370,60955,164,94,17,275,4021,10,48,171,321,154,-46,200,3811,1774
96,den601d.map,182,370,43876,118,153,63,216,45502,122,7,59,362,-4,-146,150,4006,8072
97,den601d.map,182,370,48068,129,31,52,338,51373,138,56,43,313,-9,25,34,35,179
98,den601d.map,182,370,43113,116,176,65,193,55388,149,111,32,258,-33,-65,98,1970,1335
99,den601d.map,182,370,16057,43,222,138,147,54981,148,148,33,221,-105,-74,179,2408,4143
0,den602d.map,397,708,108996,153,35,243,672,60397,85,490,311,217,68,455,523,10654,16610
1,den602d.map,397,708,79866,112,137,284,570,72685,102,238,294,469,10,101,111,2247,5116
2,den602d.map,397,708,52040,73,351,323,356,87482,123,309,273,398,-50,-42,92,95,653
3,den602d.map,397,708,214580,303,651,93,56,68886,97,497,299,210,206,-154,360,4560,4844
4,den602d.map,397,708,182890,258,481,138,226,47399,66,36,330,671,192,-445,637,23695,23256
5,den602d.map,397,708,111627,157,236,239,471,90310,127,313,269,394,30,77,107,465,114
6,den602d.map,397,708,82672,116,163,280,544,251347,355,700,41,7,-239,537,776,12589,17798
7,den602d.map,397,708,62539,88,472,308,235,96023,135,264,261,443,-47,-208,255,3722,1482
8,den602d.map,397,708,98061,138,350,258,357,91295,128,36,268,671,10,-314,324,11502,10306
9,den602d.map,397,708,96730,136,265,260,442,155141,219,618,177,89,-83,353,436,13346,10723
10,den602d.map,397,708,118619,167,324,229,383,204773,289,546,107,161,-122,222,344,9455,7000
11,den602d.map,397,708,239304,338,707,58,0,50079,70,188,326,519,268,-519,787,17369,15192
12,den602d.map,397,708,78545,110,42,286,665,116430,164,389,232,318,-54,347,401,6709,14160
13,den602d.map,397,708,242853,343,698,53,9,160111,226,604,170,103,117,-94,211,334,853
14,den602d.map,397,708,59698,84,481,312,226,274716,388,695,8,12,-304,214,518,10179,1831
15,den602d.map,397,708,48024,67,119,329,588,59921,84,258,312,449,-17,139,156,157,261
16,den602d.map,397,708,111531,157,332,239,375,101718,143,233,253,474,14,-99,113,139,125
17,den602d.map,397,708,47188,66,247,330,460,79182,111,113,285,594,-45,-134,179,242,445
18,den602d.map,397,708,150192,212,611,184,96,91165,128,166,268,541,84,-445,529,12437,17286
19,den602d.map,397,708,170731,241,604,155,103,177062,250,645,146,62,-9,41,50,53,92
20,den602d.map,397,708,61171,86,424,310,283,93148,131,307,265,400,-45,-117,162,163,163
21,den602d.map,397,708,222365,314,654,82,53,118431,167,512,229,195,147,-142,289,3527,548
22,den602d.map,397,708,236491,334,688,62,19,120108,169,251,227,456,165,-437,602,19613,10839
23,den602d.map,397,708,94836,133,35,263,672,76933,108,238,288,469,25,203,228,4339,3403
24,den602d.map,397,708,108722,153,309,243,398,62828,88,183,308,524,65,-126,191,1807,310
25,den602d.map,397,708,119850,169,509,227,198,266933,377,690,19,17,-208,181,389,1266,1635
26,den602d.map,397,708,57714,81,341,315,366,111373,157,490,239,217,-76,149,225,226,521
27,den602d.map,397,708,13944,19,215,377,492,96886,136,109,260,598,-117,-106,223,552,2652
28,den602d.map,397,708,93662,132,501,264,206,48030,67,113,329,594,65,-388,453,7329,15816
29,den602d.map,397,708,35781,50,326,346,381,77525,109,354,287,353,-59,28,87,1284,1410
30,den602d.map,397,708,175656,248,635,148,72,240724,340,703,56,4,-92,68,160,379,214
31,den602d.map,397,708,86875,122,208,274,499,121263,171,512,225,195,-49,304,353,10925,7584
32,den602d.map,397,708,235097,332,666,64,41,162985,230,562,166,145,102,-104,206,461,2369
33,den602d.map,397,708,79841,112,162,284,545,172850,244,609,152,98,-132,447,579,11746,13553
34,den602d.map,397,708,112965,159,314,237,393,220934,312,669,84,38,-153,355,508,6809,12294
35,den602d.map,397,708,126714,178,17,218,690,96748,136,247,260,460,42,230,272,4834,6408
36,den602d.map,397,708,161539,228,592,168,115,169347,239,572,157,135,-11,-20,31,32,32
37,den602d.map,397,708,63229,89,490,307,217,120733,170,334,226,373,-81,-156,237,1488,2463
38,den602d.map,397,708,98898,139,221,257,486,244286,345,681,51,26,-206,460,666,11419,14443
39,den602d.map,397,708,125665,177,358,219,349,52941,74,158,322,549,103,-200,303,2724,502
40,den602d.map,397,708,93114,131,341,265,366,54855,77,368,319,339,54,27,81,86,402
41,den602d.map,397,708,124384,175,223,221,484,235784,333,687,63,20,-158,464,622,10891,12958
42,den602d.map,397,708,151625,214,594,182,113,206892,292,551,104,156,-78,-43,121,3291,1208
43,den602d.map,397,708,134008,189,511,207,196,160883,227,540,169,167,-38,29,67,114,99
44,den602d.map,397,708,192801,272,482,124,225,49403,69,156,327,551,203,-326,529,10478,21320
45,den602d.map,397,708,76817,108,354,288,353,51274,72,409,324,298,36,55,91,1059,743
46,den602d.map,397,708,162307,229,532,167,175,114391,161,304,235,403,68,-228,296,6526,6617
47,den602d.map,397,708,74296,104,43,292,664,82038,115,89,281,618,-11,46,57,156,123
48,den602d.map,397,708,111829,157,34,239,673,117846,166,389,230,318,-9,355,364,4368,11335
49,den602d.map,397,708,175670,248,621,148,86,65615,92,228,304,479,156,-393,549,15234,12350
50,den602d.map,397,708,165129,233,542,163,165,225156,318,695,78,12,-85,153,238,3307,2616
51,den602d.map,397,708,117913,166,322,230,385,64095,90,332,306,375,76,10,86,1042,456
52,den602d.map,397,708,50711,71,264,325,443,54799,77,424,319,283,-6,160,166,2835,5274
53,den602d.map,397,708,112784,159,495,237,212,52183,73,208,323,499,86,-287,373,7628,13042
54,den602d.map,397,708,122123,172,360,224,347,75965,107,498,289,209,65,138,203,3592,4832
55,den602d.map,397,708,249947,353,684,43,23,94606,133,265,263,442,220,-419,639,15882,9870
56,den602d.map,397,708,113640,160,347,236,360,73442,103,189,293,518,57,-158,215,1917,287
57,den602d.map,397,708,125292,176,23,220,684,12519,17,224,379,483,159,201,360,1698,763
58,den602d.map,397,708,90529,127,94,269,613,49316,69,243,327,464,58,149,207,208,328
59,den602d.map,397,708,58397,82,366,314,341,100749,142,494,254,213,-60,128,188,189,407
60,den602d.map,397,708,261270,369,689,27,18,186462,263,449,133,258,106,-240,346,6770,3506
61,den602d.map,397,708,232960,329,679,67,28,97483,137,220,259,487,192,-459,651,14824,11448
62,den602d.map,397,708,183568,259,511,137,196,158706,224,593,172,114,35,82,117,448,119
63,den602d.map,397,708,85308,120,359,276,348,101917,143,34,253,673,-23,-325,348,12728,11472
64,den602d.map,397,708,158008,223,583,173,124,182190,257,473,139,234,-34,-110,144,1346,552
65,den602d.map,397,708,113623,160,364,236,343,52743,74,356,322,351,86,-8,94,1209,1583
66,den602d.map,397,708,209026,295,541,101,166,194927,275,480,121,227,20,-61,81,981,193
67,den602d.map,397,708,75658,106,97,290,610,154477,218,574,178,133,-112,477,589,22348,19694
68,den602d.map,397,708,24560,34,219,362,488,151707,214,512,182,195,-180,293,473,13775,9535
69,den602d.map,397,708,263396,372,687,24,20,98069,138,342,258,365,234,-345,579,12276,6249
70,den602d.map,397,708,102458,144,201,252,506,264830,374,669,22,38,-230,468,698,11693,12381
71,den602d.map,397,708,78489,110,98,286,609,205455,290,572,106,135,-180,474,654,22212,19196
72,den602d.map,397,708,205513,290,514,106,193,43180,60,7,336,700,230,-507,737,24159,19000
73,den602d.map,397,708,127817,180,330,216,377,51494,72,189,324,518,108,-141,249,2321,481
74,den602d.map,397,708,53580,75,227,321,480,177197,250,510,146,197,-175,283,458,12597,11445
75,den602d.map,397,708,59706,84,473,312,234,230100,325,707,71,0,-241,234,475,1799,1757
76,den602d.map,397,708,75658,106,97,290,610,186454,263,457,133,250,-157,360,517,23559,18249
77,den602d.map,397,708,52203,73,188,323,519,169411,239,508,157,199,-166,320,486,13818,11566
78,den602d.map,397,708,59160,83,311,313,396,125079,176,236,220,471,-93,-75,168,254,1005
79,den602d.map,397,708,7560,10,227,386,480,215996,305,651,91,56,-295,424,719,19178,17484
80,den602d.map,397,708,53070,74,29,322,678,167190,236,605,160,102,-162,576,738,19009,25699
81,den602d.map,397,708,122965,173,226,223,481,170829,241,506,155,201,-68,280,348,9646,6432
82,den602d.map,397,708,79877,112,126,284,581,117270,165,257,231,450,-53,131,184,2610,6508
83,den602d.map,397,708,59041,83,430,313,277,83885,118,366,278,341,-35,-64,99,784,248
84,den602d.map,397,708,89072,125,135,271,572,267627,378,704,18,3,-253,569,822,19058,28665
85,den602d.map,397,708,262692,371,683,25,24,89134,125,73,271,634,246,-610,856,26058,19489
86,den602d.map,397,708,91106,128,225,268,482,131446,185,241,211,466,-57,16,73,253,913
87,den602d.map,397,708,185000,261,495,135,212,47269,66,166,330,541,195,-329,524,10622,19352
88,den602d.map,397,708,76833,108,338,288,369,165811,234,568,162,139,-126,230,356,4845,6558
89,den602d.map,397,708,195603,276,512,120,195,246387,348,704,48,3,-72,192,264,2844,6178
90,den602d.map,397,708,66433,93,118,303,589,62970,88,41,308,666,5,-77,82,1297,952
91,den602d.map,397,708,67026,94,233,302,474,81867,115,260,281,447,-21,27,48,1228,1022
92,den602d.map,397,708,46511,65,216,331,491,211175,298,516,98,191,-233,300,533,13960,10863
93,den602d.map,397,708,16761,23,230,373,477,79869,112,134,284,573,-89,-96,185,4647,1088
94,den602d.map,397,708,96809,136,186,260,521,9687,13,224,383,483,123,38,161,241,471
95,den602d.map,397,708,214578,303,653,93,54,66519,93,32,303,675,210,-621,831,28292,19128
96,den602d.map,397,708,91101,128,230,268,477,68414,96,261,300,446,32,31,63,1458,1246
97,den602d.map,397,708,95797,135,490,261,217,93271,131,184,265,523,4,-306,310,6159,10450
98,den602d.map,397,708,220932,312,671,84,36,58533,82,230,314,477,230,-441,671,18163,13346
99,den602d.map,397,708,95920,135,367,261,340,48641,68,210,328,497,67,-157,224,3774,4673
0,den900d.map,124,122,11849,97,106,26,15,11729,96,104,27,17,1,-2,3,4,4
1,den900d.map,124,122,4473,36,40,87,81,7297,59,22,64,99,-23,-18,41,1441,282
2,den900d.map,124,122,11998,98,79,25,42,12351,101,92,22,29,-3,13,16,17,17
3,den900d.map,124,122,3849,31,54,92,67,14447,118,70,5,51,-87,16,103,179,104
4,den900d.map,124,122,10673,87,62,36,59,2863,23,64,100,57,64,2,66,67,67
5,den900d.map,124,122,10882,89,97,34,24,1775,14,54,109,67,75,-43,118,145,563
6,den900d.map,124,122,7285,59,34,64,87,9215,75,56,48,65,-16,22,38,39,133
7,den900d.map,124,122,4321,35,70,88,51,6511,53,76,70,45,-18,6,24,34,25
8,den900d.map,124,122,2505,20,56,103,65,2997,24,52,99,69,-4,-4,8,15,16
9,den900d.map,124,122,4456,36,57,87,64,4614,37,21,86,100,-1,-36,37,38,58
10,den900d.map,124,122,12865,105,66,18,55,4855,39,24,84,97,66,-42,108,109,109
11,den900d.map,124,122,2662,21,21,102,100,6543,53,44,70,77,-32,23,55,87,56
12,den900d.map,124,122,7537,61,26,62,95,13830,113,77,10,44,-52,51,103,124,231
13,den900d.map,124,122,2382,19,57,104,64,422,3,65,120,56,16,8,24,25,25
14,den900d.map,124,122,4977,40,24,83,97,7372,60,69,63,52,-20,45,65,66,66
15,den900d.map,124,122,7638,62,47,61,74,12127,99,72,24,49,-37,25,62,84,63
16,den900d.map,124,122,6788,55,43,68,78,5342,43,25,80,96,12,-18,30,31,31
17,den900d.map,124,122,681,5,50,118,71,8973,73,54,50,67,-68,4,72,99,244
18,den900d.map,124,122,5362,43,5,80,116,6658,54,51,69,70,-11,46,57,58,58
19,den900d.map,124,122,2625,21,58,102,63,5563,45,48,78,73,-24,-10,34,53,35
20,den900d.map,124,122,7659,62,26,61,95,12238,100,83,23,38,-38,57,95,127,1086
21,den900d.map,124,122,7501,61,62,62,59,8599,70,62,53,59,-9,0,9,10,10
22,den900d.map,124,122,13200,108,97,15,24,8381,68,36,55,85,40,-61,101,128,109
23,den900d.map,124,122,13696,112,89,11,32,3593,29,66,94,55,83,-23,106,108,401
24,den900d.map,124,122,2554,20,7,103,114,4964,40,37,83,84,-20,30,50,58,147
25,den900d.map,124,122,9577,78,60,45,61,6279,51,64,72,57,27,4,31,32,32
26,den900d.map,124,122,12001,98,76,25,45,5603,45,8,78,113,53,-68,121,122,286
27,den900d.map,124,122,8971,73,56,50,65,1647,13,60,110,61,60,4,64,65,65
28,den900d.map,124,122,10913,89,66,34,55,7013,57,62,66,59,32,-4,36,37,37
29,den900d.map,124,122,5464,44,25,79,96,7258,59,61,64,60,-15,36,51,52,52
30,den900d.map,124,122,13544,111,119,12,2,13348,109,71,14,50,2,-48,50,108,51
31,den900d.map,124,122,11369,93,98,30,23,10641,87,94,36,27,6,-4,10,11,11
32,den900d.map,124,122,13962,114,67,9,54,6546,53,41,70,80,61,-26,87,88,88
33,den900d.map,124,122,14302,117,93,6,28,12743,104,66,19,55,13,-27,40,41,41
34,den900d.map,124,122,7122,58,75,65,46,7486,61,77,62,44,-3,2,5,6,6
35,den900d.map,124,122,4720,38,37,85,84,14158,116,115,7,6,-78,78,156,413,197
36,den900d.map,124,122,3107,25,64,98,57,10661,87,74,36,47,-62,10,72,272,73
37,den900d.map,124,122,2794,22,11,101,110,4838,39,41,84,80,-17,30,47,65,79
38,den900d.map,124,122,13208,108,89,15,32,4820,39,59,84,62,69,-30,99,101,336
39,den900d.map,124,122,2986,24,63,99,58,7154,58,43,65,78,-34,-20,54,73,55
40,den900d.map,124,122,5904,48,73,75,48,4495,36,18,87,103,12,-55,67,88,70
41,den900d.map,124,122,1895,15,56,108,65,13567,111,96,12,25,-96,40,136,567,158
42,den900d.map,124,122,5471,44,18,79,103,12967,106,86,17,35,-62,68,130,355,132
43,den900d.map,124,122,12109,99,90,24,31,5719,46,14,77,107,53,-76,129,131,343
44,den900d.map,124,122,12484,102,81,21,40,8749,71,34,52,87,31,-47,78,880,149
45,den900d.map,124,122,4716,38,41,85,80,2558,20,3,103,118,18,-38,56,153,64
46,den900d.map,124,122,4612,37,23,86,98,5062,41,61,82,60,-4,38,42,43,43
47,den900d.map,124,122,4338,35,53,88,68,3581,29,78,94,43,6,25,31,32,34
48,den900d.map,124,122,5601,45,10,78,111,10918,89,61,34,60,-44,51,95,96,96
49,den900d.map,124,122,4851,39,28,84,93,5349,43,18,80,103,-4,-10,14,15,15
50,den900d.map,124,122,11131,91,92,32,29,13068,107,107,16,14,-16,15,31,50,32
51,den900d.map,124,122,10313,84,56,39,65,10802,88,55,35,66,-4,-1,5,6,6
52,den900d.map,124,122,13192,108,105,15,16,10054,82,71,41,50,26,-34,60,93,74
53,den900d.map,124,122,7017,57,58,66,63,7612,62,73,61,48,-5,15,20,21,21
54,den900d.map,124,122,11635,95,76,28,45,4731,38,26,85,95,57,-50,107,108,291
55,den900d.map,124,122,3458,28,79,95,42,1874,15,77,108,44,13,-2,15,25,44
56,den900d.map,124,122,14408,118,109,5,12,4370,35,21,88,100,83,-88,171,243,430
57,den900d.map,124,122,5547,45,64,78,57,13590,111,73,12,48,-66,9,75,172,76
58,den900d.map,124,122,7892,64,37,59,84,7270,59,49,64,72,5,12,17,139,205
59,den900d.map,124,122,6415,52,50,71,71,3647,29,12,94,109,23,-38,61,70,69
60,den900d.map,124,122,5432,44,57,79,64,3228,26,65,97,56,18,8,26,27,27
61,den900d.map,124,122,2245,18,72,105,49,5599,45,12,78,109,-27,-60,87,107,332
62,den900d.map,124,122,11865,97,90,26,31,1886,15,65,108,56,82,-25,107,109,538
63,den900d.map,124,122,13441,110,100,13,21,7995,65,56,58,65,45,-44,89,123,124
64,den900d.map,124,122,4834,39,45,84,76,2259,18,58,105,63,21,13,34,35,54
65,den900d.map,124,122,5313,43,54,80,67,11403,93,64,30,57,-50,10,60,61,61
66,den900d.map,124,122,2248,18,69,105,52,6031,49,68,74,53,-31,-1,32,33,33
67,den900d.map,124,122,3892,31,11,92,110,4630,37,5,86,116,-6,-6,12,13,14
68,den900d.map,124,122,5317,43,50,80,71,5567,45,44,78,77,-2,-6,8,9,9
69,den900d.map,124,122,5440,44,49,79,72,13343,109,76,14,45,-65,27,92,262,93
70,den900d.map,124,122,675,5,56,118,65,12463,102,102,21,19,-97,46,143,695,177
71,den900d.map,124,122,2427,19,12,104,109,12861,105,70,18,51,-86,58,144,208,460
72,den900d.map,124,122,12253,100,68,23,53,2910,23,17,100,104,77,-51,128,368,159
73,den900d.map,124,122,6305,51,38,72,83,7746,63,61,60,60,-12,23,35,36,36
74,den900d.map,124,122,5358,43,9,80,112,7519,61,44,62,77,-18,35,53,54,54
75,den900d.map,124,122,12490,102,75,21,46,5471,44,18,79,103,58,-57,115,116,263
76,den900d.map,124,122,6877,56,76,67,45,4261,34,8,89,113,22,-68,90,151,93
77,den900d.map,124,122,5802,47,53,76,68,9091,74,58,49,63,-27,5,32,33,33
78,den900d.map,124,122,4635,37,0,86,121,13071,107,104,16,17,-70,104,174,415,208
79,den900d.map,124,122,11138,91,85,32,36,5087,41,36,82,85,50,-49,99,101,333
80,den900d.map,124,122,2632,21,51,102,70,13188,108,109,15,12,-87,58,145,490,239
81,den900d.map,124,122,8628,70,33,53,88,4453,36,60,87,61,34,27,61,86,578
82,den900d.map,124,122,1651,13,56,110,65,14523,119,116,4,5,-106,60,166,3151,221
83,den900d.map,124,122,2802,22,3,101,118,7991,65,60,58,61,-43,57,100,108,306
84,den900d.map,124,122,7754,63,53,60,68,15012,123,115,0,6,-60,62,122,212,161
85,den900d.map,124,122,7976,65,75,58,46,6406,52,59,71,62,13,-16,29,30,30
86,den900d.map,124,122,1147,9,72,114,49,6773,55,58,68,63,-46,-14,60,61,61
87,den900d.map,124,122,9593,78,44,45,77,2260,18,57,105,64,60,13,73,74,421
88,den900d.map,124,122,11505,94,84,29,37,3222,26,71,97,50,68,-13,81,286,364
89,den900d.map,124,122,10410,85,81,38,40,5852,47,3,76,118,38,-78,116,1324,354
90,den900d.map,124,122,4713,38,44,85,77,4619,37,16,86,105,1,-28,29,30,30
91,den900d.map,124,122,4364,35,27,88,94,6519,53,68,70,53,-18,41,59,60,96
92,den900d.map,124,122,9339,76,54,47,67,13581,111,82,12,39,-35,28,63,64,65
93,den900d.map,124,122,1762,14,67,109,54,13459,110,82,13,39,-96,15,111,547,113
94,den900d.map,124,122,5185,42,60,81,61,6419,52,46,71,75,-10,-14,24,25,25
95,den900d.map,124,122,14890,122,115,1,6,13199,108,98,15,23,14,-17,31,36,51
96,den900d.map,124,122,8488,69,51,54,70,13579,111,84,12,37,-42,33,75,76,77
97,den900d.map,124,122,536,4,73,119,48,13094,107,81,16,40,-103,8,111,629,513
98,den900d.map,124,122,5716,46,17,77,104,4966,40,35,83,86,6,18,24,25,25
99,den900d.map,124,122,5721,46,12,77,109,797,6,56,117,65,40,44,84,335,155
0,den901d.map,125,119,3186,26,26,98,92,10943,91,4,33,114,-65,-22,87,1729,195
1,den901d.map,125,119,5064,42,52,82,66,7308,61,69,63,49,-19,17,36,38,54
2,den901d.map,125,119,3062,25,31,99,87,4143,34,21,90,97,-9,-10,19,20,20
3,den901d.map,125,119,1737,14,47,110,71,9775,82,101,42,17,-68,54,122,123,123
4,den901d.map,125,119,10200,85,33,39,85,906,7,45,117,73,78,12,90,91,98
5,den901d.map,125,119,968,8,102,116,16,9069,76,93,48,25,-68,-9,77,78,78
6,den901d.map,125,119,6163,51,24,73,94,6509,54,35,70,83,-3,11,14,15,15
7,den901d.map,125,119,2947,24,27,100,91,7716,64,18,60,100,-40,-9,49,50,50
8,den901d.map,125,119,4460,37,61,87,57,2700,22,36,102,82,15,-25,40,41,41
9,den901d.map,125,119,9962,83,33,41,85,2454,20,44,104,74,63,11,74,75,75
10,den901d.map,125,119,1701,14,83,110,35,3719,31,88,93,30,-17,5,22,23,23
11,den901d.map,125,119,7338,61,39,63,79,2871,24,103,100,15,37,64,101,102,102
12,den901d.map,125,119,746,6,86,118,32,3130,26,82,98,36,-20,-4,24,25,25
13,den901d.map,125,119,2149,18,111,106,7,7645,64,89,60,29,-46,-22,68,69,69
14,den901d.map,125,119,6570,55,93,69,25,747,6,85,118,33,49,-8,57,58,58
15,den901d.map,125,119,259,2,97,122,21,8055,67,36,57,82,-65,-61,126,127,342
16,den901d.map,125,119,6461,54,83,70,35,6165,51,22,73,96,3,-61,64,115,163
17,den901d.map,125,119,1012,8,58,116,60,5181,43,54,81,64,-35,-4,39,40,40
18,den901d.map,125,119,6296,52,10,72,108,9182,77,99,47,19,-25,89,114,2983,1011
19,den901d.map,125,119,986,8,84,116,34,1452,12,94,112,24,-4,10,14,15,15
20,den901d.map,125,119,1376,11,51,113,67,3209,26,3,98,115,-15,-48,63,69,100
21,den901d.map,125,119,6858,57,43,67,75,1373,11,54,113,64,46,11,57,58,58
22,den901d.map,125,119,5648,47,63,77,55,4827,40,51,84,67,7,-12,19,20,25
23,den901d.map,125,119,443,3,32,121,86,13549,113,16,11,102,-110,-16,126,724,1062
24,den901d.map,125,119,2826,23,29,101,89,5013,42,103,82,15,-19,74,93,94,94
25,den901d.map,125,119,7080,59,59,65,59,12124,101,13,23,105,-42,-46,88,313,89
26,den901d.map,125,119,4425,37,96,87,22,1194,10,114,114,4,27,18,45,58,46
27,den901d.map,125,119,7521,63,94,61,24,9550,80,88,44,30,-17,-6,23,24,24
28,den901d.map,125,119,5897,49,52,75,66,13175,110,33,14,85,-61,-19,80,81,81
29,den901d.map,125,119,7932,66,40,58,78,1588,13,77,111,41,53,37,90,91,91
30,den901d.map,125,119,767,6,65,118,53,2583,21,34,103,84,-15,-31,46,47,47
31,den901d.map,125,119,4377,36,25,88,93,6851,57,50,67,68,-21,25,46,47,47
32,den901d.map,125,119,1472,12,74,112,44,3769,31,38,93,80,-19,-36,55,56,56
33,den901d.map,125,119,7569,63,46,61,72,4787,40,91,84,27,23,45,68,1274,319
34,den901d.map,125,119,11896,99,3,25,115,513,4,81,120,37,95,78,173,437,1188
35,den901d.map,125,119,7698,64,36,60,82,7245,60,13,64,105,4,-23,27,28,28
36,den901d.map,125,119,729,6,103,118,15,3910,32,16,92,102,-26,-87,113,121,290
37,den901d.map,125,119,3299,27,32,97,86,4135,34,29,90,89,-7,-3,10,11,11
38,den901d.map,125,119,6206,52,100,72,18,5134,43,101,81,17,9,1,10,11,11
39,den901d.map,125,119,4145,34,19,90,99,598,5,115,119,3,29,96,125,320,133
40,den901d.map,125,119,4616,38,24,86,94,5871,49,78,75,40,-11,54,65,66,66
41,den901d.map,125,119,1433,12,113,112,5,9956,83,39,41,79,-71,-74,145,4127,149
42,den901d.map,125,119,1466,12,80,112,38,2502,21,115,103,3,-9,35,44,45,45
43,den901d.map,125,119,8291,69,38,55,80,7917,66,55,58,63,3,17,20,21,21
44,den901d.map,125,119,12699,106,33,18,85,743,6,89,118,29,100,56,156,297,161
45,den901d.map,125,119,9408,79,111,45,7,7523,63,92,61,26,16,-19,35,36,54
46,den901d.map,125,119,5828,48,2,76,116,1030,8,40,116,78,40,38,78,115,169
47,den901d.map,125,119,6025,50,43,74,75,10919,91,28,33,90,-41,-15,56,57,57
48,den901d.map,125,119,6776,56,6,68,112,748,6,84,118,34,50,78,128,305,202
49,den901d.map,125,119,3584,30,104,94,14,7783,65,70,59,48,-35,-34,69,70,70
50,den901d.map,125,119,4625,38,15,86,103,3369,28,81,96,37,10,66,76,77,77
51,den901d.map,125,119,2261,19,118,105,0,391,3,84,121,34,16,-34,50,62,66
52,den901d.map,125,119,8930,75,113,49,5,437,3,38,121,80,72,-75,147,328,620
53,den901d.map,125,119,1570,13,95,111,23,2685,22,51,102,67,-9,-44,53,54,54
54,den901d.map,125,119,3290,27,41,97,77,4060,34,104,90,14,-7,63,70,71,71
55,den901d.map,125,119,3196,26,16,98,102,3735,31,72,93,46,-5,56,61,62,62
56,den901d.map,125,119,3346,28,104,96,14,3531,29,38,95,80,-1,-66,67,68,68
57,den901d.map,125,119,3600,30,88,94,30,10196,85,37,39,81,-55,-51,106,107,107
58,den901d.map,125,119,6620,55,43,69,75,3621,30,67,94,51,25,24,49,50,50
59,den901d.map,125,119,8017,67,74,57,44,7010,58,10,66,108,9,-64,73,74,74
60,den901d.map,125,119,11020,92,46,32,72,13663,114,21,10,97,-22,-25,47,54,622
61,den901d.map,125,119,4318,36,84,88,34,4310,36,92,88,26,0,8,8,11,11
62,den901d.map,125,119,6464,54,80,70,38,2178,18,82,106,36,36,2,38,39,39
63,den901d.map,125,119,2587,21,30,103,88,5188,43,47,81,71,-22,17,39,40,40
64,den901d.map,125,119,7300,61,77,63,41,3991,33,54,91,64,28,-23,51,52,52
65,den901d.map,125,119,4382,36,20,88,98,4223,35,60,89,58,1,40,41,42,42
66,den901d.map,125,119,6683,56,99,68,19,3604,30,84,94,34,26,-15,41,42,42
67,den901d.map,125,119,3819,32,107,92,11,7238,60,20,64,98,-28,-87,115,116,116
68,den901d.map,125,119,7658,64,76,60,42,2298,19,81,105,37,45,5,50,51,51
69,den901d.map,125,119,3738,31,69,93,49,1983,16,39,108,79,15,-30,45,46,46
70,den901d.map,125,119,3341,28,109,96,9,8079,67,12,57,106,-39,-97,136,149,137
71,den901d.map,125,119,2753,23,102,101,16,7956,66,16,58,102,-43,-86,129,130,130
72,den901d.map,125,119,8291,69,38,55,80,11743,98,37,26,81,-29,-1,30,31,31
73,den901d.map,125,119,7042,59,97,65,21,9051,76,111,48,7,-17,14,31,55,32
74,den901d.map,125,119,1938,16,84,108,34,547,4,47,120,71,12,-37,49,90,50
75,den901d.map,125,119,5856,49,93,75,25,3903,32,23,92,95,17,-70,87,88,88
76,den901d.map,125,119,4448,37,73,87,45,4314,36,88,88,30,1,15,16,30,19
77,den901d.map,125,119,9291,78,109,46,9,7781,65,72,59,46,13,-37,50,1015,1143
78,den901d.map,125,119,9060,76,102,48,16,4220,35,63,89,55,41,-39,80,81,81
79,den901d.map,125,119,5203,43,32,81,86,5095,42,21,82,97,1,-11,12,13,13
80,den901d.map,125,119,2744,23,111,101,7,2239,18,21,106,97,5,-90,95,257,96
81,den901d.map,125,119,5968,50,100,74,18,9247,77,34,47,84,-27,-66,93,1012,2347
82,den901d.map,125,119,4449,37,72,87,46,9523,80,115,44,3,-43,43,86,756,822
83,den901d.map,125,119,4267,35,16,89,102,8236,69,93,55,25,-34,77,111,112,112
84,den901d.map,125,119,5404,45,69,79,49,12335,103,40,21,78,-58,-29,87,860,175
85,den901d.map,125,119,13770,115,33,9,85,4503,37,18,87,100,78,-15,93,94,94
86,den901d.map,125,119,6048,50,20,74,98,4789,40,89,84,29,10,69,79,1252,172
87,den901d.map,125,119,1108,9,81,115,37,252,2,104,122,14,7,23,30,46,31
88,den901d.map,125,119,6025,50,43,74,75,13188,110,20,14,98,-60,-23,83,231,84
89,den901d.map,125,119,5923,49,26,75,92,7331,61,46,63,72,-12,20,32,33,33
90,den901d.map,125,119,2483,20,15,104,103,10550,88,40,36,78,-68,25,93,198,94
91,den901d.map,125,119,7448,62,48,62,70,10812,90,16,34,102,-28,-32,60,147,61
92,den901d.map,125,119,11981,100,37,24,81,11391,95,32,29,86,5,-5,10,11,11
93,den901d.map,125,119,7666,64,68,60,50,10796,90,32,34,86,-26,-36,62,63,63
94,den901d.map,125,119,4712,39,47,85,71,6201,52,105,72,13,-13,58,71,808,435
95,den901d.map,125,119,1585,13,80,111,38,1315,11,112,113,6,2,32,34,35,35
96,den901d.map,125,119,7828,65,25,59,93,2277,19,102,105,16,46,77,123,128,124
97,den901d.map,125,119,3745,31,62,93,56,513,4,81,120,37,27,19,46,80,47
98,den901d.map,125,119,6131,51,56,73,62,10935,91,12,33,106,-40,-44,84,294,194
99,den901d.map,125,119,11401,95,22,29,96,1157,9,32,115,86,86,10,96,762,318
0,den998d.map,82,58,2349,40,28,41,29,415,7,48,74,9,33,20,53,84,421
1,den998d.map,82,58,945,16,40,65,17,382,6,23,75,34,10,-17,27,28,28
2,den998d.map,82,58,3857,66,28,15,29,746,12,7,69,50,54,-21,75,102,130
3,den998d.map,82,58,4208,72,25,9,32,1707,29,32,52,25,43,7,50,255,59
4,den998d.map,82,58,787,13,24,68,33,1247,21,28,60,29,-8,4,12,13,13
5,den998d.map,82,58,1779,30,18,51,39,270,4,19,77,38,26,1,27,53,106
6,den998d.map,82,58,3734,64,35,17,22,1135,19,24,62,33,45,-11,56,59,178
7,den998d.map,82,58,3155,54,34,27,23,1494,25,13,56,44,29,-21,50,80,108
8,den998d.map,82,58,2585,44,24,37,33,902,15,25,66,32,29,1,30,31,31
9,den998d.map,82,58,414,7,49,74,8,4310,74,39,7,18,-67,-10,77,783,535
10,den998d.map,82,58,3616,62,37,19,20,4149,71,26,10,31,-9,-11,20,21,21
11,den998d.map,82,58,1704,29,35,52,22,1177,20,40,61,17,9,5,14,15,15
12,den998d.map,82,58,4089,70,28,11,29,1643,28,38,53,19,42,10,52,361,117
13,den998d.map,82,58,1659,28,22,53,35,687,11,8,70,49,17,-14,31,41,33
14,den998d.map,82,58,1545,26,20,55,37,374,6,31,75,26,20,11,31,32,52
15,den998d.map,82,58,1817,31,38,50,19,4429,76,36,5,21,-45,-2,47,267,600
16,den998d.map,82,58,646,11,49,70,8,414,7,49,74,8,4,0,4,5,5
17,den998d.map,82,58,1722,29,17,52,40,1407,24,42,57,15,5,25,30,54,31
18,den998d.map,82,58,1332,22,1,59,56,1270,21,5,60,52,1,4,5,6,6
19,den998d.map,82,58,426,7,37,74,20,1066,18,35,63,22,-11,-2,13,14,14
20,den998d.map,82,58,3209,55,38,26,19,1507,25,0,56,57,30,-38,68,98,134
21,den998d.map,82,58,688,11,7,70,50,366,6,39,75,18,5,32,37,38,38
22,den998d.map,82,58,1074,18,27,63,30,3791,65,36,16,21,-47,9,56,218,229
23,den998d.map,82,58,3282,56,23,25,34,3788,65,39,16,18,-9,16,25,26,26
24,den998d.map,82,58,526,9,53,72,4,3159,54,30,27,27,-45,-23,68,646,341
25,den998d.map,82,58,1104,19,55,62,2,1629,28,52,53,5,-9,-3,12,13,13
26,den998d.map,82,58,784,13,27,68,30,422,7,41,74,16,6,14,20,21,21
27,den998d.map,82,58,3204,55,43,26,14,1812,31,43,50,14,24,0,24,312,358
28,den998d.map,82,58,1164,20,53,61,4,934,16,51,65,6,4,-2,6,7,7
29,den998d.map,82,58,1322,22,11,59,46,1660,28,21,53,36,-6,10,16,32,30
30,den998d.map,82,58,1643,28,38,53,19,3275,56,30,25,27,-28,-8,36,148,206
31,den998d.map,82,58,936,16,49,65,8,1331,22,2,59,55,-6,-47,53,54,114
32,den998d.map,82,58,1110,19,49,62,8,1135,19,24,62,33,0,-25,25,26,26
33,den998d.map,82,58,1136,19,23,62,34,4495,77,28,4,29,-58,5,63,114,64
34,den998d.map,82,58,468,8,53,73,4,1863,32,50,49,7,-24,-3,27,35,28
35,den998d.map,82,58,1865,32,48,49,9,2407,41,28,40,29,-9,-20,29,123,116
36,den998d.map,82,58,3969,68,32,13,25,1698,29,41,52,16,39,9,48,389,204
37,den998d.map,82,58,3156,54,33,27,24,374,6,31,75,26,48,-2,50,172,331
38,den998d.map,82,58,2293,39,26,42,31,1671,28,10,53,47,11,-16,27,36,34
39,den998d.map,82,58,3453,59,26,22,31,3391,58,30,23,27,1,4,5,6,6
40,den998d.map,82,58,1032,17,11,64,46,1017,17,26,64,31,0,15,15,19,18
41,den998d.map,82,58,1107,19,52,62,5,3557,61,38,20,19,-42,-14,56,586,328
42,den998d.map,82,58,1137,19,22,62,35,4482,77,41,4,16,-58,19,77,338,80
43,den998d.map,82,58,1722,29,17,52,40,123,2,50,79,7,27,33,60,73,104
44,den998d.map,82,58,1320,22,13,59,44,1390,23,1,58,56,-1,-12,13,14,14
45,den998d.map,82,58,1717,29,22,52,35,1183,20,34,61,23,9,12,21,97,26
46,den998d.map,82,58,2122,36,23,45,34,1471,25,36,56,21,11,13,24,34,32
47,den998d.map,82,58,1396,24,53,57,4,4093,70,24,11,33,-46,-29,75,187,527
48,den998d.map,82,58,4442,76,23,5,34,4253,73,38,8,19,3,15,18,19,19
49,den998d.map,82,58,3098,53,33,28,24,2413,41,22,40,35,12,-11,23,25,53
50,den998d.map,82,58,1777,30,20,51,37,3444,59,35,22,22,-29,15,44,93,47
51,den998d.map,82,58,2641,45,26,36,31,546,9,33,72,24,36,7,43,87,73
52,den998d.map,82,58,1424,24,25,57,32,1922,33,49,48,8,-9,24,33,34,70
53,den998d.map,82,58,1892,32,21,49,36,1093,18,8,63,49,14,-13,27,39,68
54,den998d.map,82,58,1067,18,34,63,23,892,15,35,66,22,3,1,4,5,5
55,den998d.map,82,58,1384,23,7,58,50,646,11,49,70,8,12,42,54,411,62
56,den998d.map,82,58,3792,65,35,16,22,1837,31,18,50,39,34,-17,51,54,98
57,den998d.map,82,58,1001,17,42,64,15,302,5,45,76,12,12,3,15,23,27
58,den998d.map,82,58,1867,32,46,49,11,3967,68,34,13,23,-36,-12,48,264,582
59,den998d.map,82,58,1501,25,6,56,51,303,5,44,76,13,20,38,58,73,73
60,den998d.map,82,58,3856,66,29,15,28,818,14,51,67,6,52,22,74,420,445
61,den998d.map,82,58,1056,18,45,63,12,538,9,41,72,16,9,-4,13,14,18
62,den998d.map,82,58,490,8,31,73,26,3556,61,39,20,18,-53,8,61,470,300
63,den998d.map,82,58,1267,21,8,60,49,1204,20,13,61,44,1,5,6,7,7
64,den998d.map,82,58,1722,29,17,52,40,646,11,49,70,8,18,32,50,449,78
65,den998d.map,82,58,1698,29,41,52,16,538,9,41,72,16,20,0,20,21,21
66,den998d.map,82,58,2585,44,24,37,33,4155,71,20,10,37,-27,-4,31,67,118
67,den998d.map,82,58,4211,72,22,9,35,3855,66,30,15,27,6,8,14,15,15
68,den998d.map,82,58,932,16,53,65,4,4311,74,38,7,19,-58,-15,73,690,564
69,den998d.map,82,58,448,7,15,74,42,253,4,36,77,21,3,21,24,44,25
70,den998d.map,82,58,2291,39,28,42,29,1133,19,26,62,31,20,-2,22,29,46
71,den998d.map,82,58,1411,24,38,57,19,4094,70,23,11,34,-46,-15,61,158,393
72,den998d.map,82,58,2579,44,30,37,27,660,11,35,70,22,33,5,38,114,246
73,den998d.map,82,58,3513,60,24,21,33,1107,19,52,62,5,41,28,69,257,346
74,den998d.map,82,58,1067,18,34,63,23,527,9,52,72,5,9,18,27,113,41
75,den998d.map,82,58,1778,30,19,51,38,4188,72,45,9,12,-42,26,68,415,81
76,den998d.map,82,58,1810,31,45,50,12,1173,20,44,61,13,11,-1,12,40,29
77,den998d.map,82,58,1059,18,42,63,15,804,13,7,68,50,5,-35,40,124,42
78,den998d.map,82,58,458,7,5,74,52,748,12,5,69,52,-5,0,5,6,6
79,den998d.map,82,58,729,12,24,69,33,1175,20,42,61,15,-8,18,26,27,81
80,den998d.map,82,58,4097,70,20,11,37,2300,39,19,42,38,31,-1,32,132,120
81,den998d.map,82,58,3565,61,30,20,27,1135,19,24,62,33,42,-6,48,49,129
82,den998d.map,82,58,2470,42,23,39,34,3614,62,39,19,18,-20,16,36,62,39
83,den998d.map,82,58,3619,62,34,19,23,275,4,14,77,43,58,-20,78,82,269
84,den998d.map,82,58,458,7,5,74,52,4426,76,39,5,18,-69,34,103,344,175
85,den998d.map,82,58,564,9,15,72,42,3917,67,26,14,31,-58,11,69,91,113
86,den998d.map,82,58,1200,20,17,61,40,1180,20,37,61,20,0,20,20,23,23
87,den998d.map,82,58,3976,68,25,13,32,1388,23,3,58,54,45,-22,67,171,180
88,den998d.map,82,58,1590,27,33,54,24,1894,32,19,49,38,-5,-14,19,20,20
89,den998d.map,82,58,1929,33,42,48,15,1022,17,21,64,36,16,-21,37,47,45
90,den998d.map,82,58,3912,67,31,14,26,4198,72,35,9,22,-5,4,9,10,10
91,den998d.map,82,58,3339,57,24,24,33,1951,33,20,48,37,24,-4,28,50,69
92,den998d.map,82,58,3569,61,26,20,31,2522,43,29,38,28,18,3,21,22,22
93,den998d.map,82,58,1092,18,9,63,48,1589,27,34,54,23,-9,25,34,60,37
94,den998d.map,82,58,302,5,45,76,12,1391,23,0,58,57,-18,-45,63,94,78
95,den998d.map,82,58,3453,59,26,22,31,503,8,18,73,39,51,-8,59,60,87
96,den998d.map,82,58,789,13,22,68,35,4503,77,20,4,37,-64,-2,66,278,187
97,den998d.map,82,58,525,9,54,72,3,1782,30,15,51,42,-21,-39,60,103,215
98,den998d.map,82,58,1284,22,49,59,8,1062,18,39,63,18,4,-10,14,15,15
99,den998d.map,82,58,2870,49,29,32,28,1703,29,36,52,21,20,7,27,97,80
0,hrt000d.map,779,345,172611,500,233,278,111,217637,630,57,148,287,-130,-176,306,339,1882
1,hrt000d.map,779,345,103705,300,139,478,205,245150,710,144,68,200,-410,5,415,10867,29549
2,hrt000d.map,779,345,206193,597,116,181,228,251893,730,301,48,43,-133,185,318,319,319
3,hrt000d.map,779,345,82233,238,221,540,123,77791,225,178,553,166,13,-43,56,215,319
4,hrt000d.map,779,345,231961,672,223,106,121,247895,718,159,60,185,-46,-64,110,2748,3964
5,hrt000d.map,779,345,69717,202,317,576,27,137463,398,191,380,153,-196,-126,322,14791,18831
6,hrt000d.map,779,345,219633,636,131,142,213,232214,673,315,105,29,-37,184,221,222,222
7,hrt000d.map,779,345,221270,641,219,137,125,114263,331,276,447,68,310,57,367,31569,7507
8,hrt000d.map,779,345,223912,649,337,129,7,82534,239,265,539,79,410,-72,482,40252,61619
9,hrt000d.map,779,345,101539,294,235,484,109,133645,387,214,391,130,-93,-21,114,3039,4460
10,hrt000d.map,779,345,201689,584,135,194,209,78723,228,281,550,63,356,146,502,36349,21861
11,hrt000d.map,779,345,213709,619,190,159,154,134773,390,121,388,223,229,-69,298,19807,3307
12,hrt000d.map,779,345,68436,198,218,580,126,38301,111,338,667,6,87,120,207,5294,2356
13,hrt000d.map,779,345,229401,664,23,114,321,133714,387,145,391,199,277,122,399,38828,4132
14,hrt000d.map,779,345,174085,504,139,274,205,178415,517,294,261,50,-13,155,168,170,170
15,hrt000d.map,779,345,209936,608,168,170,176,105296,305,273,473,71,303,105,408,60025,14955
16,hrt000d.map,779,345,219985,637,124,141,220,251548,729,301,49,43,-92,177,269,270,270
17,hrt000d.map,779,345,140180,406,234,372,110,131487,381,302,397,42,25,68,93,97,94
18,hrt000d.map,779,345,90514,262,220,516,124,44174,128,330,650,14,134,110,244,6655,4073
19,hrt000d.map,779,345,158483,459,216,319,128,218019,631,20,147,324,-172,-196,368,426,4057
20,hrt000d.map,779,345,158210,458,144,320,200,238111,690,283,88,61,-232,139,371,381,806
21,hrt000d.map,779,345,112329,325,140,453,204,167750,486,264,292,80,-161,124,285,4763,17589
22,hrt000d.map,779,345,129440,375,279,403,65,224559,650,35,128,309,-275,-244,519,3098,4640
23,hrt000d.map,779,345,91528,265,241,513,103,155801,451,138,327,206,-186,-103,289,14561,11312
24,hrt000d.map,779,345,221598,642,236,136,108,71199,206,215,572,129,436,-21,457,44105,24451
25,hrt000d.map,779,345,211306,612,178,166,166,206511,598,143,180,201,14,-35,49,50,50
26,hrt000d.map,779,345,57710,167,249,611,95,161247,467,212,311,132,-300,-37,337,11396,10249
27,hrt000d.map,779,345,168922,489,127,289,217,219714,636,50,142,294,-147,-77,224,257,2270
28,hrt000d.map,779,345,94648,274,226,504,118,73269,212,215,566,129,62,-11,73,1081,1588
29,hrt000d.map,779,345,133985,388,219,390,125,207516,601,173,177,171,-213,-46,259,2285,270
30,hrt000d.map,779,345,149174,432,210,346,134,216119,626,195,152,149,-194,-15,209,664,210
31,hrt000d.map,779,345,104322,302,212,476,132,216239,626,75,152,269,-324,-137,461,10531,34728
32,hrt000d.map,779,345,13152,38,302,740,42,62196,180,248,598,96,-142,-54,196,3916,14808
33,hrt000d.map,779,345,231617,671,222,107,122,138070,400,274,378,70,271,52,323,18738,8732
34,hrt000d.map,779,345,145682,422,252,356,92,116821,338,133,440,211,84,-119,203,11252,2398
35,hrt000d.map,779,345,56586,164,338,614,6,234317,679,282,99,62,-515,-56,571,21445,52538
36,hrt000d.map,779,345,230488,668,316,110,28,30380,88,324,690,20,580,8,588,55418,24099
37,hrt000d.map,779,345,202972,588,232,190,112,220013,637,96,141,248,-49,-136,185,186,186
38,hrt000d.map,779,345,238497,691,242,87,102,234703,680,241,98,103,11,-1,12,13,13
39,hrt000d.map,779,345,197388,572,296,206,48,183364,531,175,247,169,41,-121,162,2328,223
40,hrt000d.map,779,345,228685,662,49,116,295,191095,553,34,225,310,109,-15,124,125,125
41,hrt000d.map,779,345,81482,236,282,542,62,204747,593,182,185,162,-357,-100,457,15662,30121
42,hrt000d.map,779,345,94993,275,226,503,118,93202,270,292,508,52,5,66,71,1042,1863
43,hrt000d.map,779,345,211178,612,306,166,38,230780,668,24,110,320,-56,-282,338,339,339
44,hrt000d.map,779,345,209817,608,287,170,57,113660,329,189,449,155,279,-98,377,17879,4054
45,hrt000d.map,779,345,193421,560,123,218,221,57623,167,336,611,8,393,213,606,45694,25069
46,hrt000d.map,779,345,173377,502,157,276,187,67703,196,261,582,83,306,104,410,17883,18411
47,hrt000d.map,779,345,196688,570,306,208,38,212392,615,127,163,217,-45,-179,224,247,791
48,hrt000d.map,779,345,174624,506,290,272,54,250145,725,324,53,20,-219,34,253,5961,363
49,hrt000d.map,779,345,78816,228,188,550,156,117762,341,227,437,117,-113,39,152,13195,9434
50,hrt000d.map,779,345,224106,649,143,129,201,178990,518,64,260,280,131,-79,210,3166,416
51,hrt000d.map,779,345,223329,647,230,131,114,7282,21,307,757,37,626,77,703,63648,28868
52,hrt000d.map,779,345,136349,395,270,383,74,232637,674,237,104,107,-279,-33,312,9662,20058
53,hrt000d.map,779,345,248604,720,140,58,204,218367,632,17,146,327,88,-123,211,337,212
54,hrt000d.map,779,345,129142,374,232,404,112,211631,613,198,165,146,-239,-34,273,3584,2137
55,hrt000d.map,779,345,205105,594,169,184,175,180205,522,229,256,115,72,60,132,4471,468
56,hrt000d.map,779,345,204840,593,89,185,255,132974,385,195,393,149,208,106,314,16854,3427
57,hrt000d.map,779,345,82619,239,180,539,164,200596,581,193,197,151,-342,13,355,12365,40258
58,hrt000d.map,779,345,232597,674,277,104,67,231846,672,338,106,6,2,61,63,2330,1356
59,hrt000d.map,779,345,200610,581,179,197,165,151919,440,225,338,119,141,46,187,198,645
60,hrt000d.map,779,345,109880,318,174,460,170,263249,763,330,15,14,-445,156,601,7498,1236
61,hrt000d.map,779,345,80417,233,312,545,32,240367,696,97,82,247,-463,-215,678,20687,60304
62,hrt000d.map,779,345,133571,387,288,391,56,224141,649,108,129,236,-262,-180,442,4559,475
63,hrt000d.map,779,345,193120,559,79,219,265,172285,499,214,279,130,60,135,195,1832,12792
64,hrt000d.map,779,345,83890,243,289,535,55,101140,293,289,485,55,-50,0,50,299,400
65,hrt000d.map,779,345,164412,476,152,302,192,176079,510,215,268,129,-34,63,97,255,451
66,hrt000d.map,779,345,143219,415,300,363,44,91231,264,193,514,151,151,-107,258,7034,3818
67,hrt000d.map,779,345,202466,586,48,192,296,209660,607,99,171,245,-21,51,72,73,73
68,hrt000d.map,779,345,233472,676,92,102,252,218703,633,26,145,318,43,-66,109,110,110
69,hrt000d.map,779,345,39688,115,331,663,13,205441,595,178,183,166,-480,-153,633,22206,44685
70,hrt000d.map,779,345,134683,390,211,388,133,154694,448,210,330,134,-58,-1,59,60,60
71,hrt000d.map,779,345,220197,638,257,140,87,237583,688,121,90,223,-50,-136,186,187,187
72,hrt000d.map,779,345,127736,370,258,408,86,105806,306,108,472,236,64,-150,214,2946,6464
73,hrt000d.map,779,345,222572,645,297,133,47,227109,658,245,120,99,-13,-52,65,66,66
74,hrt000d.map,779,345,213825,619,74,159,270,191772,555,47,223,297,64,-27,91,92,92
75,hrt000d.map,779,345,35544,103,335,675,9,225553,653,76,125,268,-550,-259,809,25944,70569
76,hrt000d.map,779,345,215776,625,193,153,151,127371,369,278,409,66,256,85,341,583,1532
77,hrt000d.map,779,345,247880,718,174,60,170,65262,189,287,589,57,529,113,642,46216,37031
78,hrt000d.map,779,345,75986,220,258,558,86,255797,741,192,37,152,-521,-66,587,40412,39323
79,hrt000d.map,779,345,117860,341,129,437,215,122246,354,228,424,116,-13,99,112,6190,6346
80,hrt000d.map,779,345,219152,635,267,143,77,213513,618,41,160,303,17,-226,243,244,244
81,hrt000d.map,779,345,98109,284,215,494,129,220349,638,105,140,239,-354,-110,464,13758,32697
82,hrt000d.map,779,345,240547,697,262,81,82,204294,592,290,186,54,105,28,133,134,134
83,hrt000d.map,779,345,96984,281,305,497,39,240716,697,93,81,251,-416,-212,628,18661,76487
84,hrt000d.map,779,345,95697,277,212,501,132,173771,503,108,275,236,-226,-104,330,11517,13682
85,hrt000d.map,779,345,117352,340,292,438,52,83296,241,193,537,151,99,-99,198,16451,23571
86,hrt000d.map,779,345,209578,607,181,171,163,115090,333,139,445,205,274,-42,316,35693,7991
87,hrt000d.map,779,345,187584,543,95,235,249,107797,312,187,466,157,231,92,323,14080,9031
88,hrt000d.map,779,345,207036,600,308,178,36,141551,410,243,368,101,190,-65,255,13856,4040
89,hrt000d.map,779,345,75012,217,197,561,147,104735,303,144,475,200,-86,-53,139,3606,6938
90,hrt000d.map,779,345,144938,420,306,358,38,23486,68,318,710,26,352,12,364,24544,19567
91,hrt000d.map,779,345,80904,234,170,544,174,229189,664,235,114,109,-430,65,495,23150,57585
92,hrt000d.map,779,345,106441,308,163,470,181,213750,619,149,159,195,-311,-14,325,9448,19103
93,hrt000d.map,779,345,244313,708,291,70,53,185003,536,261,242,83,172,-30,202,203,680
94,hrt000d.map,779,345,93182,270,312,508,32,220182,638,272,140,72,-368,-40,408,17530,49965
95,hrt000d.map,779,345,220488,639,311,139,33,188231,545,138,233,206,94,-173,267,17053,635
96,hrt000d.map,779,345,82137,238,317,540,27,174035,504,189,274,155,-266,-128,394,15414,19341
97,hrt000d.map,779,345,71108,206,306,572,38,155693,451,246,327,98,-245,-60,305,18075,16039
98,hrt000d.map,779,345,219715,636,49,142,295,238267,690,127,88,217,-54,78,132,133,133
99,hrt000d.map,779,345,83920,243,259,535,85,216090,626,224,152,120,-383,-35,418,19652,33220
0,hrt001d.map,105,102,6786,66,47,38,54,4196,41,87,63,14,25,40,65,325,70
1,hrt001d.map,105,102,5700,55,11,49,90,4765,46,28,58,73,9,17,26,27,27
2,hrt001d.map,105,102,6032,59,87,45,14,5681,55,30,49,71,4,-57,61,62,62
3,hrt001d.map,105,102,1037,10,84,94,17,925,9,94,95,7,1,10,11,18,12
4,hrt001d.map,105,102,8888,87,87,17,14,4290,42,95,62,6,45,8,53,54,54
5,hrt001d.map,105,102,6441,63,86,41,15,5227,51,76,53,25,12,-10,22,23,23
6,hrt001d.map,105,102,6694,65,37,39,64,5423,53,84,51,17,12,47,59,67,104
7,hrt001d.map,105,102,10002,98,95,6,6,8675,85,96,19,5,13,1,14,79,73
8,hrt001d.map,105,102,1346,13,81,91,20,8780,86,93,18,8,-73,12,85,222,661
9,hrt001d.map,105,102,5728,56,85,48,16,5707,55,4,49,97,1,-81,82,83,83
10,hrt001d.map,105,102,3280,32,85,72,16,6235,61,88,43,13,-29,3,32,33,33
11,hrt001d.map,105,102,5088,49,11,55,90,3787,37,88,67,13,12,77,89,429,90
12,hrt001d.map,105,102,10120,99,79,5,22,6511,63,16,41,85,36,-63,99,543,881
13,hrt001d.map,105,102,7450,73,97,31,4,8075,79,84,25,17,-6,-13,19,30,107
14,hrt001d.map,105,102,6508,63,19,41,82,5951,58,66,46,35,5,47,52,141,62
15,hrt001d.map,105,102,7969,78,88,26,13,8783,86,90,18,11,-8,2,10,11,11
16,hrt001d.map,105,102,5986,58,31,46,70,5781,56,32,48,69,2,1,3,4,4
17,hrt001d.map,105,102,9297,91,86,13,15,6279,61,44,43,57,30,-42,72,341,267
18,hrt001d.map,105,102,3688,36,85,68,16,6841,67,94,37,7,-31,9,40,75,53
19,hrt001d.map,105,102,8187,80,74,24,27,5452,53,55,51,46,27,-19,46,177,1768
20,hrt001d.map,105,102,6580,64,49,40,52,4230,41,53,63,48,23,4,27,28,28
21,hrt001d.map,105,102,4953,48,44,56,57,5987,58,30,46,71,-10,-14,24,25,25
22,hrt001d.map,105,102,6523,63,4,41,97,4991,48,6,56,95,15,2,17,18,18
23,hrt001d.map,105,102,2062,20,79,84,22,10111,99,88,5,13,-79,9,88,89,89
24,hrt001d.map,105,102,4051,39,28,65,73,9614,94,75,10,26,-55,47,102,1675,376
25,hrt001d.map,105,102,4564,44,25,60,76,6943,68,94,36,7,-24,69,93,94,158
26,hrt001d.map,105,102,6744,66,89,38,12,6667,65,64,39,37,1,-25,26,299,176
27,hrt001d.map,105,102,3069,30,92,74,9,1847,18,90,86,11,12,-2,14,15,15
28,hrt001d.map,105,102,2360,23,87,81,14,4229,41,54,63,47,-18,-33,51,451,175
29,hrt001d.map,105,102,8888,87,87,17,14,6695,65,36,39,65,22,-51,73,491,323
30,hrt001d.map,105,102,6227,61,96,43,5,5462,53,45,51,56,8,-51,59,128,912
31,hrt001d.map,105,102,8889,87,86,17,15,4825,47,70,57,31,40,-16,56,61,57
32,hrt001d.map,105,102,5120,50,81,54,20,3593,35,78,69,23,15,-3,18,19,19
33,hrt001d.map,105,102,5411,53,96,51,5,6686,65,45,39,56,-12,-51,63,374,1183
34,hrt001d.map,105,102,8781,86,92,18,9,6223,61,100,43,1,25,8,33,107,103
35,hrt001d.map,105,102,4745,46,48,58,53,926,9,93,95,8,37,45,82,235,206
36,hrt001d.map,105,102,7552,74,97,30,4,4100,40,81,64,20,34,-16,50,122,51
37,hrt001d.map,105,102,5009,49,90,55,11,5911,57,4,47,97,-8,-86,94,95,95
38,hrt001d.map,105,102,4414,43,73,61,28,3478,34,91,70,10,9,18,27,28,33
39,hrt001d.map,105,102,2051,20,90,84,11,5175,50,26,54,75,-30,-64,94,149,372
40,hrt001d.map,105,102,5264,51,39,53,62,10313,101,90,3,11,-50,51,101,102,102
41,hrt001d.map,105,102,3378,33,89,71,12,6006,58,11,46,90,-25,-78,103,115,443
42,hrt001d.map,105,102,9293,91,90,13,11,4695,46,98,58,3,45,8,53,292,94
43,hrt001d.map,105,102,8785,86,88,18,13,5642,55,69,49,32,31,-19,50,51,51
44,hrt001d.map,105,102,4864,47,31,57,70,6370,62,55,42,46,-15,24,39,40,40
45,hrt001d.map,105,102,10318,101,85,3,16,9094,89,85,15,16,12,0,12,13,13
46,hrt001d.map,105,102,10322,101,81,3,20,5395,52,10,52,91,49,-71,120,249,1232
47,hrt001d.map,105,102,6786,66,47,38,54,5230,51,73,53,28,15,26,41,42,42
48,hrt001d.map,105,102,6076,59,43,45,58,3676,36,97,68,4,23,54,77,247,78
49,hrt001d.map,105,102,3384,33,83,71,18,7260,71,83,33,18,-38,0,38,55,85
50,hrt001d.map,105,102,3689,36,84,68,17,8579,84,90,20,11,-48,6,54,55,55
51,hrt001d.map,105,102,5472,53,35,51,66,5798,56,15,48,86,-3,-20,23,24,24
52,hrt001d.map,105,102,6097,59,22,45,79,3881,38,96,66,5,21,74,95,383,96
53,hrt001d.map,105,102,4965,48,32,56,69,4823,47,72,57,29,1,40,41,42,42
54,hrt001d.map,105,102,4777,46,16,58,85,4083,40,98,64,3,6,82,88,508,180
55,hrt001d.map,105,102,5491,53,16,51,85,3375,33,92,71,9,20,76,96,386,108
56,hrt001d.map,105,102,7348,72,97,32,4,6775,66,58,38,43,6,-39,45,369,166
57,hrt001d.map,105,102,7764,76,89,28,12,6838,67,97,37,4,9,8,17,18,18
58,hrt001d.map,105,102,5940,58,77,46,24,5757,56,56,48,45,2,-21,23,24,24
59,hrt001d.map,105,102,4873,47,22,57,79,6059,59,60,45,41,-12,38,50,51,51
60,hrt001d.map,105,102,6202,60,19,44,82,2051,20,90,84,11,40,71,111,401,166
61,hrt001d.map,105,102,9105,89,74,15,27,6747,66,86,38,15,23,12,35,95,330
62,hrt001d.map,105,102,3272,32,93,72,8,10222,100,79,4,22,-68,-14,82,253,83
63,hrt001d.map,105,102,5691,55,20,49,81,6543,64,86,40,15,-9,66,75,76,76
64,hrt001d.map,105,102,8682,85,89,19,12,8778,86,95,18,6,-1,6,7,8,8
65,hrt001d.map,105,102,5082,49,17,55,84,6078,59,41,45,60,-10,24,34,35,35
66,hrt001d.map,105,102,6006,58,11,46,90,4455,43,32,61,69,15,21,36,52,37
67,hrt001d.map,105,102,6634,65,97,39,4,6023,59,96,45,5,6,-1,7,20,18
68,hrt001d.map,105,102,4395,43,92,61,9,5911,57,4,47,97,-14,-88,102,105,533
69,hrt001d.map,105,102,2870,28,87,76,14,1743,17,92,87,9,11,5,16,17,17
70,hrt001d.map,105,102,4234,41,49,63,52,1948,19,91,85,10,22,42,64,206,593
71,hrt001d.map,105,102,9708,95,83,9,18,9813,96,80,8,21,-1,-3,4,5,5
72,hrt001d.map,105,102,5260,51,43,53,58,3894,38,83,66,18,13,40,53,223,54
73,hrt001d.map,105,102,3681,36,92,68,9,5491,53,16,51,85,-17,-76,93,94,383
74,hrt001d.map,105,102,6564,64,65,40,36,6798,66,35,38,66,-2,-30,32,33,33
75,hrt001d.map,105,102,7155,70,86,34,15,9199,90,82,14,19,-20,-4,24,32,25
76,hrt001d.map,105,102,4917,48,80,56,21,2054,20,87,84,14,28,7,35,36,36
77,hrt001d.map,105,102,5176,50,25,54,76,1236,12,89,92,12,38,64,102,939,208
78,hrt001d.map,105,102,6808,66,25,38,76,9207,90,74,14,27,-24,49,73,1579,617
79,hrt001d.map,105,102,2554,25,97,79,4,5607,54,2,50,99,-29,-95,124,164,495
80,hrt001d.map,105,102,4762,46,31,58,70,8990,88,87,16,14,-42,56,98,99,108
81,hrt001d.map,105,102,4937,48,60,56,41,5471,53,36,51,65,-5,-24,29,30,30
82,hrt001d.map,105,102,1129,11,94,93,7,6604,64,25,40,76,-53,-69,122,233,403
83,hrt001d.map,105,102,5360,52,45,52,56,2255,22,90,82,11,30,45,75,239,124
84,hrt001d.map,105,102,6610,64,19,40,82,8583,84,86,20,15,-20,67,87,436,427
85,hrt001d.map,105,102,6196,60,25,44,76,8671,85,100,19,1,-25,75,100,548,656
86,hrt001d.map,105,102,7458,73,89,31,12,7461,73,86,31,15,0,-3,3,4,4
87,hrt001d.map,105,102,6668,65,63,39,38,5165,50,36,54,65,15,-27,42,43,43
88,hrt001d.map,105,102,5019,49,80,55,21,6060,59,59,45,42,-10,-21,31,32,32
89,hrt001d.map,105,102,10009,98,88,6,13,6564,64,65,40,36,34,-23,57,664,125
90,hrt001d.map,105,102,5356,52,49,52,52,5695,55,16,49,85,-3,-33,36,37,37
91,hrt001d.map,105,102,6695,65,36,39,65,6799,66,34,38,67,-1,-2,3,4,4
92,hrt001d.map,105,102,4872,47,23,57,78,5677,55,34,49,67,-8,11,19,20,20
93,hrt001d.map,105,102,5186,50,15,54,86,7150,70,91,34,10,-20,76,96,97,97
94,hrt001d.map,105,102,3378,33,89,71,12,5235,51,68,53,33,-18,-21,39,51,40
95,hrt001d.map,105,102,7162,70,79,34,22,6270,61,53,43,48,9,-26,35,105,173
96,hrt001d.map,105,102,5313,52,92,52,9,5994,58,23,46,78,-6,-69,75,180,1133
97,hrt001d.map,105,102,5049,49,50,55,51,5050,49,49,55,52,0,-1,1,2,2
98,hrt001d.map,105,102,3589,35,82,69,19,5686,55,25,49,76,-20,-57,77,79,358
99,hrt001d.map,105,102,6073,59,46,45,55,5946,58,71,46,30,1,25,26,27,27
0,hrt002d.map,46,40,25,0,14,45,25,1343,33,16,12,23,-33,2,35,141,286
1,hrt002d.map,46,40,691,17,28,28,11,909,22,10,23,29,-5,-18,23,43,38
2,hrt002d.map,46,40,979,24,20,21,19,1014,25,25,20,14,-1,5,6,7,7
3,hrt002d.map,46,40,1304,32,15,13,24,1028,25,11,20,28,7,-4,11,12,12
4,hrt002d.map,46,40,491,12,28,33,11,750,18,9,27,30,-6,-19,25,119,44
5,hrt002d.map,46,40,1329,33,30,12,9,1459,36,20,9,19,-3,-10,13,16,17
6,hrt002d.map,46,40,1186,29,13,16,26,1277,31,2,14,37,-2,-11,13,254,139
7,hrt002d.map,46,40,1697,42,22,3,17,1828,45,11,0,28,-3,-11,14,15,15
8,hrt002d.map,46,40,848,21,31,24,8,1387,34,12,11,27,-13,-19,32,46,38
9,hrt002d.map,46,40,1779,44,20,1,19,1142,28,17,17,22,16,-3,19,20,20
10,hrt002d.map,46,40,421,10,18,35,21,823,20,16,25,23,-10,-2,12,106,121
11,hrt002d.map,46,40,1289,32,30,13,9,334,8,25,37,14,24,-5,29,30,39
12,hrt002d.map,46,40,1002,25,37,20,2,1278,31,1,14,38,-6,-36,42,498,128
13,hrt002d.map,46,40,185,4,14,41,25,1553,38,6,7,33,-34,-8,42,533,522
14,hrt002d.map,46,40,176,4,23,41,16,1108,27,11,18,28,-23,-12,35,120,105
15,hrt002d.map,46,40,296,7,23,38,16,950,23,9,22,30,-16,-14,30,74,92
16,hrt002d.map,46,40,1300,32,19,13,20,1247,31,32,14,7,1,13,14,15,15
17,hrt002d.map,46,40,1304,32,15,13,24,182,4,17,41,22,28,2,30,338,138
18,hrt002d.map,46,40,1244,31,35,14,4,1383,34,16,11,23,-3,-19,22,23,23
19,hrt002d.map,46,40,1117,27,2,18,37,1077,26,2,19,37,1,0,1,2,2
20,hrt002d.map,46,40,1179,29,20,16,19,1092,27,27,18,12,2,7,9,10,10
21,hrt002d.map,46,40,1778,44,21,1,18,931,23,28,22,11,21,7,28,29,87
22,hrt002d.map,46,40,1517,37,2,8,37,1279,31,0,14,39,6,-2,8,17,11
23,hrt002d.map,46,40,693,17,26,28,13,774,19,25,26,14,-2,-1,3,4,4
24,hrt002d.map,46,40,1016,25,23,20,16,1209,30,30,15,9,-5,7,12,13,13
25,hrt002d.map,46,40,1177,29,22,16,17,1107,27,12,18,27,2,-10,12,31,16
26,hrt002d.map,46,40,1332,33,27,12,12,1101,27,18,18,21,6,-9,15,16,16
27,hrt002d.map,46,40,213,5,26,40,13,95,2,24,43,15,3,-2,5,6,6
28,hrt002d.map,46,40,1008,25,31,20,8,1824,45,15,0,24,-20,-16,36,48,37
29,hrt002d.map,46,40,1199,29,0,16,39,983,24,16,21,23,5,16,21,114,341
30,hrt002d.map,46,40,1292,32,27,13,12,1462,36,17,9,22,-4,-10,14,15,15
31,hrt002d.map,46,40,1657,41,22,4,17,1436,35,3,10,36,6,-19,25,113,61
32,hrt002d.map,46,40,1746,43,13,2,26,1831,45,8,0,31,-2,-5,7,8,8
33,hrt002d.map,46,40,1676,41,3,4,36,1837,45,2,0,37,-4,-1,5,6,6
34,hrt002d.map,46,40,144,3,15,42,24,1492,37,27,8,12,-34,12,46,47,47
35,hrt002d.map,46,40,692,17,27,28,12,1837,45,2,0,37,-28,-25,53,122,103
36,hrt002d.map,46,40,420,10,19,35,20,1062,26,17,19,22,-16,-2,18,58,136
37,hrt002d.map,46,40,1477,36,2,9,37,95,2,24,43,15,34,22,56,346,578
38,hrt002d.map,46,40,1244,31,35,14,4,949,23,10,22,29,8,-25,33,34,34
39,hrt002d.map,46,40,688,17,31,28,8,1282,32,37,13,2,-15,6,21,26,77
40,hrt002d.map,46,40,1217,30,22,15,17,1593,39,6,6,33,-9,-16,25,187,81
41,hrt002d.map,46,40,137,3,22,42,17,1595,39,4,6,35,-36,-18,54,516,389
42,hrt002d.map,46,40,16,0,23,45,16,693,17,26,28,13,-17,3,20,21,21
43,hrt002d.map,46,40,1424,35,15,10,24,1177,29,22,16,17,6,7,13,14,14
44,hrt002d.map,46,40,1186,29,13,16,26,95,2,24,43,15,27,11,38,165,215
45,hrt002d.map,46,40,1222,30,17,15,22,534,13,25,32,14,17,8,25,94,32
46,hrt002d.map,46,40,930,23,29,22,10,535,13,24,32,15,10,-5,15,16,18
47,hrt002d.map,46,40,145,3,14,42,25,1757,43,2,2,37,-40,-12,52,229,448
48,hrt002d.map,46,40,1384,34,15,11,24,1755,43,4,2,35,-9,-11,20,38,51
49,hrt002d.map,46,40,67,1,12,44,27,108,2,11,43,28,-1,-1,2,3,3
50,hrt002d.map,46,40,941,23,18,22,21,1206,30,33,15,6,-7,15,22,23,23
51,hrt002d.map,46,40,1593,39,6,6,33,1054,26,25,19,14,13,19,32,96,297
52,hrt002d.map,46,40,1420,35,19,10,20,1294,32,25,13,14,3,6,9,10,10
53,hrt002d.map,46,40,1132,28,27,17,12,102,2,17,43,22,26,-10,36,37,37
54,hrt002d.map,46,40,1009,25,30,20,9,1397,34,2,11,37,-9,-28,37,477,121
55,hrt002d.map,46,40,172,4,27,41,12,925,23,34,22,5,-19,7,26,41,27
56,hrt002d.map,46,40,1074,26,5,19,34,612,15,27,30,12,11,22,33,131,715
57,hrt002d.map,46,40,1492,37,27,8,12,893,22,26,23,13,15,-1,16,17,17
58,hrt002d.map,46,40,140,3,19,42,20,1005,25,34,20,5,-22,15,37,53,38
59,hrt002d.map,46,40,1179,29,20,16,19,1174,29,25,16,14,0,5,5,6,6
60,hrt002d.map,46,40,904,22,15,23,24,885,22,34,23,5,0,19,19,22,23
61,hrt002d.map,46,40,27,0,12,45,27,1661,41,18,4,21,-41,6,47,145,354
62,hrt002d.map,46,40,1293,32,26,13,13,894,22,25,23,14,10,-1,11,12,12
63,hrt002d.map,46,40,1752,43,7,2,32,977,24,22,21,17,19,15,34,35,75
64,hrt002d.map,46,40,690,17,29,28,10,1279,31,0,14,39,-14,-29,43,569,131
65,hrt002d.map,46,40,1744,43,15,2,24,1138,28,21,17,18,15,6,21,22,33
66,hrt002d.map,46,40,1090,27,29,18,10,950,23,9,22,30,4,-20,24,25,25
67,hrt002d.map,46,40,1219,30,20,15,19,1399,34,0,11,39,-4,-20,24,281,106
68,hrt002d.map,46,40,176,4,23,41,16,1798,44,1,1,38,-40,-22,62,216,373
69,hrt002d.map,46,40,1244,31,35,14,4,1436,35,3,10,36,-4,-32,36,372,120
70,hrt002d.map,46,40,1384,34,15,11,24,1226,30,13,15,26,4,-2,6,7,7
71,hrt002d.map,46,40,417,10,22,35,17,1714,42,5,3,34,-32,-17,49,335,373
72,hrt002d.map,46,40,690,17,29,28,10,1018,25,21,20,18,-8,-8,16,17,17
73,hrt002d.map,46,40,1290,32,29,13,10,1613,40,26,5,13,-8,-3,11,12,12
74,hrt002d.map,46,40,1102,27,17,18,22,783,19,16,26,23,8,-1,9,10,10
75,hrt002d.map,46,40,68,1,11,44,28,94,2,25,43,14,-1,14,15,16,18
76,hrt002d.map,46,40,30,0,9,45,30,1343,33,16,12,23,-33,7,40,141,291
77,hrt002d.map,46,40,689,17,30,28,9,1398,34,1,11,38,-17,-29,46,541,132
78,hrt002d.map,46,40,1068,26,11,19,28,901,22,18,23,21,4,7,11,12,12
79,hrt002d.map,46,40,1020,25,19,20,20,143,3,16,42,23,22,-3,25,144,118
80,hrt002d.map,46,40,1059,26,20,19,19,1199,29,0,16,39,-3,-20,23,393,110
81,hrt002d.map,46,40,1433,35,6,10,33,1052,26,27,19,12,9,21,30,112,401
82,hrt002d.map,46,40,1096,27,23,18,16,1475,36,4,9,35,-9,-19,28,318,111
83,hrt002d.map,46,40,1046,26,33,19,6,223,5,16,40,23,21,-17,38,251,58
84,hrt002d.map,46,40,1713,42,6,3,33,534,13,25,32,14,29,19,48,226,297
85,hrt002d.map,46,40,1216,30,23,15,16,92,2,27,43,12,28,4,32,33,68
86,hrt002d.map,46,40,98,2,21,43,18,1237,30,2,15,37,-28,-19,47,640,409
87,hrt002d.map,46,40,1168,29,31,16,8,933,23,26,22,13,6,-5,11,12,12
88,hrt002d.map,46,40,1205,30,34,15,5,653,16,26,29,13,14,-8,22,23,26
89,hrt002d.map,46,40,1398,34,1,11,38,535,13,24,32,15,21,23,44,335,560
90,hrt002d.map,46,40,745,18,14,27,25,98,2,21,43,18,16,7,23,103,196
91,hrt002d.map,46,40,1778,44,21,1,18,612,15,27,30,12,29,6,35,36,105
92,hrt002d.map,46,40,223,5,16,40,23,983,24,16,21,23,-19,0,19,126,263
93,hrt002d.map,46,40,64,1,15,44,24,105,2,14,43,25,-1,-1,2,3,3
94,hrt002d.map,46,40,1009,25,30,20,9,1074,26,5,19,34,-1,-25,26,640,121
95,hrt002d.map,46,40,1348,33,11,12,28,1095,27,24,18,15,6,13,19,22,22
96,hrt002d.map,46,40,211,5,28,40,11,1463,36,16,9,23,-31,-12,43,95,47
97,hrt002d.map,46,40,1080,27,39,18,0,945,23,14,22,25,4,-25,29,30,30
98,hrt002d.map,46,40,96,2,23,43,16,991,24,8,21,31,-22,-15,37,138,99
99,hrt002d.map,46,40,64,1,15,44,24,133,3,26,42,13,-2,11,13,14,16
0,hrt201d.map,268,292,40337,138,250,129,41,58583,200,108,67,183,-62,-142,204,255,2181
1,hrt201d.map,268,292,30152,103,215,164,76,30844,105,107,162,184,-2,-108,110,111,111
2,hrt201d.map,268,292,19355,66,208,201,83,34583,118,164,149,127,-52,-44,96,207,122
3,hrt201d.map,268,292,21068,72,247,195,44,41094,140,77,127,214,-68,-170,238,3262,9353
4,hrt201d.map,268,292,45924,157,211,110,80,10261,35,250,232,41,122,39,161,3523,4730
5,hrt201d.map,268,292,76648,262,147,5,144,42508,145,123,122,168,117,-24,141,1639,760
6,hrt201d.map,268,292,37001,126,82,141,209,39349,134,70,133,221,-8,-12,20,23,21
7,hrt201d.map,268,292,11115,38,272,229,19,30910,105,41,162,250,-67,-231,298,3870,10368
8,hrt201d.map,268,292,34918,119,121,148,170,41351,141,112,126,179,-22,-9,31,32,32
9,hrt201d.map,268,292,29680,101,103,166,188,40198,137,97,130,194,-36,-6,42,203,325
10,hrt201d.map,268,292,19519,66,44,201,247,53935,184,84,83,207,-118,40,158,6042,738
11,hrt201d.map,268,292,30597,104,62,163,229,77247,264,132,3,159,-160,70,230,3663,499
12,hrt201d.map,268,292,44213,151,170,116,121,39118,133,9,134,282,18,-161,179,761,3813
13,hrt201d.map,268,292,18521,63,166,204,125,35509,121,114,146,177,-58,-52,110,1171,481
14,hrt201d.map,268,292,47418,162,177,105,114,36423,124,76,143,215,38,-101,139,800,1557
15,hrt201d.map,268,292,38922,133,205,134,86,7651,26,232,241,59,107,27,134,1057,985
16,hrt201d.map,268,292,58809,201,174,66,117,46491,159,228,108,63,42,54,96,1094,2132
17,hrt201d.map,268,292,56185,192,170,75,121,39190,134,229,133,62,58,59,117,786,3285
18,hrt201d.map,268,292,36776,125,15,142,276,40809,139,70,128,221,-14,55,69,76,191
19,hrt201d.map,268,292,39427,135,284,132,7,48661,166,102,101,189,-31,-182,213,449,2164
20,hrt201d.map,268,292,44921,153,46,114,245,18150,62,245,205,46,91,199,290,13191,5077
21,hrt201d.map,268,292,28177,96,146,171,145,48754,166,9,101,282,-70,-137,207,349,674
22,hrt201d.map,268,292,67928,232,107,35,184,11343,38,44,229,247,194,-63,257,748,4162
23,hrt201d.map,268,292,10771,36,32,231,259,40534,138,53,129,238,-102,21,123,524,126
24,hrt201d.map,268,292,18184,62,211,205,80,30759,105,192,162,99,-43,-19,62,100,99
25,hrt201d.map,268,292,38650,132,185,135,106,5615,19,224,248,67,113,39,152,3612,1290
26,hrt201d.map,268,292,21745,74,154,193,137,29308,100,183,167,108,-26,29,55,698,577
27,hrt201d.map,268,292,39722,136,281,131,10,63498,217,157,50,134,-81,-124,205,2685,2707
28,hrt201d.map,268,292,47878,163,9,104,282,25551,87,144,180,147,76,135,211,955,353
29,hrt201d.map,268,292,42560,145,71,122,220,30477,104,182,163,109,41,111,152,541,382
30,hrt201d.map,268,292,40178,137,117,130,174,45206,154,53,113,238,-17,-64,81,1282,101
31,hrt201d.map,268,292,64420,220,111,47,180,55263,189,216,78,75,31,105,136,1520,710
32,hrt201d.map,268,292,43780,149,19,118,272,31765,108,62,159,229,41,43,84,93,97
33,hrt201d.map,268,292,44339,151,44,116,247,46550,159,169,108,122,-8,125,133,1961,1870
34,hrt201d.map,268,292,62995,215,76,52,215,58030,198,77,69,214,17,1,18,19,29
35,hrt201d.map,268,292,42884,146,39,121,252,33669,115,202,152,89,31,163,194,3065,1187
36,hrt201d.map,268,292,2379,8,248,259,43,14270,48,37,219,254,-40,-211,251,4421,8721
37,hrt201d.map,268,292,12509,42,46,225,245,36775,125,16,142,275,-83,-30,113,510,143
38,hrt201d.map,268,292,63836,218,111,49,180,5902,20,229,247,62,198,118,316,10707,1181
39,hrt201d.map,268,292,24857,85,254,182,37,29732,101,51,166,240,-16,-203,219,1562,6172
40,hrt201d.map,268,292,40964,140,207,127,84,48661,166,102,101,189,-26,-105,131,205,1355
41,hrt201d.map,268,292,38141,130,110,137,181,9086,31,257,236,34,99,147,246,6077,4824
42,hrt201d.map,268,292,55635,190,136,77,155,23780,81,163,186,128,109,27,136,5758,1946
43,hrt201d.map,268,292,48642,166,121,101,170,39900,136,103,131,188,30,-18,48,51,248
44,hrt201d.map,268,292,51280,175,111,92,180,64449,220,82,47,209,-45,-29,74,75,93
45,hrt201d.map,268,292,28691,98,216,169,75,30734,105,217,162,74,-7,1,8,9,9
46,hrt201d.map,268,292,11420,39,259,228,32,57934,198,173,69,118,-159,-86,245,5829,2343
47,hrt201d.map,268,292,24857,85,254,182,37,67559,231,184,36,107,-146,-70,216,5090,2442
48,hrt201d.map,268,292,25605,87,90,180,201,48919,167,136,100,155,-80,46,126,1048,1678
49,hrt201d.map,268,292,17016,58,211,209,80,35599,121,24,146,267,-63,-187,250,375,2123
50,hrt201d.map,268,292,26961,92,194,175,97,38206,130,45,137,246,-38,-149,187,189,918
51,hrt201d.map,268,292,9369,32,266,235,25,19957,68,190,199,101,-36,-76,112,4456,2510
52,hrt201d.map,268,292,49240,168,107,99,184,37355,127,20,140,271,41,-87,128,496,1750
53,hrt201d.map,268,292,44355,151,28,116,263,44207,151,176,116,115,0,148,148,3105,2153
54,hrt201d.map,268,292,60331,206,112,61,179,44647,152,28,115,263,54,-84,138,1384,1050
55,hrt201d.map,268,292,50016,171,207,96,84,12911,44,228,223,63,127,21,148,7229,3876
56,hrt201d.map,268,292,40706,139,173,128,118,34346,117,109,150,182,22,-64,86,868,1071
57,hrt201d.map,268,292,51658,176,25,91,266,7047,24,252,243,39,152,227,379,11988,12799
58,hrt201d.map,268,292,15438,52,37,215,254,38207,130,44,137,247,-78,7,85,86,86
59,hrt201d.map,268,292,24592,84,227,183,64,48640,166,123,101,168,-82,-104,186,678,549
60,hrt201d.map,268,292,35153,120,178,147,113,33348,114,231,153,60,6,53,59,243,410
61,hrt201d.map,268,292,55104,188,83,79,208,67603,231,140,36,151,-43,57,100,2626,3263
62,hrt201d.map,268,292,29450,100,41,167,250,59780,204,79,63,212,-104,38,142,2673,686
63,hrt201d.map,268,292,56890,194,49,73,242,22525,77,250,190,41,117,201,318,12759,5589
64,hrt201d.map,268,292,41090,140,81,127,210,66821,228,46,39,245,-88,-35,123,630,1043
65,hrt201d.map,268,292,59170,202,105,65,186,44879,153,88,114,203,49,-17,66,1030,345
66,hrt201d.map,268,292,8792,30,259,237,32,16295,55,56,212,235,-25,-203,228,6920,7319
67,hrt201d.map,268,292,46707,159,12,108,279,45612,156,231,111,60,3,219,222,3878,3464
68,hrt201d.map,268,292,32069,109,50,158,241,41174,141,289,126,2,-32,239,271,2370,2424
69,hrt201d.map,268,292,39137,134,282,133,9,40901,140,270,127,21,-6,-12,18,19,39
70,hrt201d.map,268,292,28113,96,210,171,81,40707,139,172,128,119,-43,-38,81,82,137
71,hrt201d.map,268,292,22340,76,143,191,148,63509,217,146,50,145,-141,3,144,2330,1823
72,hrt201d.map,268,292,54402,186,201,81,90,43980,150,111,117,180,36,-90,126,1111,262
73,hrt201d.map,268,292,62440,213,47,54,244,16301,55,50,212,241,158,3,161,315,272
74,hrt201d.map,268,292,29653,101,130,166,161,40030,137,265,130,26,-36,135,171,747,745
75,hrt201d.map,268,292,28649,98,258,169,33,39415,134,4,133,287,-36,-254,290,3107,9309
76,hrt201d.map,268,292,9972,34,247,233,44,30294,103,73,164,218,-69,-174,243,2927,7425
77,hrt201d.map,268,292,48752,166,11,101,280,62682,214,97,53,194,-48,86,134,859,2391
78,hrt201d.map,268,292,41131,140,40,127,251,9676,33,251,234,40,107,211,318,11726,4903
79,hrt201d.map,268,292,41240,141,223,126,68,31031,106,212,161,79,35,-11,46,1340,1295
80,hrt201d.map,268,292,39114,133,13,134,278,41061,140,110,127,181,-7,97,104,105,105
81,hrt201d.map,268,292,24089,82,146,185,145,39204,134,215,133,76,-52,69,121,536,209
82,hrt201d.map,268,292,28994,99,205,168,86,54666,187,229,80,62,-88,24,112,1916,1441
83,hrt201d.map,268,292,68736,235,175,32,116,46200,158,227,109,64,77,52,129,1522,2370
84,hrt201d.map,268,292,18820,64,159,203,132,43390,148,117,119,174,-84,-42,126,1226,897
85,hrt201d.map,268,292,64161,219,78,48,213,25353,86,50,181,241,133,-28,161,975,1391
86,hrt201d.map,268,292,31578,108,249,159,42,55019,188,168,79,123,-80,-81,161,4328,1145
87,hrt201d.map,268,292,53649,183,78,84,213,19301,66,262,201,29,117,184,301,4193,8219
88,hrt201d.map,268,292,35155,120,176,147,115,58531,200,160,67,131,-80,-16,96,1676,722
89,hrt201d.map,268,292,33329,114,250,153,41,36969,126,114,141,177,-12,-136,148,2827,4047
90,hrt201d.map,268,292,62035,212,160,55,131,9100,31,243,236,48,181,83,264,6029,4634
91,hrt201d.map,268,292,29937,102,138,165,153,31655,108,172,159,119,-6,34,40,41,41
92,hrt201d.map,268,292,45353,155,198,112,93,48163,164,16,103,275,-9,-182,191,4073,3966
93,hrt201d.map,268,292,18430,63,257,204,34,71718,245,113,22,178,-182,-144,326,3691,3706
94,hrt201d.map,268,292,11432,39,247,228,44,9094,31,249,236,42,8,2,10,11,11
95,hrt201d.map,268,292,6428,22,287,245,4,29958,102,117,165,174,-80,-170,250,3269,5089
96,hrt201d.map,268,292,35553,121,70,146,221,34578,118,169,149,122,3,99,102,1733,2012
97,hrt201d.map,268,292,40361,138,226,129,65,4422,15,249,252,42,123,23,146,549,910
98,hrt201d.map,268,292,29552,101,231,166,60,30189,103,178,164,113,-2,-53,55,56,98
99,hrt201d.map,268,292,41160,140,11,127,280,52841,180,10,87,281,-40,-1,41,112,71
0,hrt201n.map,297,291,67145,230,75,66,215,63850,219,169,77,121,11,94,105,2709,2486
1,hrt201n.map,297,291,46913,161,228,135,62,29481,101,200,195,90,60,-28,88,1232,1792
2,hrt201n.map,297,291,52267,179,112,117,178,76103,261,138,35,152,-82,26,108,900,717
3,hrt201n.map,297,291,28476,97,41,199,249,18156,62,176,234,114,35,135,170,2039,2436
4,hrt201n.map,297,291,69781,239,58,57,232,38742,133,251,163,39,106,193,299,7883,6323
5,hrt201n.map,297,291,54539,187,168,109,122,39198,134,86,162,204,53,-82,135,522,1634
6,hrt201n.map,297,291,55746,191,125,105,165,11094,38,254,258,36,153,129,282,8605,8524
7,hrt201n.map,297,291,60308,207,219,89,71,33055,113,118,183,172,94,-101,195,2972,1158
8,hrt201n.map,297,291,38832,133,161,163,129,82255,282,97,14,193,-149,-64,213,1019,215
9,hrt201n.map,297,291,71473,245,112,51,178,46434,159,125,137,165,86,13,99,1473,482
10,hrt201n.map,297,291,48664,167,223,129,67,28063,96,163,200,127,71,-60,131,2032,1321
11,hrt201n.map,297,291,48185,165,120,131,170,38622,132,80,164,210,33,-40,73,74,124
12,hrt201n.map,297,291,49475,170,285,126,5,14390,49,159,247,131,121,-126,247,5737,2127
13,hrt201n.map,297,291,50532,173,101,123,189,44205,151,26,145,264,22,-75,97,399,104
14,hrt201n.map,297,291,40064,137,93,159,197,60769,208,49,88,241,-71,-44,115,2626,2489
15,hrt201n.map,297,291,85696,294,148,2,142,39778,136,88,160,202,158,-60,218,249,1198
16,hrt201n.map,297,291,63040,216,106,80,184,56326,193,127,103,163,23,21,44,45,45
17,hrt201n.map,297,291,46801,160,49,136,241,72933,250,107,46,183,-90,58,148,149,192
18,hrt201n.map,297,291,59543,204,111,92,179,32127,110,173,186,117,94,62,156,3508,1158
19,hrt201n.map,297,291,46160,158,108,138,182,43344,148,14,148,276,10,-94,104,598,532
20,hrt201n.map,297,291,16312,56,274,240,16,76730,263,93,33,197,-207,-181,388,7354,9406
21,hrt201n.map,297,291,71440,245,145,51,145,29129,100,261,196,29,145,116,261,9551,8915
22,hrt201n.map,297,291,67400,231,111,65,179,57430,197,187,99,103,34,76,110,6234,3133
23,hrt201n.map,297,291,52340,179,39,117,251,63879,219,140,77,150,-40,101,141,1207,1633
24,hrt201n.map,297,291,72699,249,50,47,240,57223,196,103,100,187,53,53,106,381,125
25,hrt201n.map,297,291,66234,227,113,69,177,50898,174,26,122,264,53,-87,140,1202,1184
26,hrt201n.map,297,291,47226,162,206,134,84,46581,160,269,136,21,2,63,65,169,78
27,hrt201n.map,297,291,81642,280,128,16,162,42028,144,166,152,124,136,38,174,3721,5985
28,hrt201n.map,297,291,20436,70,224,226,66,35406,121,95,175,195,-51,-129,180,4839,11859
29,hrt201n.map,297,291,46733,160,117,136,173,47223,162,209,134,81,-2,92,94,1682,2256
30,hrt201n.map,297,291,33062,113,111,183,179,13807,47,160,249,130,66,49,115,1280,1847
31,hrt201n.map,297,291,30912,106,224,190,66,72100,247,67,49,223,-141,-157,298,6010,15881
32,hrt201n.map,297,291,64242,220,68,76,222,36998,127,249,169,41,93,181,274,8252,9393
33,hrt201n.map,297,291,39712,136,154,160,136,14912,51,219,245,71,85,65,150,6587,3120
34,hrt201n.map,297,291,57862,198,46,98,244,37207,127,40,169,250,71,-6,77,3816,2982
35,hrt201n.map,297,291,17866,61,175,235,115,62709,215,146,81,144,-154,-29,183,4098,1981
36,hrt201n.map,297,291,26816,92,246,204,44,72961,250,79,46,211,-158,-167,325,5650,11091
37,hrt201n.map,297,291,77298,265,107,31,183,28375,97,142,199,148,168,35,203,360,328
38,hrt201n.map,297,291,21370,73,163,223,127,45964,157,13,139,277,-84,-150,234,2786,1447
39,hrt201n.map,297,291,14582,50,258,246,32,15551,53,162,243,128,-3,-96,99,6165,4740
40,hrt201n.map,297,291,38612,132,90,164,200,47652,163,71,133,219,-31,-19,50,594,1195
41,hrt201n.map,297,291,48985,168,193,128,97,17197,59,262,237,28,109,69,178,265,980
42,hrt201n.map,297,291,14902,51,229,245,61,24711,84,23,212,267,-33,-206,239,5237,9728
43,hrt201n.map,297,291,41156,141,165,155,125,17781,61,260,235,30,80,95,175,3341,3021
44,hrt201n.map,297,291,20676,71,275,225,15,42236,145,249,151,41,-74,-26,100,251,1446
45,hrt201n.map,297,291,49676,170,84,126,206,26247,90,233,206,57,80,149,229,10195,4111
46,hrt201n.map,297,291,56864,195,171,101,119,79633,273,100,23,190,-78,-71,149,3299,6025
47,hrt201n.map,297,291,48284,165,21,131,269,17796,61,245,235,45,104,224,328,10747,5430
48,hrt201n.map,297,291,32713,112,169,184,121,44771,153,42,143,248,-41,-127,168,2657,3700
49,hrt201n.map,297,291,83969,288,129,8,161,26327,90,153,206,137,198,24,222,3730,5587
50,hrt201n.map,297,291,28244,97,273,199,17,67430,231,81,65,209,-134,-192,326,9239,11320
51,hrt201n.map,297,291,54338,186,78,110,212,63933,219,86,77,204,-33,8,41,4131,2299
52,hrt201n.map,297,291,75272,258,96,38,194,60674,208,144,88,146,50,48,98,978,1131
53,hrt201n.map,297,291,42395,145,90,151,200,17415,59,44,237,246,86,-46,132,1866,2328
54,hrt201n.map,297,291,16418,56,168,240,122,83965,288,133,8,157,-232,-35,267,5718,2754
55,hrt201n.map,297,291,3240,11,251,285,39,18298,62,34,234,256,-51,-217,268,5250,7763
56,hrt201n.map,297,291,24676,84,58,212,232,19268,66,228,230,62,18,170,188,10950,7922
57,hrt201n.map,297,291,30348,104,206,192,84,22639,77,58,219,232,27,-148,175,3809,2335
58,hrt201n.map,297,291,17017,58,151,238,139,54340,186,76,110,214,-128,-75,203,771,3879
59,hrt201n.map,297,291,39987,137,170,159,120,61063,209,46,87,244,-72,-124,196,2814,2285
60,hrt201n.map,297,291,24979,85,46,211,244,83957,288,141,8,149,-203,95,298,3953,3481
61,hrt201n.map,297,291,45352,155,43,141,247,56538,194,206,102,84,-39,163,202,6376,3981
62,hrt201n.map,297,291,40569,139,170,157,120,22831,78,157,218,133,61,-13,74,1222,1087
63,hrt201n.map,297,291,26223,90,257,206,33,70623,242,89,54,201,-152,-168,320,5462,9446
64,hrt201n.map,297,291,24299,83,144,213,146,42181,144,13,152,277,-61,-131,192,3112,1215
65,hrt201n.map,297,291,55059,189,230,107,60,78395,269,174,27,116,-80,-56,136,7404,8654
66,hrt201n.map,297,291,63865,219,154,77,136,46442,159,117,137,173,60,-37,97,964,1916
67,hrt201n.map,297,291,78160,268,118,28,172,41383,142,229,154,61,126,111,237,2611,3315
68,hrt201n.map,297,291,61756,212,226,84,64,63646,218,82,78,208,-6,-144,150,8089,7537
69,hrt201n.map,297,291,31618,108,100,188,190,14390,49,159,247,131,59,59,118,1402,1822
70,hrt201n.map,297,291,58257,200,233,96,57,59613,204,41,92,249,-4,-192,196,3245,9958
71,hrt201n.map,297,291,41962,144,232,152,58,24110,82,42,214,248,62,-190,252,2041,408
72,hrt201n.map,297,291,56697,194,47,102,243,18342,63,281,233,9,131,234,365,11364,8242
73,hrt201n.map,297,291,48019,165,286,131,4,60627,208,191,88,99,-43,-95,138,1579,1994
74,hrt201n.map,297,291,38744,133,249,163,41,19560,67,227,229,63,66,-22,88,1051,415
75,hrt201n.map,297,291,16361,56,225,240,65,38188,131,223,165,67,-75,-2,77,5280,5736
76,hrt201n.map,297,291,37780,129,49,167,241,22734,78,254,218,36,51,205,256,7617,3032
77,hrt201n.map,297,291,57221,196,105,100,185,4391,15,264,281,26,181,159,340,8221,6452
78,hrt201n.map,297,291,22944,78,44,218,246,14275,49,274,247,16,29,230,259,9153,5235
79,hrt201n.map,297,291,45080,154,24,142,266,31563,108,155,188,135,46,131,177,3518,2670
80,hrt201n.map,297,291,35288,121,213,175,77,56120,192,42,104,248,-71,-171,242,677,1087
81,hrt201n.map,297,291,23992,82,160,214,130,71812,246,64,50,226,-164,-96,260,1814,4030
82,hrt201n.map,297,291,36818,126,138,170,152,61070,209,39,87,251,-83,-99,182,808,588
83,hrt201n.map,297,291,44733,153,80,143,210,30687,105,158,191,132,48,78,126,1742,1318
84,hrt201n.map,297,291,20954,72,288,224,2,38015,130,105,166,185,-58,-183,241,3647,9175
85,hrt201n.map,297,291,24481,84,253,212,37,56701,194,43,102,247,-110,-210,320,5329,9448
86,hrt201n.map,297,291,34006,116,40,180,250,38286,131,125,165,165,-15,85,100,101,349
87,hrt201n.map,297,291,65694,225,71,71,219,40798,140,232,156,58,85,161,246,2998,6204
88,hrt201n.map,297,291,4121,14,243,282,47,80458,276,148,20,142,-262,-95,357,10208,11385
89,hrt201n.map,297,291,56694,194,50,102,240,75782,260,168,36,122,-66,118,184,1453,3735
90,hrt201n.map,297,291,67353,231,158,65,132,34527,118,101,178,189,113,-57,170,266,1406
91,hrt201n.map,297,291,45123,155,272,141,18,48766,167,121,129,169,-12,-151,163,3712,4054
92,hrt201n.map,297,291,44561,153,252,143,38,71203,244,91,52,199,-91,-161,252,4027,6459
93,hrt201n.map,297,291,39808,136,58,160,232,61188,210,212,86,78,-74,154,228,2748,1552
94,hrt201n.map,297,291,38225,131,186,165,104,67442,231,69,65,221,-100,-117,217,4666,746
95,hrt201n.map,297,291,17171,59,288,237,2,84830,291,141,5,149,-232,-147,379,11303,10113
96,hrt201n.map,297,291,34408,118,220,178,70,29835,102,137,194,153,16,-83,99,875,1366
97,hrt201n.map,297,291,57778,198,130,98,160,38947,133,46,163,244,65,-84,149,166,808
98,hrt201n.map,297,291,43020,147,47,149,243,31669,108,49,188,241,39,2,41,3667,2992
99,hrt201n.map,297,291,56538,194,206,102,84,9638,33,255,263,35,161,49,210,2633,4858
0,isound1.map,61,53,2964,55,3,5,49,597,11,38,49,14,44,35,79,314,377
1,isound1.map,61,53,2348,44,36,16,16,1238,23,33,37,19,21,-3,24,25,25
2,isound1.map,61,53,372,7,51,53,1,1260,23,11,37,41,-16,-40,56,57,117
3,isound1.map,61,53,1193,22,25,38,27,1286,24,38,36,14,-2,13,15,16,16
4,isound1.map,61,53,2329,43,2,17,50,2977,56,43,4,9,-13,41,54,55,95
5,isound1.map,61,53,611,11,24,49,28,13,0,39,60,13,11,15,26,27,27
6,isound1.map,61,53,2002,37,11,23,41,477,9,52,51,0,28,41,69,262,1646
7,isound1.map,61,53,2104,39,15,21,37,227,4,37,56,15,35,22,57,190,1071
8,isound1.map,61,53,420,7,3,53,49,884,16,16,44,36,-9,13,22,23,23
9,isound1.map,61,53,1912,36,48,24,4,64,1,41,59,11,35,-7,42,43,43
10,isound1.map,61,53,146,2,12,58,40,2591,48,5,12,47,-46,-7,53,671,613
11,isound1.map,61,53,1995,37,18,23,34,269,5,48,55,4,32,30,62,175,1518
12,isound1.map,61,53,1850,34,4,26,48,1268,23,3,37,49,11,-1,12,878,990
13,isound1.map,61,53,3080,58,46,2,6,1151,21,14,39,38,37,-32,69,1479,212
14,isound1.map,61,53,1484,28,52,32,0,2375,44,9,16,43,-16,-43,59,510,208
15,isound1.map,61,53,254,4,10,56,42,743,14,51,46,1,-10,41,51,52,304
16,isound1.map,61,53,736,13,5,47,47,2036,38,30,22,22,-25,25,50,51,51
17,isound1.map,61,53,2413,45,24,15,28,862,16,38,44,14,29,14,43,44,44
18,isound1.map,61,53,2693,50,9,10,43,2903,54,11,6,41,-4,2,6,7,7
19,isound1.map,61,53,1491,28,45,32,7,405,7,18,53,34,21,-27,48,181,49
20,isound1.map,61,53,52,0,0,60,52,1191,22,27,38,25,-22,27,49,50,102
21,isound1.map,61,53,2460,46,30,14,22,3222,60,10,0,42,-14,-20,34,35,35
22,isound1.map,61,53,1194,22,24,38,28,1163,21,2,39,50,1,-22,23,71,259
23,isound1.map,61,53,2486,46,4,14,48,1959,36,1,24,51,10,-3,13,14,14
24,isound1.map,61,53,648,12,40,48,12,2212,41,13,19,39,-29,-27,56,936,194
25,isound1.map,61,53,2896,54,18,6,34,557,10,25,50,27,44,7,51,91,109
26,isound1.map,61,53,1710,32,38,28,14,1271,23,0,37,52,9,-38,47,505,309
27,isound1.map,61,53,429,8,47,52,5,653,12,35,48,17,-4,-12,16,17,17
28,isound1.map,61,53,680,12,8,48,44,3215,60,17,0,35,-48,9,57,476,633
29,isound1.map,61,53,1477,27,6,33,46,1525,28,11,32,41,-1,5,6,7,7
30,isound1.map,61,53,1920,36,40,24,12,1418,26,12,34,40,10,-28,38,923,234
31,isound1.map,61,53,1320,24,4,36,48,2832,53,29,7,23,-29,25,54,311,1092
32,isound1.map,61,53,2175,41,50,19,2,415,7,8,53,44,34,-42,76,239,77
33,isound1.map,61,53,2867,54,47,6,5,1110,20,2,40,50,34,-45,79,1638,337
34,isound1.map,61,53,2753,51,2,9,50,1862,35,45,25,7,16,43,59,250,60
35,isound1.map,61,53,2923,55,44,5,8,2486,46,4,14,48,9,-40,49,50,50
36,isound1.map,61,53,169,3,42,57,10,1925,36,35,24,17,-33,-7,40,41,41
37,isound1.map,61,53,2896,54,18,6,34,11,0,41,60,11,54,23,77,117,135
38,isound1.map,61,53,1794,33,7,27,45,380,7,43,53,9,26,36,62,307,1823
39,isound1.map,61,53,74,1,31,59,21,70,1,35,59,17,0,4,4,5,5
40,isound1.map,61,53,376,7,47,53,5,1961,37,52,23,0,-30,5,35,36,36
41,isound1.map,61,53,1610,30,32,30,20,1502,28,34,32,18,2,2,4,5,5
42,isound1.map,61,53,673,12,15,48,37,3083,58,43,2,9,-46,28,74,75,95
43,isound1.map,61,53,566,10,16,50,36,22,0,30,60,22,10,14,24,119,126
44,isound1.map,61,53,1658,31,37,29,15,2531,47,12,13,40,-16,-25,41,42,159
45,isound1.map,61,53,2233,42,45,18,7,2197,41,28,19,24,1,-17,18,19,19
46,isound1.map,61,53,2235,42,43,18,9,3086,58,40,2,12,-16,-3,19,20,20
47,isound1.map,61,53,725,13,16,47,36,2613,49,36,11,16,-36,20,56,57,57
48,isound1.map,61,53,2742,51,13,9,39,2855,53,6,7,46,-2,-7,9,10,10
49,isound1.map,61,53,2236,42,42,18,10,3045,57,28,3,24,-15,-14,29,30,30
50,isound1.map,61,53,578,10,4,50,48,383,7,40,53,12,3,36,39,177,170
51,isound1.map,61,53,1002,18,4,42,48,167,3,44,57,8,15,40,55,226,56
52,isound1.map,61,53,912,17,41,43,11,852,16,48,44,4,1,7,8,9,9
53,isound1.map,61,53,2112,39,7,21,45,1203,22,15,38,37,17,8,25,802,764
54,isound1.map,61,53,702,13,39,47,13,1222,23,49,37,3,-10,10,20,21,21
55,isound1.map,61,53,360,6,10,54,42,2519,47,24,13,28,-41,14,55,56,63
56,isound1.map,61,53,2888,54,26,6,26,3164,59,15,1,37,-5,-11,16,112,148
57,isound1.map,61,53,1267,23,4,37,48,2844,53,17,7,35,-30,13,43,462,903
58,isound1.map,61,53,928,17,25,43,27,2979,56,41,4,11,-39,16,55,56,56
59,isound1.map,61,53,165,3,46,57,6,1927,36,33,24,19,-33,-13,46,47,47
60,isound1.map,61,53,2978,56,42,4,10,1901,35,6,25,46,21,-36,57,248,58
61,isound1.map,61,53,1272,24,52,36,0,1863,35,44,25,8,-11,-8,19,20,20
62,isound1.map,61,53,3002,56,18,4,34,1083,20,29,40,23,36,11,47,87,48
63,isound1.map,61,53,504,9,25,51,27,1742,32,6,28,46,-23,-19,42,1115,294
64,isound1.map,61,53,3169,59,10,1,42,2381,44,3,16,49,15,-7,22,23,23
65,isound1.map,61,53,1757,33,44,27,8,2654,50,48,10,4,-17,4,21,22,22
66,isound1.map,61,53,2475,46,15,14,37,2847,53,14,7,38,-7,-1,8,9,9
67,isound1.map,61,53,320,6,50,54,2,1940,36,20,24,32,-30,-30,60,1505,164
68,isound1.map,61,53,2656,50,46,10,6,1751,33,50,27,2,17,4,21,22,22
69,isound1.map,61,53,1468,27,15,33,37,445,8,31,52,21,19,16,35,66,36
70,isound1.map,61,53,104,1,1,59,51,1234,23,37,37,15,-22,36,58,59,227
71,isound1.map,61,53,2228,42,50,18,2,1095,20,17,40,35,22,-33,55,986,157
72,isound1.map,61,53,1045,19,14,41,38,789,14,5,46,47,5,-9,14,15,15
73,isound1.map,61,53,682,12,6,48,46,76,1,29,59,23,11,23,34,214,92
74,isound1.map,61,53,2884,54,30,6,22,2213,41,12,19,40,13,-18,31,60,32
75,isound1.map,61,53,34,0,18,60,34,2950,55,17,5,35,-55,-1,56,333,330
76,isound1.map,61,53,395,7,28,53,24,2477,46,13,14,39,-39,-15,54,192,159
77,isound1.map,61,53,1517,28,19,32,33,53,1,52,59,0,27,33,60,85,61
78,isound1.map,61,53,524,9,5,51,47,1077,20,35,40,17,-11,30,41,42,90
79,isound1.map,61,53,2816,53,45,7,7,2095,39,24,21,28,14,-21,35,36,36
80,isound1.map,61,53,490,9,39,51,13,1083,20,29,40,23,-11,-10,21,22,22
81,isound1.map,61,53,2157,40,15,20,37,543,10,39,50,13,30,24,54,179,974
82,isound1.map,61,53,2757,52,51,8,1,661,12,27,48,25,40,-24,64,65,65
83,isound1.map,61,53,254,4,10,56,42,2639,49,10,11,42,-45,0,45,665,611
84,isound1.map,61,53,2763,52,45,8,7,1133,21,32,39,20,31,-13,44,45,45
85,isound1.map,61,53,2449,46,41,14,11,1099,20,13,40,39,26,-28,54,994,200
86,isound1.map,61,53,34,0,18,60,34,1253,23,18,37,34,-23,0,23,24,24
87,isound1.map,61,53,106,2,52,58,0,2991,56,29,4,23,-54,-23,77,78,78
88,isound1.map,61,53,339,6,31,54,21,1924,36,36,24,16,-30,5,35,36,36
89,isound1.map,61,53,1456,27,27,33,25,2547,48,49,12,3,-21,22,43,44,44
90,isound1.map,61,53,2272,42,6,18,46,37,0,15,60,37,42,9,51,500,739
91,isound1.map,61,53,2932,55,35,5,17,1853,34,1,26,51,21,-34,55,188,56
92,isound1.map,61,53,2129,40,43,20,9,2069,39,50,21,2,1,7,8,9,9
93,isound1.map,61,53,1649,31,46,29,6,98,1,7,59,45,30,-39,69,346,70
94,isound1.map,61,53,2953,55,14,5,38,2555,48,41,12,11,7,27,34,79,170
95,isound1.map,61,53,1721,32,27,28,25,1610,30,32,30,20,2,5,7,8,8
96,isound1.map,61,53,123,2,35,58,17,903,17,50,43,2,-15,15,30,31,31
97,isound1.map,61,53,720,13,21,47,31,2625,49,24,11,28,-36,3,39,40,40
98,isound1.map,61,53,1537,29,52,31,0,2778,52,30,8,22,-23,-22,45,46,46
99,isound1.map,61,53,339,6,31,54,21,2372,44,12,16,40,-38,-19,57,479,173
0,lak100c.map,470,320,91821,286,18,183,301,80086,250,233,219,86,36,215,251,9385,4395
1,lak100c.map,470,320,132739,414,60,55,259,97244,303,35,166,284,111,-25,136,1187,501
2,lak100c.map,470,320,92962,290,157,179,162,63781,199,218,270,101,91,61,152,274,2051
3,lak100c.map,470,320,91960,287,199,182,120,42120,131,119,338,200,156,-80,236,1478,4116
4,lak100c.map,470,320,46171,144,228,325,91,132076,412,83,57,236,-268,-145,413,18410,12745
5,lak100c.map,470,320,131452,410,67,59,252,95135,297,224,172,95,113,157,270,10567,6812
6,lak100c.map,470,320,61349,191,90,278,229,130391,407,168,62,151,-216,78,294,20244,17838
7,lak100c.map,470,320,67593,211,246,258,73,91453,285,66,184,253,-74,-180,254,11626,5771
8,lak100c.map,470,320,25719,80,200,389,119,69239,216,200,253,119,-136,0,136,1665,3491
9,lak100c.map,470,320,106593,333,286,136,33,7532,23,147,446,172,310,-139,449,11586,15521
10,lak100c.map,470,320,99828,311,11,158,308,97415,304,184,165,135,7,173,180,2621,2038
11,lak100c.map,470,320,20288,63,191,406,128,72557,226,82,243,237,-163,-109,272,4506,8310
12,lak100c.map,470,320,69613,217,146,252,173,20319,63,160,406,159,154,14,168,2658,2547
13,lak100c.map,470,320,122508,382,51,87,268,68343,213,136,256,183,169,85,254,15165,13677
14,lak100c.map,470,320,86592,270,127,199,192,4630,14,169,455,150,256,42,298,12129,14723
15,lak100c.map,470,320,9446,29,153,440,166,65702,205,217,264,102,-176,64,240,4380,5710
16,lak100c.map,470,320,95332,297,27,172,292,140647,439,152,30,167,-142,125,267,1178,1134
17,lak100c.map,470,320,71800,224,199,245,120,117592,367,167,102,152,-143,-32,175,24553,15410
18,lak100c.map,470,320,54837,171,202,298,117,91359,285,160,184,159,-114,-42,156,3087,478
19,lak100c.map,470,320,139654,436,185,33,134,94678,295,41,174,278,141,-144,285,5742,2985
20,lak100c.map,470,320,124625,389,174,80,145,102725,321,314,148,5,68,140,208,12262,17063
21,lak100c.map,470,320,131016,409,183,60,136,135613,423,66,46,253,-14,-117,131,842,573
22,lak100c.map,470,320,69218,216,221,253,98,94349,294,50,175,269,-78,-171,249,7347,2733
23,lak100c.map,470,320,44244,138,235,331,84,132396,413,83,56,236,-275,-152,427,18678,12910
24,lak100c.map,470,320,127539,398,140,71,179,131371,410,148,59,171,-12,8,20,21,21
25,lak100c.map,470,320,64773,202,186,267,133,48503,151,136,318,183,51,-50,101,184,109
26,lak100c.map,470,320,130467,407,92,62,227,144727,452,232,17,87,-45,140,185,228,288
27,lak100c.map,470,320,41993,131,246,338,73,83175,259,24,210,295,-128,-222,350,14913,4412
28,lak100c.map,470,320,63178,197,181,272,138,25085,78,194,391,125,119,13,132,4044,1936
29,lak100c.map,470,320,92384,288,95,181,224,59309,185,210,284,109,103,115,218,1019,9712
30,lak100c.map,470,320,86995,271,44,198,275,67454,210,65,259,254,61,21,82,12539,11912
31,lak100c.map,470,320,98402,307,157,162,162,18039,56,200,413,119,251,43,294,6920,5871
32,lak100c.map,470,320,55852,174,147,295,172,51630,161,209,308,110,13,62,75,555,751
33,lak100c.map,470,320,131025,409,174,60,145,66999,209,200,260,119,200,26,226,15248,20509
34,lak100c.map,470,320,137194,428,85,41,234,90669,283,210,186,109,145,125,270,11681,8526
35,lak100c.map,470,320,121450,379,149,90,170,89583,279,16,190,303,100,-133,233,1669,7354
36,lak100c.map,470,320,8184,25,135,444,184,36577,114,222,355,97,-89,87,176,339,211
37,lak100c.map,470,320,40723,127,236,342,83,25707,80,212,389,107,47,-24,71,72,83
38,lak100c.map,470,320,66170,206,69,263,250,140615,439,184,30,135,-233,115,348,20922,17235
39,lak100c.map,470,320,53603,167,156,302,163,84540,264,259,205,60,-97,103,200,6440,1299
40,lak100c.map,470,320,74697,233,182,236,137,90860,283,19,186,300,-50,-163,213,8635,8573
41,lak100c.map,470,320,120592,376,47,93,272,10089,31,150,438,169,345,103,448,22344,20133
42,lak100c.map,470,320,67976,212,183,257,136,98957,309,242,160,77,-97,59,156,621,161
43,lak100c.map,470,320,105954,331,285,138,34,43612,136,227,333,92,195,-58,253,3157,9015
44,lak100c.map,470,320,68604,214,195,255,124,91631,286,208,183,111,-72,13,85,86,86
45,lak100c.map,470,320,12962,40,157,429,162,110374,344,25,125,294,-304,-132,436,17647,21867
46,lak100c.map,470,320,129872,405,47,64,272,126270,394,129,75,190,11,82,93,1204,165
47,lak100c.map,470,320,31145,97,214,372,105,59964,187,195,282,124,-90,-19,109,879,1573
48,lak100c.map,470,320,63587,198,92,271,227,6557,20,162,449,157,178,70,248,6182,6983
49,lak100c.map,470,320,42651,133,228,336,91,89703,280,216,189,103,-147,-12,159,1009,463
50,lak100c.map,470,320,21232,66,207,403,112,54551,170,168,299,151,-104,-39,143,3025,4206
51,lak100c.map,470,320,146979,459,220,10,99,10087,31,152,438,167,428,-68,496,24082,23416
52,lak100c.map,470,320,37857,118,222,351,97,95123,297,236,172,83,-179,14,193,2611,3731
53,lak100c.map,470,320,133697,417,62,52,257,107494,335,25,134,294,82,-37,119,120,164
54,lak100c.map,470,320,74384,232,175,237,144,60366,188,113,281,206,44,-62,106,3251,1610
55,lak100c.map,470,320,19681,61,158,408,161,48423,151,216,318,103,-90,58,148,4300,4864
56,lak100c.map,470,320,34667,108,212,361,107,97455,304,144,165,175,-196,-68,264,4371,5852
57,lak100c.map,470,320,67124,209,75,260,244,130781,408,98,61,221,-199,23,222,17075,16695
58,lak100c.map,470,320,51369,160,150,309,169,107535,336,304,133,15,-176,154,330,6926,1018
59,lak100c.map,470,320,93428,291,11,178,308,140574,439,225,30,94,-148,214,362,9702,2488
60,lak100c.map,470,320,111957,349,42,120,277,100935,315,184,154,135,34,142,176,2479,3590
61,lak100c.map,470,320,129538,404,61,65,258,78895,246,144,223,175,158,83,241,17365,13573
62,lak100c.map,470,320,69258,216,181,253,138,136171,425,148,44,171,-209,-33,242,19276,16591
63,lak100c.map,470,320,52331,163,148,306,171,64549,201,90,268,229,-38,-58,96,2329,2052
64,lak100c.map,470,320,21553,67,206,402,113,49779,155,140,314,179,-88,-66,154,4208,3868
65,lak100c.map,470,320,72226,225,93,244,226,89566,279,33,190,286,-54,-60,114,10618,12658
66,lak100c.map,470,320,103333,322,26,147,293,130062,406,177,63,142,-84,151,235,280,2167
67,lak100c.map,470,320,125620,392,139,77,180,87351,272,8,197,311,120,-131,251,977,6418
68,lak100c.map,470,320,45632,142,127,327,192,139054,434,145,35,174,-292,18,310,23230,20387
69,lak100c.map,470,320,86916,271,123,198,196,81495,254,104,215,215,17,-19,36,37,37
70,lak100c.map,470,320,93275,291,164,178,155,31789,99,210,370,109,192,46,238,5099,4101
71,lak100c.map,470,320,13619,42,140,427,179,67125,209,74,260,245,-167,-66,233,5241,5103
72,lak100c.map,470,320,99184,309,15,160,304,43932,137,227,332,92,172,212,384,5182,11452
73,lak100c.map,470,320,71842,224,157,245,162,56494,176,145,293,174,48,-12,60,1892,1732
74,lak100c.map,470,320,90715,283,164,186,155,92340,288,139,181,180,-5,-25,30,205,80
75,lak100c.map,470,320,34340,107,219,362,100,72861,227,98,242,221,-120,-121,241,752,5166
76,lak100c.map,470,320,99978,312,181,157,138,63303,197,56,272,263,115,-125,240,6480,4215
77,lak100c.map,470,320,83410,260,109,209,210,108133,337,26,132,293,-77,-83,160,1553,6585
78,lak100c.map,470,320,57795,180,124,289,195,34093,106,146,363,173,74,22,96,911,940
79,lak100c.map,470,320,120500,376,139,93,180,141517,442,242,27,77,-66,103,169,3142,399
80,lak100c.map,470,320,81352,254,247,215,72,77530,242,229,227,90,12,-18,30,53,146
81,lak100c.map,470,320,128528,401,111,68,208,49108,153,171,316,148,248,60,308,19063,19153
82,lak100c.map,470,320,138740,433,139,36,180,65516,204,83,265,236,229,-56,285,17315,19075
83,lak100c.map,470,320,43074,134,125,335,194,97247,303,32,166,287,-169,-93,262,12549,9645
84,lak100c.map,470,320,96400,301,239,168,80,91945,287,214,182,105,14,-25,39,40,40
85,lak100c.map,470,320,56432,176,207,293,112,78585,245,134,224,185,-69,-73,142,1252,155
86,lak100c.map,470,320,94385,294,14,175,305,26999,84,200,385,119,210,186,396,12349,13306
87,lak100c.map,470,320,21889,68,190,401,129,52591,164,208,305,111,-96,18,114,1778,954
88,lak100c.map,470,320,2724,8,155,461,164,39534,123,145,346,174,-115,-10,125,1668,714
89,lak100c.map,470,320,97081,303,198,166,121,36870,115,249,354,70,188,51,239,268,1295
90,lak100c.map,470,320,63194,197,165,272,154,65683,205,236,264,83,-8,71,79,80,80
91,lak100c.map,470,320,100148,312,11,157,308,47837,149,162,320,157,163,151,314,11756,12454
92,lak100c.map,470,320,48819,152,140,317,179,125292,391,147,78,172,-239,7,246,25080,20140
93,lak100c.map,470,320,72248,225,71,244,248,135185,422,174,47,145,-197,103,300,20279,18420
94,lak100c.map,470,320,44033,137,126,332,193,125587,392,172,77,147,-255,46,301,25011,17196
95,lak100c.map,470,320,128291,400,28,69,291,98831,308,48,161,271,92,20,112,1057,1380
96,lak100c.map,470,320,57057,178,222,291,97,133258,416,181,53,138,-238,-41,279,21412,12944
97,lak100c.map,470,320,118536,370,183,99,136,34975,109,224,360,95,261,41,302,17135,26789
98,lak100c.map,470,320,127312,397,47,72,272,143798,449,201,20,118,-52,154,206,263,434
99,lak100c.map,470,320,64081,200,238,269,81,121787,380,132,89,187,-180,-106,286,23475,13036
0,lak100d.map,469,320,68026,212,133,256,186,99379,310,140,158,179,-98,7,105,5031,3850
1,lak100d.map,469,320,85547,267,212,201,107,31461,98,218,370,101,169,6,175,2566,1430
2,lak100d.map,469,320,103688,324,311,144,8,29598,92,161,376,158,232,-150,382,11156,2719
3,lak100d.map,469,320,76978,240,141,228,178,107543,336,296,132,23,-96,155,251,5776,6399
4,lak100d.map,469,320,141208,441,231,27,88,81352,254,247,214,72,187,16,203,16530,23695
5,lak100d.map,469,320,92658,289,141,179,178,141254,441,185,27,134,-152,44,196,12135,13102
6,lak100d.map,469,320,100984,315,135,153,184,61841,193,238,275,81,122,103,225,275,3218
7,lak100d.map,469,320,68019,212,140,256,179,32087,100,232,368,87,112,92,204,429,602
8,lak100d.map,469,320,66680,208,199,260,120,81051,253,228,215,91,-45,29,74,7449,1097
9,lak100d.map,469,320,98865,308,14,160,305,60886,190,233,278,86,118,219,337,5081,10924
10,lak100d.map,469,320,97867,305,52,163,267,66975,209,224,259,95,96,172,268,2711,9330
11,lak100d.map,469,320,13307,41,132,427,187,86020,268,59,200,260,-227,-73,300,20716,16468
12,lak100d.map,469,320,99473,310,46,158,273,144446,451,193,17,126,-141,147,288,1060,6483
13,lak100d.map,469,320,82427,257,132,211,187,109399,341,40,127,279,-84,-92,176,11791,18095
14,lak100d.map,469,320,36971,115,148,353,171,27966,87,193,381,126,28,45,73,2038,3336
15,lak100d.map,469,320,97097,303,182,165,137,27902,87,257,381,62,216,75,291,431,2556
16,lak100d.map,469,320,93900,293,179,175,140,95798,299,201,169,118,-6,22,28,29,29
17,lak100d.map,469,320,7187,22,172,446,147,35292,110,227,358,92,-88,55,143,372,2355
18,lak100d.map,469,320,146346,457,213,11,106,41351,129,248,339,71,328,35,363,12948,28189
19,lak100d.map,469,320,20005,62,154,406,165,44983,140,136,328,183,-78,-18,96,347,720
20,lak100d.map,469,320,100353,313,126,155,193,59090,184,109,284,210,129,-17,146,11598,7516
21,lak100d.map,469,320,57707,180,212,288,107,80087,250,232,218,87,-70,20,90,7611,1586
22,lak100d.map,469,320,87222,272,137,196,182,137767,430,152,38,167,-158,15,173,21080,19364
23,lak100d.map,469,320,91589,286,250,182,69,21558,67,201,401,118,219,-49,268,6242,5312
24,lak100d.map,469,320,90688,283,191,185,128,95909,299,90,169,229,-16,-101,117,2376,950
25,lak100d.map,469,320,103010,321,29,147,290,44570,139,229,329,90,182,200,382,4595,12198
26,lak100d.map,469,320,129204,403,75,65,244,77628,242,131,226,188,161,56,217,21055,16515
27,lak100d.map,469,320,26362,82,197,386,122,124430,388,49,80,270,-306,-148,454,20941,20010
28,lak100d.map,469,320,143154,447,205,21,114,99071,309,128,159,191,138,-77,215,10193,9282
29,lak100d.map,469,320,130829,408,50,60,269,74134,231,105,237,214,177,55,232,17796,14299
30,lak100d.map,469,320,45649,142,110,326,209,101455,317,304,151,15,-175,194,369,11695,1419
31,lak100d.map,469,320,61560,192,199,276,120,28325,88,154,380,165,104,-45,149,2469,943
32,lak100d.map,469,320,35234,110,285,358,34,72212,225,107,243,212,-115,-178,293,4804,596
33,lak100d.map,469,320,26609,83,270,385,49,59734,186,105,282,214,-103,-165,268,3607,1403
34,lak100d.map,469,320,37827,118,252,350,67,88172,275,147,193,172,-157,-105,262,6898,969
35,lak100d.map,469,320,35570,111,269,357,50,87220,272,139,196,180,-161,-130,291,5674,503
36,lak100d.map,469,320,94848,296,191,172,128,132716,414,83,54,236,-118,-108,226,6769,10385
37,lak100d.map,469,320,96554,301,85,167,234,34412,107,147,361,172,194,62,256,12016,14050
38,lak100d.map,469,320,32328,101,311,367,8,142858,446,181,22,138,-345,-130,475,28089,13194
39,lak100d.map,469,320,8488,26,151,442,168,120491,376,148,92,171,-350,-3,353,31097,24208
40,lak100d.map,469,320,73200,228,79,240,240,124325,388,154,80,165,-160,75,235,24428,18718
41,lak100d.map,469,320,124952,390,167,78,152,17127,53,152,415,167,337,-15,352,23515,29979
42,lak100d.map,469,320,18736,58,143,410,176,83185,259,14,209,305,-201,-129,330,19865,16369
43,lak100d.map,469,320,29169,91,270,377,49,147917,462,242,6,77,-371,-28,399,28223,13138
44,lak100d.map,469,320,59088,184,111,284,208,95506,298,173,170,146,-114,62,176,4708,8767
45,lak100d.map,469,320,65042,203,237,265,82,9109,28,170,440,149,175,-67,242,7590,4008
46,lak100d.map,469,320,61890,193,189,275,130,100986,315,133,153,186,-122,-56,178,4181,2725
47,lak100d.map,469,320,134265,419,134,49,185,9147,28,132,440,187,391,-2,393,24438,30118
48,lak100d.map,469,320,95466,298,213,170,106,109084,340,35,128,284,-42,-178,220,4210,3030
49,lak100d.map,469,320,50378,157,181,311,138,54287,169,112,299,207,-12,-69,81,650,486
50,lak100d.map,469,320,68961,215,158,253,161,69548,217,211,251,108,-2,53,55,56,56
51,lak100d.map,469,320,44993,140,126,328,193,46254,144,145,324,174,-4,19,23,37,62
52,lak100d.map,469,320,88438,276,201,192,118,97559,304,40,164,279,-28,-161,189,9746,23991
53,lak100d.map,469,320,98385,307,174,161,145,88068,275,251,193,68,32,77,109,657,110
54,lak100d.map,469,320,23162,72,197,396,122,97995,306,244,162,75,-234,47,281,4392,6911
55,lak100d.map,469,320,49388,154,211,314,108,66014,206,225,262,94,-52,14,66,222,586
56,lak100d.map,469,320,45587,142,172,326,147,116327,363,152,105,167,-221,-20,241,31360,22033
57,lak100d.map,469,320,32040,100,279,368,40,90980,284,219,184,100,-184,-60,244,2990,1321
58,lak100d.map,469,320,90672,283,207,185,112,24455,76,184,392,135,207,-23,230,6167,1924
59,lak100d.map,469,320,2068,6,171,462,148,21870,68,209,400,110,-62,38,100,346,807
60,lak100d.map,469,320,56503,176,136,292,183,119511,373,168,95,151,-197,32,229,31055,20503
61,lak100d.map,469,320,87515,273,164,195,155,60903,190,216,278,103,83,52,135,864,7668
62,lak100d.map,469,320,73075,228,204,240,115,40708,127,251,341,68,101,47,148,152,398
63,lak100d.map,469,320,17768,55,151,413,168,82767,258,112,210,207,-203,-39,242,16766,10070
64,lak100d.map,469,320,27317,85,202,383,117,87783,274,216,194,103,-189,14,203,2380,4080
65,lak100d.map,469,320,94881,296,158,172,161,99035,309,164,159,155,-13,6,19,20,20
66,lak100d.map,469,320,101094,315,25,153,294,36214,113,265,355,54,202,240,442,4856,13547
67,lak100d.map,469,320,67984,212,175,256,144,98376,307,183,161,136,-95,8,103,2011,1802
68,lak100d.map,469,320,98601,308,278,160,41,51963,162,196,306,123,146,-82,228,239,1979
69,lak100d.map,469,320,67016,209,183,259,136,94515,295,204,173,115,-86,21,107,892,485
70,lak100d.map,469,320,103420,323,259,145,60,89668,280,251,188,68,43,-8,51,1353,4045
71,lak100d.map,469,320,8158,25,161,443,158,120814,377,145,91,174,-352,-16,368,31022,24279
72,lak100d.map,469,320,30491,95,228,373,91,139293,435,226,33,93,-340,-2,342,34197,17261
73,lak100d.map,469,320,39208,122,151,346,168,119635,373,44,95,275,-251,-107,358,16703,19749
74,lak100d.map,469,320,108816,340,303,128,16,64796,202,163,266,156,138,-140,278,906,5176
75,lak100d.map,469,320,71907,224,92,244,227,145676,455,243,13,76,-231,151,382,25855,18426
76,lak100d.map,469,320,56120,175,199,293,120,36829,115,290,353,29,60,91,151,162,253
77,lak100d.map,469,320,35297,110,222,358,97,41036,128,243,340,76,-18,21,39,45,40
78,lak100d.map,469,320,126024,393,55,75,264,97743,305,176,163,143,88,121,209,8484,4593
79,lak100d.map,469,320,11681,36,158,432,161,35543,111,296,357,23,-75,138,213,2144,2367
80,lak100d.map,469,320,116125,362,34,106,285,69967,218,112,250,207,144,78,222,15498,10936
81,lak100d.map,469,320,62227,194,172,274,147,70607,220,112,248,207,-26,-60,86,87,94
82,lak100d.map,469,320,132952,415,167,53,152,95794,299,205,169,114,116,38,154,11193,16475
83,lak100d.map,469,320,132945,415,174,53,145,131140,409,59,59,260,6,-115,121,357,368
84,lak100d.map,469,320,117258,366,181,102,138,118902,371,137,97,182,-5,-44,49,50,50
85,lak100d.map,469,320,20922,65,197,403,122,131044,409,155,59,164,-344,-42,386,28026,21457
86,lak100d.map,469,320,90400,282,159,186,160,65176,203,103,265,216,79,-56,135,3607,5180
87,lak100d.map,469,320,94293,294,106,174,213,67461,210,58,258,261,84,-48,132,10924,10058
88,lak100d.map,469,320,142468,445,251,23,68,58676,183,203,285,116,262,-48,310,14778,30414
89,lak100d.map,469,320,128184,400,135,68,184,90732,283,147,185,172,117,12,129,12792,8173
90,lak100d.map,469,320,84270,263,209,205,110,100943,315,176,153,143,-52,-33,85,114,105
91,lak100d.map,469,320,92425,288,54,180,265,96765,302,194,166,125,-14,140,154,1403,2144
92,lak100d.map,469,320,91337,285,182,183,137,81260,253,19,215,300,32,-163,195,2655,4220
93,lak100d.map,469,320,68264,213,215,255,104,90418,282,141,186,178,-69,-74,143,4325,297
94,lak100d.map,469,320,127497,398,182,70,137,131677,411,162,57,157,-13,-20,33,34,34
95,lak100d.map,469,320,71577,223,102,245,217,132423,413,56,55,263,-190,-46,236,15188,17212
96,lak100d.map,469,320,15824,49,175,419,144,121123,378,156,90,163,-329,-19,348,30959,23094
97,lak100d.map,469,320,124432,388,47,80,272,89535,279,64,189,255,109,17,126,967,1599
98,lak100d.map,469,320,34336,107,223,361,96,97035,303,244,165,75,-196,21,217,3215,4027
99,lak100d.map,469,320,70185,219,214,249,105,25729,80,190,388,129,139,-24,163,3887,2030
0,lak100n.map,470,320,134628,420,91,49,228,129135,403,144,66,175,17,53,70,71,71
1,lak100n.map,470,320,12976,40,143,429,176,82858,258,21,211,298,-218,-122,340,17719,15281
2,lak100n.map,470,320,32169,100,150,369,169,84755,264,44,205,275,-164,-106,270,15075,12797
3,lak100n.map,470,320,38777,121,262,348,57,13634,42,125,427,194,79,-137,216,305,298
4,lak100n.map,470,320,66371,207,188,262,131,96764,302,195,167,124,-95,7,102,1086,1444
5,lak100n.map,470,320,97514,304,85,165,234,121131,378,148,91,171,-74,63,137,7281,6482
6,lak100n.map,470,320,92337,288,142,181,177,89566,279,33,190,286,9,-109,118,1341,4201
7,lak100n.map,470,320,66339,207,220,262,99,86462,270,257,199,62,-63,37,100,2878,2024
8,lak100n.map,470,320,59668,186,171,283,148,34973,109,226,360,93,77,55,132,1081,365
9,lak100n.map,470,320,146312,457,247,12,72,94551,295,168,174,151,162,-79,241,11472,13419
10,lak100n.map,470,320,95819,299,180,170,139,97990,306,249,163,70,-7,69,76,77,77
11,lak100n.map,470,320,97491,304,108,165,211,94239,294,160,175,159,10,52,62,318,453
12,lak100n.map,470,320,123052,384,147,85,172,130807,408,72,61,247,-24,-75,99,229,187
13,lak100n.map,470,320,56507,176,132,293,187,81268,253,11,216,308,-77,-121,198,13063,12055
14,lak100n.map,470,320,116010,362,149,107,170,87013,271,26,198,293,91,-123,214,1819,8251
15,lak100n.map,470,320,130820,408,59,61,260,19957,62,202,407,117,346,143,489,20283,20577
16,lak100n.map,470,320,97576,304,23,165,296,60988,190,131,279,188,114,108,222,15598,11700
17,lak100n.map,470,320,80761,252,198,217,121,89250,278,29,191,290,-26,-169,195,5821,6505
18,lak100n.map,470,320,133283,416,156,53,163,67020,209,179,260,140,207,23,230,16744,19305
19,lak100n.map,470,320,15508,48,171,421,148,97439,304,160,165,159,-256,-11,267,9603,9324
20,lak100n.map,470,320,99650,311,189,158,130,140646,439,153,30,166,-128,-36,164,11336,10361
21,lak100n.map,470,320,52009,162,150,307,169,76586,239,213,230,106,-77,63,140,463,354
22,lak100n.map,470,320,93404,291,35,178,284,67333,210,186,259,133,81,151,232,7263,8790
23,lak100n.map,470,320,83897,262,262,207,57,100758,314,41,155,278,-52,-221,273,4741,4294
24,lak100n.map,470,320,70313,219,86,250,233,11039,34,160,435,159,185,74,259,5846,5372
25,lak100n.map,470,320,86816,271,223,198,96,145075,453,204,16,115,-182,-19,201,16393,12718
26,lak100n.map,470,320,126580,395,139,74,180,126895,396,144,73,175,-1,5,6,7,7
27,lak100n.map,470,320,54613,170,106,299,213,123478,385,41,84,278,-215,-65,280,13858,19299
28,lak100n.map,470,320,62192,194,207,275,112,140571,439,228,30,91,-245,21,266,26285,15108
29,lak100n.map,470,320,129104,403,175,66,144,40076,125,243,344,76,278,68,346,17907,22715
30,lak100n.map,470,320,145708,455,211,14,108,26087,81,152,388,167,374,-59,433,21344,22860
31,lak100n.map,470,320,87953,274,46,195,273,44671,139,128,330,191,135,82,217,9062,12905
32,lak100n.map,470,320,9141,28,138,441,181,10415,32,144,437,175,-4,6,10,11,11
33,lak100n.map,470,320,69857,218,222,251,97,82454,257,105,212,214,-39,-117,156,6336,1633
34,lak100n.map,470,320,54827,171,212,298,107,94239,294,160,175,159,-123,-52,175,2995,1960
35,lak100n.map,470,320,126552,395,167,74,152,92698,289,101,180,218,106,-66,172,7115,7021
36,lak100n.map,470,320,90992,284,207,185,112,116976,365,143,104,176,-81,-64,145,20667,12179
37,lak100n.map,470,320,40088,125,231,344,88,91271,285,248,184,71,-160,17,177,4060,3837
38,lak100n.map,470,320,122716,383,163,86,156,139381,435,138,34,181,-52,-25,77,78,78
39,lak100n.map,470,320,32809,102,150,367,169,62311,194,88,275,231,-92,-62,154,3579,3519
40,lak100n.map,470,320,83088,259,111,210,208,91645,286,194,183,125,-27,83,110,292,638
41,lak100n.map,470,320,97409,304,190,165,129,91335,285,184,184,135,19,-6,25,26,26
42,lak100n.map,470,320,134968,421,71,48,248,123390,385,129,84,190,36,58,94,1268,234
43,lak100n.map,470,320,93019,290,100,179,219,95197,297,162,172,157,-7,62,69,640,816
44,lak100n.map,470,320,74076,231,163,238,156,63294,197,65,272,254,34,-98,132,1090,2448
45,lak100n.map,470,320,39208,122,151,347,168,69553,217,206,252,113,-95,55,150,608,2367
46,lak100n.map,470,320,142163,444,236,25,83,49111,153,168,316,151,291,-68,359,18903,27268
47,lak100n.map,470,320,98606,308,273,161,46,95590,298,89,171,230,10,-184,194,2829,1098
48,lak100n.map,470,320,128864,402,95,67,224,53284,166,155,303,164,236,60,296,16400,17061
49,lak100n.map,470,320,74024,231,215,238,104,37501,117,258,352,61,114,43,157,1710,2179
50,lak100n.map,470,320,59666,186,173,283,146,98380,307,179,162,140,-121,6,127,2783,2262
51,lak100n.map,470,320,143808,449,191,20,128,17131,53,148,416,171,396,-43,439,22862,22833
52,lak100n.map,470,320,41450,129,149,340,170,106595,333,284,136,35,-204,135,339,10194,7160
53,lak100n.map,470,320,67393,210,126,259,193,120785,377,174,92,145,-167,48,215,24219,16979
54,lak100n.map,470,320,69336,216,103,253,216,108820,340,299,129,20,-124,196,320,5153,736
55,lak100n.map,470,320,94931,296,108,173,211,76332,238,147,231,172,58,39,97,7003,5873
56,lak100n.map,470,320,117297,366,142,103,177,125391,391,48,78,271,-25,-94,119,923,715
57,lak100n.map,470,320,132704,414,95,55,224,70823,221,216,248,103,193,121,314,14685,15510
58,lak100n.map,470,320,44017,137,142,332,177,29861,93,218,376,101,44,76,120,3451,4173
59,lak100n.map,470,320,133283,416,156,53,163,20915,65,204,404,115,351,48,399,20867,22709
60,lak100n.map,470,320,28274,88,205,381,114,82951,259,248,210,71,-171,43,214,7661,5965
61,lak100n.map,470,320,129885,405,34,64,285,123470,385,49,84,270,20,15,35,36,41
62,lak100n.map,470,320,98546,307,13,162,306,24429,76,210,393,109,231,197,428,11895,13448
63,lak100n.map,470,320,140626,439,173,30,146,91499,285,20,184,299,154,-153,307,2081,1582
64,lak100n.map,470,320,100369,313,110,156,209,98530,307,29,162,290,6,-81,87,354,1392
65,lak100n.map,470,320,70329,219,70,250,249,137765,430,154,39,165,-211,84,295,18986,17774
66,lak100n.map,470,320,94609,295,110,174,209,67314,210,205,259,114,85,95,180,2095,5560
67,lak100n.map,470,320,31473,98,206,371,113,100939,315,180,154,139,-217,-26,243,3826,5903
68,lak100n.map,470,320,11677,36,162,433,157,129103,403,176,66,143,-367,14,381,22716,24010
69,lak100n.map,470,320,129856,405,63,64,256,99606,311,233,158,86,94,170,264,11101,6616
70,lak100n.map,470,320,139333,435,186,34,133,7837,24,162,445,157,411,-24,435,24022,22808
71,lak100n.map,470,320,69011,215,108,254,211,136142,425,177,44,142,-210,69,279,19996,16874
72,lak100n.map,470,320,124011,387,148,82,171,109742,342,17,127,302,45,-131,176,1395,1535
73,lak100n.map,470,320,62942,196,97,273,222,56207,175,112,294,207,21,15,36,2877,2344
74,lak100n.map,470,320,141523,442,236,27,83,126910,396,129,73,190,46,-107,153,301,2443
75,lak100n.map,470,320,97130,303,149,166,170,88630,276,9,193,310,27,-140,167,1103,3570
76,lak100n.map,470,320,128508,401,131,68,188,130757,408,122,61,197,-7,-9,16,17,17
77,lak100n.map,470,320,69640,217,119,252,200,131694,411,145,58,174,-194,26,220,18560,16830
78,lak100n.map,470,320,44021,137,138,332,181,93007,290,112,179,207,-153,-26,179,11157,5818
79,lak100n.map,470,320,68258,213,221,256,98,129245,403,34,66,285,-190,-187,377,11265,12813
80,lak100n.map,470,320,91776,286,63,183,256,95322,297,37,172,282,-11,-26,37,38,38
81,lak100n.map,470,320,47835,149,164,320,155,72479,226,160,243,159,-77,-4,81,1393,1213
82,lak100n.map,470,320,71610,223,69,246,250,59674,186,165,283,154,37,96,133,1693,153
83,lak100n.map,470,320,131980,412,179,57,140,73085,228,194,241,125,184,15,199,16064,19119
84,lak100n.map,470,320,69682,217,77,252,242,74407,232,152,237,167,-15,75,90,2165,718
85,lak100n.map,470,320,85100,265,19,204,300,24765,77,194,392,125,188,175,363,13186,17708
86,lak100n.map,470,320,44987,140,132,329,187,138087,431,152,38,167,-291,20,311,22719,17056
87,lak100n.map,470,320,71899,224,100,245,219,40084,125,235,344,84,99,135,234,579,317
88,lak100n.map,470,320,76889,240,230,229,89,93098,290,21,179,298,-50,-209,259,4175,9750
89,lak100n.map,470,320,93385,291,54,178,265,96458,301,181,168,138,-10,127,137,1351,1569
90,lak100n.map,470,320,55243,172,116,297,203,17095,53,184,416,135,119,68,187,3876,4785
91,lak100n.map,470,320,93555,292,204,177,115,142822,446,217,23,102,-154,13,167,14878,11696
92,lak100n.map,470,320,74349,232,210,237,109,77197,241,242,228,77,-9,32,41,5491,1304
93,lak100n.map,470,320,19650,61,189,408,130,69260,216,179,253,140,-155,-10,165,2139,5278
94,lak100n.map,470,320,133625,417,134,52,185,144757,452,202,17,117,-35,68,103,667,790
95,lak100n.map,470,320,136242,425,77,44,242,146628,458,251,11,68,-33,174,207,828,2938
96,lak100n.map,470,320,98371,307,188,162,131,95276,297,83,172,236,10,-105,115,1249,525
97,lak100n.map,470,320,94803,296,236,173,83,129139,403,140,66,179,-107,-96,203,12793,11469
98,lak100n.map,470,320,134904,421,135,48,184,122082,381,157,88,162,40,22,62,63,63
99,lak100n.map,470,320,72165,225,154,244,165,130174,406,65,63,254,-181,-89,270,13515,15633
0,lak101d.map,27,22,488,22,17,4,4,135,6,18,20,3,16,1,17,18,18
1,lak101d.map,27,22,230,10,11,16,10,207,9,12,17,9,1,1,2,3,3
2,lak101d.map,27,22,472,21,11,5,10,134,6,19,20,2,15,8,23,24,24
3,lak101d.map,27,22,49,2,16,24,5,443,20,18,6,3,-18,2,20,21,21
4,lak101d.map,27,22,104,4,5,22,16,91,4,18,22,3,0,13,13,17,17
5,lak101d.map,27,22,472,21,11,5,10,375,17,20,9,1,4,9,13,14,14
6,lak101d.map,27,22,320,14,9,12,12,229,10,12,16,9,4,3,7,8,8
7,lak101d.map,27,22,331,15,20,11,1,135,6,18,20,3,9,-2,11,12,17
8,lak101d.map,27,22,155,7,20,19,1,493,22,12,4,9,-15,-8,23,24,24
9,lak101d.map,27,22,224,10,17,16,4,513,23,14,3,7,-13,-3,16,17,17
10,lak101d.map,27,22,144,6,9,20,12,3,0,18,26,3,6,9,15,18,16
11,lak101d.map,27,22,386,17,9,9,12,211,9,8,17,13,8,-1,9,10,10
12,lak101d.map,27,22,152,6,1,20,20,29,1,14,25,7,5,13,18,30,19
13,lak101d.map,27,22,528,24,21,2,0,22,1,21,25,0,23,0,23,41,45
14,lak101d.map,27,22,24,1,19,25,2,102,4,7,22,14,-3,-12,15,41,21
15,lak101d.map,27,22,377,17,18,9,3,421,19,18,7,3,-2,0,2,3,3
16,lak101d.map,27,22,136,6,17,20,4,93,4,16,22,5,2,-1,3,4,4
17,lak101d.map,27,22,138,6,15,20,6,508,23,19,3,2,-17,4,21,25,22
18,lak101d.map,27,22,83,3,4,23,17,310,14,19,12,2,-11,15,26,31,45
19,lak101d.map,27,22,80,3,7,23,14,470,21,13,5,8,-18,6,24,25,33
20,lak101d.map,27,22,316,14,13,12,8,167,7,8,19,13,7,-5,12,13,13
21,lak101d.map,27,22,73,3,14,23,7,386,17,9,9,12,-14,-5,19,20,20
22,lak101d.map,27,22,464,21,19,5,2,292,13,15,13,6,8,-4,12,13,13
23,lak101d.map,27,22,336,15,15,11,6,295,13,12,13,9,2,-3,5,6,6
24,lak101d.map,27,22,311,14,18,12,3,23,1,20,25,1,13,2,15,16,16
25,lak101d.map,27,22,252,11,11,15,10,422,19,17,7,4,-8,6,14,15,15
26,lak101d.map,27,22,181,8,16,18,5,423,19,16,7,5,-11,0,11,12,12
27,lak101d.map,27,22,490,22,15,4,6,290,13,17,13,4,9,2,11,12,12
28,lak101d.map,27,22,80,3,7,23,14,289,13,18,13,3,-10,11,21,22,40
29,lak101d.map,27,22,124,5,7,21,14,404,18,13,8,8,-13,6,19,20,20
30,lak101d.map,27,22,117,5,14,21,7,30,1,13,25,8,4,-1,5,6,6
31,lak101d.map,27,22,246,11,17,15,4,167,7,8,19,13,4,-9,13,14,14
32,lak101d.map,27,22,362,16,11,10,10,253,11,10,15,11,5,-1,6,7,7
33,lak101d.map,27,22,380,17,15,9,6,287,13,20,13,1,4,5,9,10,10
34,lak101d.map,27,22,173,7,2,19,19,334,15,17,11,4,-8,15,23,24,24
35,lak101d.map,27,22,293,13,14,13,7,231,10,10,16,11,3,-4,7,8,8
36,lak101d.map,27,22,468,21,15,5,6,189,8,8,18,13,13,-7,20,21,21
37,lak101d.map,27,22,357,16,16,10,5,167,7,8,19,13,9,-8,17,18,18
38,lak101d.map,27,22,138,6,15,20,6,246,11,17,15,4,-5,2,7,8,8
39,lak101d.map,27,22,232,10,9,16,12,153,6,0,20,21,4,-9,13,14,14
40,lak101d.map,27,22,360,16,13,10,8,385,17,10,9,11,-1,-3,4,5,5
41,lak101d.map,27,22,165,7,10,19,11,174,7,1,19,20,0,-9,9,10,10
42,lak101d.map,27,22,209,9,10,17,11,333,15,18,11,3,-6,8,14,15,15
43,lak101d.map,27,22,510,23,17,3,4,207,9,12,17,9,14,-5,19,20,20
44,lak101d.map,27,22,117,5,14,21,7,430,19,9,7,12,-14,-5,19,20,20
45,lak101d.map,27,22,163,7,12,19,9,404,18,13,8,8,-11,1,12,13,13
46,lak101d.map,27,22,104,4,5,22,16,575,26,18,0,3,-22,13,35,36,45
47,lak101d.map,27,22,104,4,5,22,16,226,10,15,16,6,-6,10,16,17,23
48,lak101d.map,27,22,136,6,17,20,4,362,16,11,10,10,-10,-6,16,17,17
49,lak101d.map,27,22,170,7,5,19,16,229,10,12,16,9,-3,7,10,11,11
50,lak101d.map,27,22,426,19,13,7,8,254,11,9,15,12,8,-4,12,13,13
51,lak101d.map,27,22,337,15,14,11,7,163,7,12,19,9,8,-2,10,11,11
52,lak101d.map,27,22,464,21,19,5,2,535,24,14,2,7,-3,-5,8,9,9
53,lak101d.map,27,22,406,18,11,8,10,207,9,12,17,9,9,1,10,11,11
54,lak101d.map,27,22,385,17,10,9,11,158,7,17,19,4,10,7,17,18,18
55,lak101d.map,27,22,153,6,0,20,21,553,25,18,1,3,-19,18,37,38,38
56,lak101d.map,27,22,337,15,14,11,7,251,11,12,15,9,4,-2,6,7,7
57,lak101d.map,27,22,145,6,8,20,13,363,16,10,10,11,-10,2,12,13,13
58,lak101d.map,27,22,96,4,13,22,8,90,4,19,22,2,0,6,6,7,7
59,lak101d.map,27,22,98,4,11,22,10,227,10,14,16,7,-6,3,9,10,10
60,lak101d.map,27,22,506,23,21,3,0,293,13,14,13,7,10,-7,17,18,26
61,lak101d.map,27,22,252,11,11,15,10,510,23,17,3,4,-12,6,18,19,19
62,lak101d.map,27,22,173,7,2,19,19,23,1,20,25,1,6,18,24,35,25
63,lak101d.map,27,22,515,23,12,3,9,92,4,17,22,4,19,5,24,25,25
64,lak101d.map,27,22,171,7,4,19,17,575,26,18,0,3,-19,14,33,34,34
65,lak101d.map,27,22,465,21,18,5,3,380,17,15,9,6,4,-3,7,8,8
66,lak101d.map,27,22,48,2,17,24,4,193,8,4,18,17,-6,-13,19,20,28
67,lak101d.map,27,22,248,11,15,15,6,274,12,11,14,10,-1,-4,5,6,6
68,lak101d.map,27,22,248,11,15,15,6,202,9,17,17,4,2,2,4,5,5
69,lak101d.map,27,22,273,12,12,14,9,70,3,17,23,4,9,5,14,15,15
70,lak101d.map,27,22,228,10,13,16,8,487,22,18,4,3,-12,5,17,18,18
71,lak101d.map,27,22,125,5,6,21,15,487,22,18,4,3,-17,12,29,30,30
72,lak101d.map,27,22,405,18,12,8,9,54,2,11,24,10,16,-1,17,18,18
73,lak101d.map,27,22,68,3,19,23,2,46,2,19,24,2,1,0,1,2,2
74,lak101d.map,27,22,360,16,13,10,8,492,22,13,4,8,-6,0,6,7,7
75,lak101d.map,27,22,293,13,14,13,7,510,23,17,3,4,-10,3,13,14,14
76,lak101d.map,27,22,145,6,8,20,13,427,19,12,7,9,-13,4,17,18,18
77,lak101d.map,27,22,464,21,19,5,2,208,9,11,17,10,12,-8,20,21,21
78,lak101d.map,27,22,402,18,15,8,6,115,5,16,21,5,13,1,14,15,15
79,lak101d.map,27,22,49,2,16,24,5,145,6,8,20,13,-4,-8,12,13,13
80,lak101d.map,27,22,201,9,18,17,3,126,5,5,21,16,4,-13,17,18,18
81,lak101d.map,27,22,408,18,9,8,12,90,4,19,22,2,14,10,24,25,25
82,lak101d.map,27,22,273,12,12,14,9,313,14,16,12,5,-2,4,6,7,7
83,lak101d.map,27,22,408,18,9,8,12,319,14,10,12,11,4,1,5,6,6
84,lak101d.map,27,22,44,2,21,24,0,383,17,12,9,9,-15,-9,24,25,25
85,lak101d.map,27,22,506,23,21,3,0,147,6,6,20,15,17,-15,32,33,46
86,lak101d.map,27,22,184,8,13,18,8,23,1,20,25,1,7,7,14,15,15
87,lak101d.map,27,22,142,6,11,20,10,319,14,10,12,11,-8,-1,9,10,10
88,lak101d.map,27,22,77,3,10,23,11,141,6,12,20,9,-3,2,5,6,6
89,lak101d.map,27,22,468,21,15,5,6,574,26,19,0,2,-5,4,9,10,10
90,lak101d.map,27,22,125,5,6,21,15,181,8,16,18,5,-3,10,13,14,14
91,lak101d.map,27,22,529,24,20,2,1,474,21,9,5,12,3,-11,14,15,15
92,lak101d.map,27,22,427,19,12,7,9,510,23,17,3,4,-4,5,9,10,10
93,lak101d.map,27,22,181,8,16,18,5,406,18,11,8,10,-10,-5,15,16,16
94,lak101d.map,27,22,26,1,17,25,4,230,10,11,16,10,-9,-6,15,16,16
95,lak101d.map,27,22,316,14,13,12,8,430,19,9,7,12,-5,-4,9,10,10
96,lak101d.map,27,22,210,9,9,17,12,514,23,13,3,8,-14,4,18,19,19
97,lak101d.map,27,22,552,25,19,1,2,162,7,13,19,8,18,-6,24,25,27
98,lak101d.map,27,22,401,18,16,8,5,173,7,2,19,19,11,-14,25,26,26
99,lak101d.map,27,22,297,13,10,13,11,245,11,18,15,3,2,8,10,11,11
0,lak102d.map,25,36,684,19,35,5,0,805,22,22,2,13,-3,-13,16,17,17
1,lak102d.map,25,36,706,19,13,5,22,579,16,32,8,3,3,19,22,24,23
2,lak102d.map,25,36,746,20,9,4,26,686,19,33,5,2,1,24,25,26,26
3,lak102d.map,25,36,337,9,22,15,13,60,1,11,23,24,8,-11,19,44,57
4,lak102d.map,25,36,674,18,9,6,26,501,13,2,11,33,5,-7,12,15,20
5,lak102d.map,25,36,312,8,11,16,24,722,20,33,4,2,-12,22,34,35,55
6,lak102d.map,25,36,736,20,19,4,16,399,11,32,13,3,9,13,22,23,25
7,lak102d.map,25,36,872,24,27,0,8,22,0,13,24,22,24,-14,38,62,43
8,lak102d.map,25,36,579,16,32,8,3,501,13,2,11,33,3,-30,33,168,59
9,lak102d.map,25,36,156,4,23,20,12,620,17,27,7,8,-13,4,17,39,74
10,lak102d.map,25,36,518,14,21,10,14,695,19,24,5,11,-5,3,8,9,9
11,lak102d.map,25,36,346,9,13,15,22,351,9,8,15,27,0,-5,5,6,6
12,lak102d.map,25,36,204,5,11,19,24,300,8,23,16,12,-3,12,15,48,38
13,lak102d.map,25,36,465,12,2,12,33,644,17,3,7,32,-5,1,6,7,7
14,lak102d.map,25,36,11,0,24,24,11,837,23,26,1,9,-23,2,25,62,120
15,lak102d.map,25,36,737,20,18,4,17,500,13,3,11,32,7,-15,22,41,23
16,lak102d.map,25,36,48,1,23,23,12,201,5,14,19,21,-4,-9,13,61,76
17,lak102d.map,25,36,610,16,1,8,34,477,13,26,11,9,3,25,28,61,120
18,lak102d.map,25,36,378,10,17,14,18,310,8,13,16,22,2,-4,6,7,7
19,lak102d.map,25,36,713,19,6,5,29,615,17,32,7,3,2,26,28,33,29
20,lak102d.map,25,36,472,13,31,11,4,415,11,16,13,19,2,-15,17,18,18
21,lak102d.map,25,36,98,2,9,22,26,637,17,10,7,25,-15,1,16,137,135
22,lak102d.map,25,36,9,0,26,24,9,94,2,13,22,22,-2,-13,15,74,94
23,lak102d.map,25,36,585,16,26,8,9,835,23,28,1,7,-7,2,9,10,10
24,lak102d.map,25,36,165,4,14,20,21,502,13,1,11,34,-9,-13,22,203,135
25,lak102d.map,25,36,192,5,23,19,12,513,14,26,10,9,-9,3,12,25,45
26,lak102d.map,25,36,449,12,18,12,17,387,10,8,14,27,2,-10,12,13,13
27,lak102d.map,25,36,673,18,10,6,25,347,9,12,15,23,9,2,11,77,105
28,lak102d.map,25,36,348,9,11,15,24,869,24,30,0,5,-15,19,34,35,43
29,lak102d.map,25,36,483,13,20,11,15,677,18,6,6,29,-5,-14,19,20,24
30,lak102d.map,25,36,338,9,21,15,14,428,11,3,13,32,-2,-18,20,206,62
31,lak102d.map,25,36,200,5,15,19,20,415,11,16,13,19,-6,1,7,10,8
32,lak102d.map,25,36,193,5,22,19,13,671,18,12,6,23,-13,-10,23,51,26
33,lak102d.map,25,36,99,2,8,22,27,403,11,28,13,7,-9,20,29,33,54
34,lak102d.map,25,36,690,19,29,5,6,86,2,21,22,14,17,-8,25,30,55
35,lak102d.map,25,36,272,7,15,17,20,758,21,33,3,2,-14,18,32,33,59
36,lak102d.map,25,36,755,20,0,4,35,775,21,16,3,19,-1,16,17,18,18
37,lak102d.map,25,36,368,10,27,14,8,205,5,10,19,25,5,-17,22,40,25
38,lak102d.map,25,36,786,21,5,3,30,123,3,20,21,15,18,15,33,38,72
39,lak102d.map,25,36,673,18,10,6,25,716,19,3,5,32,-1,-7,8,9,10
40,lak102d.map,25,36,635,17,12,7,23,381,10,14,14,21,7,2,9,60,92
41,lak102d.map,25,36,617,17,30,7,5,671,18,12,6,23,-1,-18,19,20,22
42,lak102d.map,25,36,776,21,15,3,20,405,11,26,13,9,10,11,21,22,32
43,lak102d.map,25,36,610,16,1,8,34,703,19,16,5,19,-3,15,18,19,34
44,lak102d.map,25,36,546,15,29,9,6,516,14,23,10,12,1,-6,7,8,8
45,lak102d.map,25,36,573,15,2,9,33,687,19,32,5,3,-4,30,34,35,108
46,lak102d.map,25,36,501,13,2,11,33,150,4,29,20,6,9,27,36,201,304
47,lak102d.map,25,36,205,5,10,19,25,661,18,22,6,13,-13,12,25,28,40
48,lak102d.map,25,36,619,17,28,7,7,718,19,1,5,34,-2,-27,29,30,40
49,lak102d.map,25,36,115,3,28,21,7,62,1,9,23,26,2,-19,21,81,100
50,lak102d.map,25,36,409,11,22,13,13,554,15,21,9,14,-4,-1,5,6,6
51,lak102d.map,25,36,9,0,26,24,9,364,10,31,14,4,-10,5,15,16,16
52,lak102d.map,25,36,657,18,26,6,9,117,3,26,21,9,15,0,15,88,44
53,lak102d.map,25,36,730,20,25,4,10,412,11,19,13,16,9,-6,15,16,16
54,lak102d.map,25,36,370,10,25,14,10,455,12,12,12,23,-2,-13,15,16,16
55,lak102d.map,25,36,666,18,17,6,18,455,12,12,12,23,6,-5,11,50,35
56,lak102d.map,25,36,704,19,15,5,20,517,14,22,10,13,5,7,12,13,13
57,lak102d.map,25,36,654,18,29,6,6,702,19,17,5,18,-1,-12,13,14,14
58,lak102d.map,25,36,168,4,11,20,24,371,10,24,14,11,-6,13,19,23,38
59,lak102d.map,25,36,840,23,23,1,12,831,23,32,1,3,0,9,9,10,10
60,lak102d.map,25,36,481,13,22,11,13,164,4,15,20,20,9,-7,16,33,20
61,lak102d.map,25,36,649,18,34,6,1,121,3,22,21,13,15,-12,27,29,28
62,lak102d.map,25,36,452,12,15,12,20,428,11,3,13,32,1,-12,13,204,117
63,lak102d.map,25,36,730,20,25,4,10,365,10,30,14,5,10,5,15,16,16
64,lak102d.map,25,36,672,18,11,6,24,803,22,24,2,11,-4,13,17,18,18
65,lak102d.map,25,36,368,10,27,14,8,370,10,25,14,10,0,-2,2,3,3
66,lak102d.map,25,36,128,3,15,21,20,790,21,1,3,34,-18,-14,32,145,139
67,lak102d.map,25,36,867,24,32,0,3,590,16,21,8,14,8,-11,19,20,20
68,lak102d.map,25,36,659,18,24,6,11,871,24,28,0,7,-6,4,10,11,11
69,lak102d.map,25,36,804,22,23,2,12,518,14,21,10,14,8,-2,10,11,11
70,lak102d.map,25,36,692,19,27,5,8,574,15,1,9,34,4,-26,30,84,31
71,lak102d.map,25,36,728,20,27,4,8,406,11,25,13,10,9,-2,11,12,12
72,lak102d.map,25,36,545,15,30,9,5,715,19,4,5,31,-4,-26,30,31,35
73,lak102d.map,25,36,873,24,26,0,9,12,0,23,24,12,24,-3,27,104,59
74,lak102d.map,25,36,401,11,30,13,5,406,11,25,13,10,0,-5,5,6,6
75,lak102d.map,25,36,21,0,14,24,21,439,12,28,12,7,-12,14,26,31,51
76,lak102d.map,25,36,614,17,33,7,2,510,14,29,10,6,3,-4,7,8,8
77,lak102d.map,25,36,374,10,21,14,14,774,21,17,3,18,-11,-4,15,25,16
78,lak102d.map,25,36,589,16,22,8,13,375,10,20,14,15,6,-2,8,9,9
79,lak102d.map,25,36,627,17,20,7,15,724,20,31,4,4,-3,11,14,15,15
80,lak102d.map,25,36,840,23,23,1,12,545,15,30,9,5,8,7,15,16,16
81,lak102d.map,25,36,96,2,11,22,24,709,19,10,5,25,-17,-1,18,134,130
82,lak102d.map,25,36,398,11,33,13,2,670,18,13,6,22,-7,-20,27,42,29
83,lak102d.map,25,36,155,4,24,20,11,171,4,8,20,27,0,-16,16,68,95
84,lak102d.map,25,36,96,2,11,22,24,401,11,30,13,5,-9,19,28,32,82
85,lak102d.map,25,36,123,3,20,21,15,548,15,27,9,8,-12,7,19,34,21
86,lak102d.map,25,36,444,12,23,12,12,669,18,14,6,21,-6,-9,15,22,16
87,lak102d.map,25,36,290,8,33,16,2,805,22,22,2,13,-14,-11,25,26,30
88,lak102d.map,25,36,475,13,28,11,7,878,24,21,0,14,-11,-7,18,19,19
89,lak102d.map,25,36,418,11,13,13,22,86,2,21,22,14,9,8,17,45,20
90,lak102d.map,25,36,192,5,23,19,12,682,18,1,6,34,-13,-22,35,92,69
91,lak102d.map,25,36,777,21,14,3,21,770,21,21,3,14,0,7,7,8,8
92,lak102d.map,25,36,44,1,27,23,8,421,11,10,13,25,-10,-17,27,30,85
93,lak102d.map,25,36,475,13,28,11,7,651,18,32,6,3,-5,4,9,10,10
94,lak102d.map,25,36,254,7,33,17,2,63,1,8,23,27,6,-25,31,108,111
95,lak102d.map,25,36,392,10,3,14,32,330,9,29,15,6,1,26,27,74,318
96,lak102d.map,25,36,150,4,29,20,6,311,8,12,16,23,-4,-17,21,69,97
97,lak102d.map,25,36,635,17,12,7,23,707,19,12,5,23,-2,0,2,3,3
98,lak102d.map,25,36,330,9,29,15,6,346,9,13,15,22,0,-16,16,23,24
99,lak102d.map,25,36,80,2,27,22,8,327,9,32,15,3,-7,5,12,13,13
0,lak103d.map,47,49,1083,22,43,24,5,1582,32,34,14,14,-10,-9,19,20,20
1,lak103d.map,47,49,1546,31,21,15,27,2295,46,7,0,41,-15,-14,29,132,116
2,lak103d.map,47,49,1496,30,22,16,26,755,15,28,31,20,15,6,21,122,75
3,lak103d.map,47,49,2057,41,0,5,48,2237,45,16,1,32,-4,16,20,22,21
4,lak103d.map,47,49,1084,22,42,24,6,2055,41,2,5,46,-19,-40,59,68,97
5,lak103d.map,47,49,1386,28,34,18,14,1726,35,37,11,11,-7,3,10,11,11
6,lak103d.map,47,49,2280,46,22,0,26,649,13,36,33,12,33,14,47,205,633
7,lak103d.map,47,49,705,14,29,32,19,844,17,37,29,11,-3,8,11,12,12
8,lak103d.map,47,49,2105,42,1,4,47,1794,36,18,10,30,6,17,23,32,24
9,lak103d.map,47,49,163,3,32,43,16,2220,45,33,1,15,-42,1,43,703,527
10,lak103d.map,47,49,1688,34,26,12,22,1618,33,47,13,1,1,21,22,69,28
11,lak103d.map,47,49,2217,45,36,1,12,749,15,34,31,14,30,-2,32,200,706
12,lak103d.map,47,49,2170,44,34,2,14,702,14,32,32,16,30,-2,32,367,703
13,lak103d.map,47,49,1713,34,1,12,47,1406,28,14,18,34,6,13,19,80,64
14,lak103d.map,47,49,2185,44,19,2,29,1901,38,9,8,39,6,-10,16,70,91
15,lak103d.map,47,49,1682,34,32,12,16,1749,35,14,11,34,-1,-18,19,20,20
16,lak103d.map,47,49,654,13,31,33,17,1959,39,0,7,48,-26,-31,57,118,301
17,lak103d.map,47,49,1334,27,37,19,11,1527,31,40,15,8,-4,3,7,8,8
18,lak103d.map,47,49,202,4,42,42,6,1546,31,21,15,27,-27,-21,48,217,359
19,lak103d.map,47,49,994,20,34,26,14,1573,32,43,14,5,-12,9,21,46,25
20,lak103d.map,47,49,1089,22,37,24,11,1502,30,16,16,32,-8,-21,29,30,37
21,lak103d.map,47,49,2298,46,4,0,44,1291,26,31,20,17,20,27,47,156,210
22,lak103d.map,47,49,1786,36,26,10,22,1586,32,30,14,18,4,4,8,9,9
23,lak103d.map,47,49,2186,44,18,2,30,115,2,31,44,17,42,13,55,500,684
24,lak103d.map,47,49,58,1,39,45,9,1446,29,23,17,25,-28,-16,44,203,255
25,lak103d.map,47,49,1611,32,5,14,43,399,8,41,38,7,24,36,60,640,605
26,lak103d.map,47,49,2176,44,28,2,20,1290,26,32,20,16,18,4,22,178,589
27,lak103d.map,47,49,2264,46,38,0,10,1135,23,40,23,8,23,2,25,199,699
28,lak103d.map,47,49,2152,43,3,3,45,1692,34,22,12,26,9,19,28,35,31
29,lak103d.map,47,49,1794,36,18,10,30,842,17,39,29,9,19,21,40,45,60
30,lak103d.map,47,49,58,1,39,45,9,156,3,39,43,9,-2,0,2,3,3
31,lak103d.map,47,49,1528,31,39,15,9,2296,46,6,0,42,-15,-33,48,227,188
32,lak103d.map,47,49,64,1,33,45,15,1527,31,40,15,8,-30,7,37,158,234
33,lak103d.map,47,49,1000,20,28,26,20,12,0,36,46,12,20,8,28,29,29
34,lak103d.map,47,49,1353,27,18,19,30,2275,46,27,0,21,-19,9,28,375,166
35,lak103d.map,47,49,2196,44,8,2,40,2183,44,21,2,27,0,13,13,14,14
36,lak103d.map,47,49,753,15,30,31,18,2219,45,34,1,14,-30,4,34,704,419
37,lak103d.map,47,49,1731,35,32,11,16,1523,31,44,15,4,4,12,16,17,17
38,lak103d.map,47,49,1243,25,30,21,18,2103,42,3,4,45,-17,-27,44,53,71
39,lak103d.map,47,49,659,13,26,33,22,991,20,37,26,11,-7,11,18,19,19
40,lak103d.map,47,49,360,7,31,39,17,1393,28,27,18,21,-21,-4,25,112,106
41,lak103d.map,47,49,168,3,27,43,21,1871,38,39,8,9,-35,12,47,104,48
42,lak103d.map,47,49,1859,37,2,9,46,1083,22,43,24,5,15,41,56,99,305
43,lak103d.map,47,49,1730,35,33,11,15,1599,32,17,14,31,3,-16,19,20,20
44,lak103d.map,47,49,797,16,35,30,13,1631,33,34,13,14,-17,-1,18,19,19
45,lak103d.map,47,49,1697,34,17,12,31,164,3,31,43,17,31,14,45,267,151
46,lak103d.map,47,49,264,5,29,41,19,1292,26,30,20,18,-21,1,22,97,44
47,lak103d.map,47,49,395,8,45,38,3,1255,25,18,21,30,-17,-27,44,228,386
48,lak103d.map,47,49,1948,39,11,7,37,756,15,27,31,21,24,16,40,241,103
49,lak103d.map,47,49,560,11,27,35,21,364,7,27,39,21,4,0,4,7,7
50,lak103d.map,47,49,700,14,34,32,14,1638,33,27,13,21,-19,-7,26,72,27
51,lak103d.map,47,49,2176,44,28,2,20,1740,35,23,11,25,9,-5,14,143,367
52,lak103d.map,47,49,65,1,32,45,16,2295,46,7,0,41,-45,-25,70,495,527
53,lak103d.map,47,49,158,3,37,43,11,1599,32,17,14,31,-29,-20,49,191,379
54,lak103d.map,47,49,1872,38,38,8,10,1860,37,1,9,47,1,-37,38,64,88
55,lak103d.map,47,49,1602,32,14,14,34,1951,39,8,7,40,-7,-6,13,16,28
56,lak103d.map,47,49,805,16,27,30,21,1662,33,3,13,45,-17,-24,41,388,310
57,lak103d.map,47,49,1969,40,39,6,9,414,8,26,38,22,32,-13,45,46,59
58,lak103d.map,47,49,201,4,43,42,5,2293,46,9,0,39,-42,-34,76,599,685
59,lak103d.map,47,49,2272,46,30,0,18,989,20,39,26,9,26,9,35,201,649
60,lak103d.map,47,49,2177,44,27,2,21,805,16,27,30,21,28,0,28,439,686
61,lak103d.map,47,49,1553,31,14,15,34,361,7,30,39,18,24,16,40,204,126
62,lak103d.map,47,49,115,2,31,44,17,1455,29,14,17,34,-27,-17,44,151,191
63,lak103d.map,47,49,394,8,46,38,2,300,6,42,40,6,2,-4,6,7,7
64,lak103d.map,47,49,1186,24,38,22,10,1580,32,36,14,12,-8,-2,10,11,11
65,lak103d.map,47,49,1969,40,39,6,9,2251,45,2,1,46,-5,-37,42,60,223
66,lak103d.map,47,49,2004,40,4,6,44,349,7,42,39,6,33,38,71,628,242
67,lak103d.map,47,49,2176,44,28,2,20,396,8,44,38,4,36,16,52,736,697
68,lak103d.map,47,49,56,1,41,45,7,60,1,37,45,11,0,-4,4,5,5
69,lak103d.map,47,49,1897,38,13,8,35,1782,36,30,10,18,2,17,19,24,23
70,lak103d.map,47,49,256,5,37,41,11,295,6,47,40,1,-1,10,11,12,12
71,lak103d.map,47,49,1472,30,46,16,2,751,15,32,31,16,15,-14,29,36,63
72,lak103d.map,47,49,1337,27,34,19,14,410,8,30,38,18,19,-4,23,65,31
73,lak103d.map,47,49,1737,35,26,11,22,1582,32,34,14,14,3,8,11,12,12
74,lak103d.map,47,49,2290,46,12,0,36,2215,45,38,1,10,1,26,27,28,28
75,lak103d.map,47,49,1390,28,30,18,18,647,13,38,33,10,15,8,23,24,39
76,lak103d.map,47,49,208,4,36,42,12,2171,44,33,2,15,-40,-3,43,702,620
77,lak103d.map,47,49,1089,22,37,24,11,1422,29,47,17,1,-7,10,17,41,21
78,lak103d.map,47,49,1595,32,21,14,27,2239,45,14,1,34,-13,-7,20,208,130
79,lak103d.map,47,49,1386,28,34,18,14,1675,34,39,12,9,-6,5,11,12,12
80,lak103d.map,47,49,1569,32,47,14,1,300,6,42,40,6,26,-5,31,316,182
81,lak103d.map,47,49,1900,38,10,8,38,2220,45,33,1,15,-7,23,30,189,120
82,lak103d.map,47,49,260,5,33,41,15,311,6,31,40,17,-1,-2,3,4,4
83,lak103d.map,47,49,154,3,41,43,7,306,6,36,40,12,-3,-5,8,9,9
84,lak103d.map,47,49,112,2,34,44,14,1406,28,14,18,34,-26,-20,46,170,237
85,lak103d.map,47,49,1616,32,0,14,48,2225,45,28,1,20,-13,28,41,78,42
86,lak103d.map,47,49,1944,39,15,7,33,306,6,36,40,12,33,21,54,430,180
87,lak103d.map,47,49,257,5,36,41,12,299,6,43,40,5,-1,7,8,9,9
88,lak103d.map,47,49,304,6,38,40,10,1343,27,28,19,20,-21,-10,31,168,239
89,lak103d.map,47,49,1401,28,19,18,29,1391,28,29,18,19,0,10,10,11,11
90,lak103d.map,47,49,117,2,29,44,19,1726,35,37,11,11,-33,8,41,88,42
91,lak103d.map,47,49,2216,45,37,1,11,1502,30,16,16,32,15,-21,36,160,457
92,lak103d.map,47,49,1694,34,20,12,28,1350,27,21,19,27,7,1,8,9,9
93,lak103d.map,47,49,1246,25,27,21,21,895,18,35,28,13,7,8,15,16,16
94,lak103d.map,47,49,2216,45,37,1,11,111,2,35,44,13,43,-2,45,606,707
95,lak103d.map,47,49,1613,32,3,14,45,2197,44,7,2,41,-12,4,16,35,17
96,lak103d.map,47,49,1626,33,39,13,9,350,7,41,39,7,26,2,28,345,152
97,lak103d.map,47,49,299,6,43,40,5,1349,27,22,19,26,-21,-21,42,205,298
98,lak103d.map,47,49,1083,22,43,24,5,1406,28,14,18,34,-6,-29,35,36,43
99,lak103d.map,47,49,116,2,30,44,18,703,14,31,32,17,-12,1,13,25,18
0,lak104d.map,37,38,1186,31,29,5,8,1269,33,22,3,15,-2,-7,9,10,10
1,lak104d.map,37,38,994,26,31,10,6,959,25,28,11,9,1,-3,4,5,5
2,lak104d.map,37,38,1042,27,21,9,16,614,16,31,20,6,11,10,21,22,47
3,lak104d.map,37,38,665,17,18,19,19,422,11,33,25,4,6,15,21,22,22
4,lak104d.map,37,38,457,12,36,24,1,588,15,19,21,18,-3,-17,20,21,21
5,lak104d.map,37,38,274,7,29,29,8,1394,36,11,0,26,-29,-18,47,54,51
6,lak104d.map,37,38,1203,31,12,5,25,788,20,9,16,28,11,-3,14,15,15
7,lak104d.map,37,38,544,14,25,22,12,115,3,36,33,1,11,11,22,23,23
8,lak104d.map,37,38,740,19,19,17,18,365,9,14,27,23,10,-5,15,16,16
9,lak104d.map,37,38,1096,28,5,8,32,498,13,33,23,4,15,28,43,53,44
10,lak104d.map,37,38,624,16,21,20,16,1147,30,30,6,7,-14,9,23,38,24
11,lak104d.map,37,38,361,9,18,27,19,244,6,21,30,16,3,3,6,7,7
12,lak104d.map,37,38,208,5,19,31,18,305,8,36,28,1,-3,17,20,21,21
13,lak104d.map,37,38,117,3,34,33,3,535,14,34,22,3,-11,0,11,12,12
14,lak104d.map,37,38,611,16,34,20,3,1319,34,10,2,27,-18,-24,42,43,47
15,lak104d.map,37,38,736,19,23,17,14,682,17,1,19,36,2,-22,24,25,25
16,lak104d.map,37,38,1226,32,27,4,10,307,8,34,28,3,24,7,31,32,32
17,lak104d.map,37,38,1091,28,10,8,27,660,17,23,19,14,11,13,24,25,25
18,lak104d.map,37,38,867,22,6,14,31,126,3,25,33,12,19,19,38,47,45
19,lak104d.map,37,38,809,21,26,15,11,395,10,22,26,15,11,-4,15,16,16
20,lak104d.map,37,38,979,25,8,11,29,655,17,28,19,9,8,20,28,29,29
21,lak104d.map,37,38,1312,34,17,2,20,246,6,19,30,18,28,2,30,128,175
22,lak104d.map,37,38,808,21,27,15,10,921,24,28,12,9,-3,1,4,5,5
23,lak104d.map,37,38,515,13,16,23,21,1118,29,21,7,16,-16,5,21,158,91
24,lak104d.map,37,38,979,25,8,11,29,773,20,24,16,13,5,16,21,45,24
25,lak104d.map,37,38,1064,28,37,8,0,1394,36,11,0,26,-8,-26,34,35,66
26,lak104d.map,37,38,1120,29,19,7,18,774,20,23,16,14,9,4,13,62,48
27,lak104d.map,37,38,1014,26,11,10,26,1286,33,5,3,32,-7,-6,13,14,14
28,lak104d.map,37,38,1134,29,5,7,32,199,5,28,31,9,24,23,47,57,54
29,lak104d.map,37,38,504,13,27,23,10,153,4,36,32,1,9,9,18,19,31
30,lak104d.map,37,38,681,17,2,19,35,1282,33,9,3,28,-16,7,23,24,24
31,lak104d.map,37,38,320,8,21,28,16,432,11,23,25,14,-3,2,5,6,6
32,lak104d.map,37,38,1154,30,23,6,14,636,16,9,20,28,14,-14,28,103,184
33,lak104d.map,37,38,700,18,21,18,16,14,0,23,36,14,18,2,20,21,21
34,lak104d.map,37,38,208,5,19,31,18,627,16,18,20,19,-11,-1,12,13,13
35,lak104d.map,37,38,1261,33,30,3,7,1191,31,24,5,13,2,-6,8,9,9
36,lak104d.map,37,38,777,20,20,16,17,1107,29,32,7,5,-9,12,21,24,22
37,lak104d.map,37,38,156,4,33,32,4,1165,30,12,6,25,-26,-21,47,54,50
38,lak104d.map,37,38,50,1,25,35,12,515,13,16,23,21,-12,-9,21,22,22
39,lak104d.map,37,38,470,12,23,24,14,1222,32,31,4,6,-20,8,28,62,29
40,lak104d.map,37,38,81,2,32,34,5,886,23,25,13,12,-21,-7,28,72,29
41,lak104d.map,37,38,1378,36,27,0,10,659,17,24,19,13,19,-3,22,23,23
42,lak104d.map,37,38,705,18,16,18,21,155,4,34,32,3,14,18,32,33,33
43,lak104d.map,37,38,721,18,0,18,37,1316,34,13,2,24,-16,13,29,34,30
44,lak104d.map,37,38,547,14,22,22,15,1092,28,9,8,28,-14,-13,27,28,33
45,lak104d.map,37,38,508,13,23,23,14,198,5,29,31,8,8,6,14,15,15
46,lak104d.map,37,38,210,5,17,31,20,198,5,29,31,8,0,12,12,13,13
47,lak104d.map,37,38,620,16,25,20,12,1271,33,20,3,17,-17,-5,22,57,64
48,lak104d.map,37,38,496,13,35,23,2,205,5,22,31,15,8,-13,21,22,22
49,lak104d.map,37,38,1264,33,27,3,10,1095,28,6,8,31,5,-21,26,82,27
50,lak104d.map,37,38,741,19,18,17,19,941,24,8,12,29,-5,-10,15,16,16
51,lak104d.map,37,38,280,7,23,29,14,1267,33,24,3,13,-26,1,27,74,61
52,lak104d.map,37,38,1166,30,11,6,26,206,5,21,31,16,25,10,35,39,42
53,lak104d.map,37,38,509,13,22,23,15,1359,35,8,1,29,-22,-14,36,37,43
54,lak104d.map,37,38,1045,27,18,9,19,1173,30,4,6,33,-3,-14,17,41,95
55,lak104d.map,37,38,1132,29,7,7,30,159,4,30,32,7,25,23,48,56,55
56,lak104d.map,37,38,6,0,31,36,6,671,17,12,19,25,-17,-19,36,43,39
57,lak104d.map,37,38,272,7,31,29,6,398,10,19,26,18,-3,-12,15,16,16
58,lak104d.map,37,38,432,11,23,25,14,276,7,27,29,10,4,4,8,9,9
59,lak104d.map,37,38,657,17,26,19,11,1226,32,27,4,10,-15,1,16,17,17
60,lak104d.map,37,38,1147,30,30,6,7,1231,32,22,4,15,-2,-8,10,11,11
61,lak104d.map,37,38,1078,28,23,8,14,1271,33,20,3,17,-5,-3,8,9,9
62,lak104d.map,37,38,753,19,6,17,31,94,2,19,34,18,17,13,30,39,37
63,lak104d.map,37,38,659,17,24,19,13,1205,31,10,5,27,-14,-14,28,29,29
64,lak104d.map,37,38,792,20,5,16,32,1059,27,4,9,33,-7,-1,8,9,9
65,lak104d.map,37,38,731,19,28,17,9,44,1,31,35,6,18,3,21,22,36
66,lak104d.map,37,38,243,6,22,30,15,1039,27,24,9,13,-21,2,23,88,42
67,lak104d.map,37,38,1013,26,12,10,25,886,23,25,13,12,3,13,16,70,100
68,lak104d.map,37,38,923,24,26,12,11,1207,31,8,5,29,-7,-18,25,100,92
69,lak104d.map,37,38,1008,26,17,10,20,6,0,31,36,6,26,14,40,41,256
70,lak104d.map,37,38,673,17,10,19,27,997,26,28,10,9,-9,18,27,32,28
71,lak104d.map,37,38,546,14,23,22,14,211,5,16,31,21,9,-7,16,17,17
72,lak104d.map,37,38,826,21,9,15,28,1204,31,11,5,26,-10,2,12,13,13
73,lak104d.map,37,38,1107,29,32,7,5,399,10,18,26,19,19,-14,33,34,80
74,lak104d.map,37,38,698,18,23,18,14,165,4,24,32,13,14,1,15,16,16
75,lak104d.map,37,38,116,3,35,33,2,271,7,32,29,5,-4,-3,7,8,8
76,lak104d.map,37,38,736,19,23,17,14,905,23,6,13,31,-4,-17,21,22,22
77,lak104d.map,37,38,94,2,19,34,18,1079,28,22,8,15,-26,3,29,209,81
78,lak104d.map,37,38,1242,32,11,4,26,1116,29,23,7,14,3,12,15,29,36
79,lak104d.map,37,38,861,22,12,14,25,1359,35,8,1,29,-13,-4,17,18,18
80,lak104d.map,37,38,1105,29,34,7,3,981,25,6,11,31,4,-28,32,166,124
81,lak104d.map,37,38,1203,31,12,5,25,998,26,27,10,10,5,15,20,45,97
82,lak104d.map,37,38,656,17,27,19,10,1352,35,15,1,22,-18,-12,30,74,31
83,lak104d.map,37,38,157,4,32,32,5,159,4,30,32,7,0,-2,2,3,3
84,lak104d.map,37,38,699,18,22,18,15,511,13,20,23,17,5,-2,7,8,8
85,lak104d.map,37,38,648,17,35,19,2,126,3,25,33,12,14,-10,24,25,25
86,lak104d.map,37,38,905,23,6,13,31,546,14,23,22,14,9,17,26,35,27
87,lak104d.map,37,38,361,9,18,27,19,586,15,21,21,16,-6,3,9,10,10
88,lak104d.map,37,38,1165,30,12,6,25,1102,29,37,7,0,1,25,26,47,119
89,lak104d.map,37,38,200,5,27,31,10,203,5,24,31,13,0,-3,3,4,4
90,lak104d.map,37,38,308,8,33,28,4,591,15,16,21,21,-7,-17,24,25,55
91,lak104d.map,37,38,1392,36,13,0,24,553,14,16,22,21,22,3,25,47,35
92,lak104d.map,37,38,620,16,25,20,12,357,9,22,27,15,7,-3,10,11,11
93,lak104d.map,37,38,1282,33,9,3,28,500,13,31,23,6,20,22,42,48,43
94,lak104d.map,37,38,117,3,34,33,3,663,17,20,19,17,-14,-14,28,29,29
95,lak104d.map,37,38,1176,30,1,6,36,458,12,35,24,2,18,34,52,62,65
96,lak104d.map,37,38,1379,36,26,0,11,468,12,25,24,12,24,-1,25,26,26
97,lak104d.map,37,38,688,18,33,18,4,779,20,18,16,19,-2,-15,17,18,18
98,lak104d.map,37,38,386,10,31,26,6,787,20,10,16,27,-10,-21,31,34,46
99,lak104d.map,37,38,1229,32,24,4,13,1327,34,2,2,35,-2,-22,24,25,37
0,lak105d.map,25,28,534,19,25,5,2,519,18,12,6,15,1,-13,14,67,117
1,lak105d.map,25,28,219,7,4,17,23,342,12,21,12,6,-5,17,22,46,67
2,lak105d.map,25,28,619,22,24,2,3,262,9,17,15,10,13,-7,20,23,21
3,lak105d.map,25,28,568,20,19,4,8,281,10,26,14,1,10,7,17,21,18
4,lak105d.map,25,28,276,9,3,15,24,4,0,23,24,4,9,20,29,196,138
5,lak105d.map,25,28,560,20,27,4,0,253,9,26,15,1,11,-1,12,13,13
6,lak105d.map,25,28,338,12,25,12,2,556,19,3,5,24,-7,-22,29,30,51
7,lak105d.map,25,28,416,14,3,10,24,158,5,9,19,18,9,6,15,16,16
8,lak105d.map,25,28,505,18,26,6,1,526,18,5,6,22,0,-21,21,76,151
9,lak105d.map,25,28,477,17,26,7,1,439,15,8,9,19,2,-18,20,76,98
10,lak105d.map,25,28,652,23,19,1,8,4,0,23,24,4,23,4,27,71,30
11,lak105d.map,25,28,123,4,16,20,11,310,11,25,13,2,-7,9,16,17,34
12,lak105d.map,25,28,268,9,11,15,16,238,8,13,16,14,1,2,3,4,4
13,lak105d.map,25,28,337,12,26,12,1,94,3,17,21,10,9,-9,18,47,21
14,lak105d.map,25,28,477,17,26,7,1,239,8,12,16,15,9,-14,23,33,24
15,lak105d.map,25,28,260,9,19,15,8,524,18,7,6,20,-9,-12,21,29,24
16,lak105d.map,25,28,304,10,3,14,24,168,6,27,18,0,4,24,28,179,146
17,lak105d.map,25,28,1,0,26,24,1,92,3,19,21,8,-3,-7,10,64,73
18,lak105d.map,25,28,204,7,19,17,8,541,19,18,5,9,-12,-1,13,14,14
19,lak105d.map,25,28,364,13,27,11,0,573,20,14,4,13,-7,-13,20,61,58
20,lak105d.map,25,28,616,22,27,2,0,93,3,18,21,9,19,-9,28,65,31
21,lak105d.map,25,28,113,4,26,20,1,255,9,24,15,3,-5,-2,7,8,8
22,lak105d.map,25,28,466,16,9,8,18,386,13,5,11,22,3,-4,7,8,8
23,lak105d.map,25,28,365,13,26,11,1,37,1,18,23,9,12,-8,20,57,27
24,lak105d.map,25,28,112,4,27,20,0,76,2,7,22,20,2,-20,22,81,143
25,lak105d.map,25,28,681,24,18,0,9,196,7,27,17,0,17,9,26,41,27
26,lak105d.map,25,28,372,13,19,11,8,37,1,18,23,9,12,-1,13,14,14
27,lak105d.map,25,28,370,13,21,11,6,188,6,7,18,20,7,-14,21,22,22
28,lak105d.map,25,28,264,9,15,15,12,28,1,27,23,0,8,12,20,85,63
29,lak105d.map,25,28,304,10,3,14,24,634,22,9,2,18,-12,6,18,23,19
30,lak105d.map,25,28,449,16,26,8,1,618,22,25,2,2,-6,-1,7,8,8
31,lak105d.map,25,28,522,18,9,6,18,277,9,2,15,25,9,-7,16,17,21
32,lak105d.map,25,28,560,20,27,4,0,645,23,26,1,1,-3,-1,4,5,5
33,lak105d.map,25,28,395,14,24,10,3,270,9,9,15,18,5,-15,20,23,21
34,lak105d.map,25,28,372,13,19,11,8,103,3,8,21,19,10,-11,21,22,22
35,lak105d.map,25,28,620,22,23,2,4,358,12,5,12,22,10,-18,28,139,190
36,lak105d.map,25,28,371,13,20,11,7,230,8,21,16,6,5,1,6,7,7
37,lak105d.map,25,28,501,17,2,7,25,230,8,21,16,6,9,19,28,81,103
38,lak105d.map,25,28,536,19,23,5,4,561,20,26,4,1,-1,3,4,5,5
39,lak105d.map,25,28,163,5,4,19,23,564,20,23,4,4,-15,19,34,227,45
40,lak105d.map,25,28,241,8,10,16,17,548,19,11,5,16,-11,1,12,41,58
41,lak105d.map,25,28,536,19,23,5,4,476,17,27,7,0,2,4,6,7,7
42,lak105d.map,25,28,499,17,4,7,23,583,20,4,4,23,-3,0,3,4,4
43,lak105d.map,25,28,160,5,7,19,20,29,1,26,23,1,4,19,23,145,74
44,lak105d.map,25,28,282,10,25,14,2,102,3,9,21,18,7,-16,23,54,96
45,lak105d.map,25,28,2,0,25,24,2,364,13,27,11,0,-13,2,15,16,16
46,lak105d.map,25,28,1,0,26,24,1,422,15,25,9,2,-15,-1,16,17,17
47,lak105d.map,25,28,259,9,20,15,7,143,5,24,19,3,4,4,8,26,24
48,lak105d.map,25,28,99,3,12,21,15,540,19,19,5,8,-16,7,23,24,24
49,lak105d.map,25,28,113,4,26,20,1,451,16,24,8,3,-12,-2,14,15,15
50,lak105d.map,25,28,211,7,12,17,15,188,6,7,18,20,1,-5,6,7,7
51,lak105d.map,25,28,371,13,20,11,7,310,11,25,13,2,2,5,7,8,8
52,lak105d.map,25,28,282,10,25,14,2,308,11,27,13,0,-1,2,3,4,4
53,lak105d.map,25,28,627,22,16,2,11,485,17,18,7,9,5,2,7,8,8
54,lak105d.map,25,28,310,11,25,13,2,423,15,24,9,3,-4,-1,5,6,6
55,lak105d.map,25,28,128,4,11,20,16,238,8,13,16,14,-4,2,6,7,7
56,lak105d.map,25,28,466,16,9,8,18,563,20,24,4,3,-4,15,19,128,60
57,lak105d.map,25,28,258,9,21,15,6,492,17,11,7,16,-8,-10,18,23,19
58,lak105d.map,25,28,157,5,10,19,17,182,6,13,18,14,-1,3,4,5,5
59,lak105d.map,25,28,536,19,23,5,4,35,1,20,23,7,18,-3,21,59,56
60,lak105d.map,25,28,121,4,18,20,9,358,12,5,12,22,-8,-13,21,95,28
61,lak105d.map,25,28,549,19,10,5,17,366,13,25,11,2,6,15,21,60,48
62,lak105d.map,25,28,515,18,16,6,11,403,14,16,10,11,4,0,4,5,5
63,lak105d.map,25,28,122,4,17,20,10,420,15,27,9,0,-11,10,21,22,53
64,lak105d.map,25,28,627,22,16,2,11,195,6,0,18,27,16,-16,32,89,37
65,lak105d.map,25,28,395,14,24,10,3,461,16,14,8,13,-2,-10,12,30,40
66,lak105d.map,25,28,472,16,3,8,24,589,21,26,3,1,-5,23,28,176,132
67,lak105d.map,25,28,34,1,21,23,6,91,3,20,21,7,-2,-1,3,4,4
68,lak105d.map,25,28,513,18,18,6,9,254,9,25,15,2,9,7,16,25,17
69,lak105d.map,25,28,65,2,18,22,9,258,9,21,15,6,-7,3,10,15,11
70,lak105d.map,25,28,292,10,15,14,12,422,15,25,9,2,-5,10,15,16,18
71,lak105d.map,25,28,384,13,7,11,20,506,18,25,6,2,-5,18,23,125,104
72,lak105d.map,25,28,288,10,19,14,8,563,20,24,4,3,-10,5,15,16,17
73,lak105d.map,25,28,35,1,20,23,7,630,22,13,2,14,-21,-7,28,50,29
74,lak105d.map,25,28,489,17,14,7,13,106,3,5,21,22,14,-9,23,38,71
75,lak105d.map,25,28,515,18,16,6,11,596,21,19,3,8,-3,3,6,7,7
76,lak105d.map,25,28,445,15,2,9,25,270,9,9,15,18,6,7,13,65,25
77,lak105d.map,25,28,570,20,17,4,10,151,5,16,19,11,15,-1,16,17,17
78,lak105d.map,25,28,569,20,18,4,9,210,7,13,17,14,13,-5,18,19,19
79,lak105d.map,25,28,477,17,26,7,1,199,7,24,17,3,10,-2,12,13,13
80,lak105d.map,25,28,186,6,9,18,18,403,14,16,10,11,-8,7,15,16,16
81,lak105d.map,25,28,512,18,19,6,8,213,7,10,17,17,11,-9,20,21,21
82,lak105d.map,25,28,554,19,5,5,22,94,3,17,21,10,16,12,28,31,90
83,lak105d.map,25,28,57,2,26,22,1,241,8,10,16,17,-6,-16,22,67,123
84,lak105d.map,25,28,619,22,24,2,3,38,1,17,23,10,21,-7,28,45,35
85,lak105d.map,25,28,433,15,14,9,13,29,1,26,23,1,14,12,26,83,33
86,lak105d.map,25,28,609,21,6,3,21,417,14,2,10,25,7,-4,11,12,14
87,lak105d.map,25,28,376,13,15,11,12,413,14,6,10,21,-1,-9,10,18,19
88,lak105d.map,25,28,250,8,1,16,26,29,1,26,23,1,7,25,32,178,133
89,lak105d.map,25,28,489,17,14,7,13,292,10,15,14,12,7,1,8,9,9
90,lak105d.map,25,28,91,3,20,21,7,525,18,6,6,21,-15,-14,29,87,32
91,lak105d.map,25,28,393,14,26,10,1,101,3,10,21,17,11,-16,27,56,30
92,lak105d.map,25,28,576,20,11,4,16,93,3,18,21,9,17,7,24,25,53
93,lak105d.map,25,28,480,17,23,7,4,58,2,25,22,2,15,2,17,18,25
94,lak105d.map,25,28,149,5,18,19,9,271,9,8,15,19,-4,-10,14,15,15
95,lak105d.map,25,28,528,18,3,6,24,411,14,8,10,19,4,5,9,10,10
96,lak105d.map,25,28,56,2,27,22,0,390,13,1,11,26,-11,-26,37,150,215
97,lak105d.map,25,28,402,14,17,10,10,290,10,17,14,10,4,0,4,5,5
98,lak105d.map,25,28,545,19,14,5,13,220,7,3,17,24,12,-11,23,27,28
99,lak105d.map,25,28,214,7,9,17,18,630,22,13,2,14,-15,4,19,47,49
0,lak106d.map,76,60,514,8,25,67,34,3038,50,21,25,38,-42,-4,46,47,47
1,lak106d.map,76,60,753,12,26,63,33,3642,60,17,15,42,-48,-9,57,58,58
2,lak106d.map,76,60,3818,63,21,12,38,695,11,24,64,35,52,3,55,56,56
3,lak106d.map,76,60,2315,38,24,37,35,3399,56,20,19,39,-18,-4,22,23,23
4,lak106d.map,76,60,3169,52,10,23,49,4181,69,18,6,41,-17,8,25,26,26
5,lak106d.map,76,60,2987,49,12,26,47,516,8,23,67,36,41,11,52,53,53
6,lak106d.map,76,60,4217,70,42,5,17,285,4,14,71,45,66,-28,94,121,219
7,lak106d.map,76,60,4036,67,43,8,16,3974,66,45,9,14,1,2,3,4,4
8,lak106d.map,76,60,2568,42,11,33,48,2336,38,3,37,56,4,-8,12,13,13
9,lak106d.map,76,60,3848,64,51,11,8,1307,21,12,54,47,43,-39,82,126,157
10,lak106d.map,76,60,459,7,20,68,39,3108,51,11,24,48,-44,-9,53,54,54
11,lak106d.map,76,60,3761,62,18,13,41,4389,73,50,2,9,-11,32,43,44,44
12,lak106d.map,76,60,773,12,6,63,53,223,3,16,72,43,9,10,19,41,20
13,lak106d.map,76,60,403,6,16,69,43,3315,55,44,20,15,-49,28,77,798,106
14,lak106d.map,76,60,2024,33,15,42,44,3818,63,21,12,38,-30,6,36,37,37
15,lak106d.map,76,60,4146,69,53,6,6,1367,22,12,53,47,47,-41,88,132,161
16,lak106d.map,76,60,4004,66,15,9,44,639,10,20,65,39,56,5,61,62,62
17,lak106d.map,76,60,1003,16,16,59,43,2502,41,17,34,42,-25,1,26,27,27
18,lak106d.map,76,60,4176,69,23,6,36,2927,48,12,27,47,21,-11,32,33,33
19,lak106d.map,76,60,1675,27,4,48,55,886,14,13,61,46,13,9,22,32,103
20,lak106d.map,76,60,4329,72,50,3,9,1606,26,13,49,46,46,-37,83,127,142
21,lak106d.map,76,60,1010,16,9,59,50,1061,17,18,58,41,-1,9,10,11,11
22,lak106d.map,76,60,3728,62,51,13,8,3495,58,44,17,15,4,-7,11,12,12
23,lak106d.map,76,60,4178,69,21,6,38,4334,72,45,3,14,-3,24,27,90,143
24,lak106d.map,76,60,1546,25,13,50,46,2092,34,7,41,52,-9,-6,15,16,16
25,lak106d.map,76,60,2496,41,23,34,36,4116,68,23,7,36,-27,0,27,28,28
26,lak106d.map,76,60,712,11,7,64,52,3665,61,54,14,5,-50,47,97,197,143
27,lak106d.map,76,60,4066,67,13,8,46,3275,54,24,21,35,13,11,24,25,25
28,lak106d.map,76,60,2092,34,7,41,52,3702,61,17,14,42,-27,10,37,38,38
29,lak106d.map,76,60,1653,27,26,48,33,1902,31,17,44,42,-4,-9,13,14,14
30,lak106d.map,76,60,3920,65,39,10,20,1667,27,12,48,47,38,-27,65,86,118
31,lak106d.map,76,60,953,15,6,60,53,2317,38,22,37,37,-23,16,39,40,40
32,lak106d.map,76,60,637,10,22,65,37,1606,26,13,49,46,-16,-9,25,26,26
33,lak106d.map,76,60,3576,59,23,16,36,3274,54,25,21,34,5,2,7,8,8
34,lak106d.map,76,60,3881,64,18,11,41,1182,19,17,56,42,45,-1,46,47,47
35,lak106d.map,76,60,3681,61,38,14,21,1244,20,15,55,44,41,-23,64,83,140
36,lak106d.map,76,60,352,5,7,70,52,1593,26,26,49,33,-21,19,40,56,116
37,lak106d.map,76,60,3434,57,45,18,14,1354,22,25,53,34,35,-20,55,154,207
38,lak106d.map,76,60,3932,65,27,10,32,2621,43,18,32,41,22,-9,31,32,32
39,lak106d.map,76,60,2091,34,8,41,51,1967,32,12,43,47,2,4,6,7,7
40,lak106d.map,76,60,1965,32,14,43,45,3967,66,52,9,7,-34,38,72,106,116
41,lak106d.map,76,60,3273,54,26,21,33,3748,62,31,13,28,-8,5,13,14,14
42,lak106d.map,76,60,2211,36,8,39,51,3639,60,20,15,39,-24,12,36,37,37
43,lak106d.map,76,60,2860,47,19,28,40,1853,30,6,45,53,17,-13,30,31,31
44,lak106d.map,76,60,107,1,12,74,47,3732,62,47,13,12,-61,35,96,230,137
45,lak106d.map,76,60,2264,37,15,38,44,337,5,22,70,37,32,7,39,40,40
46,lak106d.map,76,60,1064,17,15,58,44,2389,39,10,36,49,-22,-5,27,28,28
47,lak106d.map,76,60,2926,48,13,27,46,1007,16,12,59,47,32,-1,33,34,34
48,lak106d.map,76,60,3608,60,51,15,8,1054,17,25,58,34,43,-26,69,203,134
49,lak106d.map,76,60,3490,58,49,17,10,4188,69,11,6,48,-11,-38,49,56,67
50,lak106d.map,76,60,3873,64,26,11,33,2086,34,13,41,46,30,-13,43,44,63
51,lak106d.map,76,60,3993,66,26,9,33,3878,64,21,11,38,2,-5,7,8,8
52,lak106d.map,76,60,3589,59,10,16,49,215,3,24,72,35,56,14,70,71,71
53,lak106d.map,76,60,3728,62,51,13,8,693,11,26,64,33,51,-25,76,295,151
54,lak106d.map,76,60,2984,49,15,26,44,4160,69,39,6,20,-20,24,44,46,65
55,lak106d.map,76,60,291,4,8,71,51,1197,19,2,56,57,-15,-6,21,51,22
56,lak106d.map,76,60,4450,74,49,1,10,1235,20,24,55,35,54,-25,79,371,135
57,lak106d.map,76,60,402,6,17,69,42,4084,68,55,7,4,-62,38,100,219,146
58,lak106d.map,76,60,2091,34,8,41,51,4269,71,50,4,9,-37,42,79,109,123
59,lak106d.map,76,60,2201,36,18,39,41,3858,64,41,11,18,-28,23,51,69,76
60,lak106d.map,76,60,3763,62,16,13,43,701,11,18,64,41,51,2,53,54,54
61,lak106d.map,76,60,2809,46,10,29,49,3978,66,41,9,18,-20,31,51,53,76
62,lak106d.map,76,60,166,2,13,73,46,2199,36,20,39,39,-34,7,41,42,42
63,lak106d.map,76,60,1536,25,23,50,36,1423,23,16,52,43,2,-7,9,10,10
64,lak106d.map,76,60,3853,64,46,11,13,693,11,26,64,33,53,-20,73,300,148
65,lak106d.map,76,60,3993,66,26,9,33,4084,68,55,7,4,-2,29,31,59,159
66,lak106d.map,76,60,106,1,13,74,46,3579,59,20,16,39,-58,7,65,66,66
67,lak106d.map,76,60,1010,16,9,59,50,1605,26,14,49,45,-10,5,15,16,16
68,lak106d.map,76,60,3154,52,25,23,34,4173,69,26,6,33,-17,1,18,19,19
69,lak106d.map,76,60,1113,18,26,57,33,2381,39,18,36,41,-21,-8,29,30,30
70,lak106d.map,76,60,3044,50,15,25,44,1014,16,5,59,54,34,-10,44,45,45
71,lak106d.map,76,60,1607,26,12,49,47,3559,59,40,16,19,-33,28,61,120,84
72,lak106d.map,76,60,3741,62,38,13,21,2213,36,6,39,53,26,-32,58,77,76
73,lak106d.map,76,60,465,7,14,68,45,3970,66,49,9,10,-59,35,94,205,137
74,lak106d.map,76,60,1121,18,18,57,41,2028,33,11,42,48,-15,-7,22,23,23
75,lak106d.map,76,60,2689,44,10,31,49,1963,32,16,43,43,12,6,18,19,19
76,lak106d.map,76,60,416,6,3,69,56,3483,58,56,17,3,-52,53,105,1007,210
77,lak106d.map,76,60,158,2,21,73,38,1655,27,24,48,35,-25,3,28,29,29
78,lak106d.map,76,60,456,7,23,68,36,102,1,17,74,42,6,-6,12,13,13
79,lak106d.map,76,60,3154,52,25,23,34,3502,58,37,17,22,-6,12,18,34,32
80,lak106d.map,76,60,2397,39,2,36,57,2326,38,13,37,46,1,11,12,13,13
81,lak106d.map,76,60,713,11,6,64,53,2378,39,21,36,38,-28,15,43,44,44
82,lak106d.map,76,60,709,11,10,64,49,349,5,10,70,49,6,0,6,7,7
83,lak106d.map,76,60,1424,23,15,52,44,2389,39,10,36,49,-16,-5,21,22,22
84,lak106d.map,76,60,4120,68,19,7,40,1370,22,9,53,50,46,-10,56,57,57
85,lak106d.map,76,60,3451,57,28,18,31,219,3,20,72,39,54,-8,62,63,186
86,lak106d.map,76,60,1417,23,22,52,37,4183,69,16,6,43,-46,-6,52,53,53
87,lak106d.map,76,60,1734,28,5,47,54,2679,44,20,31,39,-16,15,31,32,32
88,lak106d.map,76,60,1734,28,5,47,54,2151,35,8,40,51,-7,3,10,11,11
89,lak106d.map,76,60,1784,29,15,46,44,1903,31,16,44,43,-2,1,3,4,4
90,lak106d.map,76,60,1251,20,8,55,51,4103,68,36,7,23,-48,28,76,152,91
91,lak106d.map,76,60,2619,43,20,32,39,756,12,23,63,36,31,3,34,35,35
92,lak106d.map,76,60,2689,44,10,31,49,3037,50,22,25,37,-6,12,18,19,19
93,lak106d.map,76,60,224,3,15,72,44,1655,27,24,48,35,-24,9,33,34,34
94,lak106d.map,76,60,3992,66,27,9,32,93,1,26,74,33,65,-1,66,143,153
95,lak106d.map,76,60,154,2,25,73,34,819,13,20,62,39,-11,-5,16,17,17
96,lak106d.map,76,60,3555,59,44,16,15,1053,17,26,58,33,42,-18,60,177,126
97,lak106d.map,76,60,3857,64,42,11,17,214,3,25,72,34,61,-17,78,242,175
98,lak106d.map,76,60,3349,55,10,20,49,998,16,21,59,38,39,11,50,51,51
99,lak106d.map,76,60,3745,62,34,13,25,289,4,10,71,49,58,-24,82,91,207
0,lak107d.map,23,30,196,6,13,16,16,221,7,18,15,11,-1,5,6,7,7
1,lak107d.map,23,30,185,6,24,16,5,306,10,23,12,6,-4,-1,5,6,6
2,lak107d.map,23,30,285,9,14,13,15,566,18,3,4,26,-9,-11,20,21,21
3,lak107d.map,23,30,131,4,18,18,11,254,8,15,14,14,-4,-3,7,8,8
4,lak107d.map,23,30,447,14,2,8,27,223,7,16,15,13,7,14,21,22,22
5,lak107d.map,23,30,300,10,29,12,0,252,8,17,14,12,2,-12,14,15,15
6,lak107d.map,23,30,474,15,5,7,24,133,4,16,18,13,11,11,22,23,23
7,lak107d.map,23,30,395,13,24,9,5,262,8,7,14,22,5,-17,22,23,23
8,lak107d.map,23,30,128,4,21,18,8,382,12,7,10,22,-8,-14,22,23,23
9,lak107d.map,23,30,201,6,8,16,21,268,8,1,14,28,-2,-7,9,10,10
10,lak107d.map,23,30,565,18,4,4,25,111,3,8,19,21,15,4,19,20,20
11,lak107d.map,23,30,274,9,25,13,4,231,7,8,15,21,2,-17,19,20,20
12,lak107d.map,23,30,379,12,10,10,19,271,9,28,13,1,3,18,21,22,22
13,lak107d.map,23,30,332,11,27,11,2,349,11,10,11,19,0,-17,17,20,20
14,lak107d.map,23,30,322,10,7,12,22,332,11,27,11,2,-1,20,21,22,22
15,lak107d.map,23,30,395,13,24,9,5,46,1,13,21,16,12,-11,23,27,24
16,lak107d.map,23,30,546,18,23,4,6,173,5,6,17,23,13,-17,30,59,251
17,lak107d.map,23,30,573,19,26,3,3,503,16,6,6,23,3,-20,23,84,106
18,lak107d.map,23,30,78,2,11,20,18,607,20,22,2,7,-18,11,29,212,61
19,lak107d.map,23,30,172,5,7,17,22,100,3,19,19,10,2,12,14,15,15
20,lak107d.map,23,30,178,5,1,17,28,390,13,29,9,0,-8,28,36,37,37
21,lak107d.map,23,30,544,18,25,4,4,211,7,28,15,1,11,3,14,15,22
22,lak107d.map,23,30,391,13,28,9,1,335,11,24,11,5,2,-4,6,7,7
23,lak107d.map,23,30,609,20,20,2,9,194,6,15,16,14,14,-5,19,50,153
24,lak107d.map,23,30,251,8,18,14,11,195,6,14,16,15,2,-4,6,7,7
25,lak107d.map,23,30,212,7,27,15,2,228,7,11,15,18,0,-16,16,17,17
26,lak107d.map,23,30,224,7,15,15,14,244,8,25,14,4,-1,10,11,12,12
27,lak107d.map,23,30,378,12,11,10,18,229,7,10,15,19,5,-1,6,7,7
28,lak107d.map,23,30,411,13,8,9,21,236,7,3,15,26,6,-5,11,12,12
29,lak107d.map,23,30,75,2,14,20,15,300,10,29,12,0,-8,15,23,24,27
30,lak107d.map,23,30,171,5,8,17,21,348,11,11,11,18,-6,3,9,10,10
31,lak107d.map,23,30,418,13,1,9,28,355,11,4,11,25,2,3,5,6,6
32,lak107d.map,23,30,472,15,7,7,22,307,10,22,12,7,5,15,20,21,21
33,lak107d.map,23,30,483,16,26,6,3,159,5,20,17,9,11,-6,17,18,18
34,lak107d.map,23,30,592,19,7,3,22,356,11,3,11,26,8,-4,12,13,13
35,lak107d.map,23,30,178,5,1,17,28,283,9,16,13,13,-4,15,19,20,20
36,lak107d.map,23,30,277,9,22,13,7,447,14,2,8,27,-5,-20,25,26,26
37,lak107d.map,23,30,43,1,16,21,13,303,10,26,12,3,-9,10,19,20,23
38,lak107d.map,23,30,96,3,23,19,6,452,15,27,7,2,-12,4,16,17,17
39,lak107d.map,23,30,499,16,10,6,19,215,7,24,15,5,9,14,23,24,24
40,lak107d.map,23,30,197,6,12,16,17,126,4,23,18,6,2,11,13,14,14
41,lak107d.map,23,30,361,12,28,10,1,140,4,9,18,20,8,-19,27,28,28
42,lak107d.map,23,30,326,10,3,12,26,286,9,13,13,16,1,10,11,12,12
43,lak107d.map,23,30,282,9,17,13,12,540,18,29,4,0,-9,12,21,32,22
44,lak107d.map,23,30,416,13,3,9,26,446,14,3,8,26,-1,0,1,2,2
45,lak107d.map,23,30,272,9,27,13,2,128,4,21,18,8,5,-6,11,12,12
46,lak107d.map,23,30,52,1,7,21,22,591,19,8,3,21,-18,1,19,20,20
47,lak107d.map,23,30,514,17,25,5,4,187,6,22,16,7,11,-3,14,24,34
48,lak107d.map,23,30,300,10,29,12,0,439,14,10,8,19,-4,-19,23,24,24
49,lak107d.map,23,30,624,20,5,2,24,363,12,26,10,3,8,21,29,87,85
50,lak107d.map,23,30,282,9,17,13,12,684,22,5,0,24,-13,-12,25,26,26
51,lak107d.map,23,30,248,8,21,14,8,95,3,24,19,5,5,3,8,9,9
52,lak107d.map,23,30,475,15,4,7,25,550,18,19,4,10,-3,15,18,263,85
53,lak107d.map,23,30,541,18,28,4,1,102,3,17,19,12,15,-11,26,27,34
54,lak107d.map,23,30,684,22,5,0,24,351,11,8,11,21,11,3,14,15,15
55,lak107d.map,23,30,440,14,9,8,20,99,3,20,19,9,11,11,22,23,23
56,lak107d.map,23,30,73,2,16,20,13,237,7,2,15,27,-5,-14,19,21,20
57,lak107d.map,23,30,332,11,27,11,2,285,9,14,13,15,2,-13,15,16,16
58,lak107d.map,23,30,186,6,23,16,6,228,7,11,15,18,-1,-12,13,14,14
59,lak107d.map,23,30,382,12,7,10,22,351,11,8,11,21,1,1,2,3,3
60,lak107d.map,23,30,500,16,9,6,20,580,19,19,3,10,-3,10,13,235,81
61,lak107d.map,23,30,251,8,18,14,11,214,7,25,15,4,1,7,8,9,9
62,lak107d.map,23,30,515,17,24,5,5,133,4,16,18,13,13,-8,21,43,99
63,lak107d.map,23,30,594,19,5,3,24,572,19,27,3,2,0,22,22,111,91
64,lak107d.map,23,30,196,6,13,16,16,511,17,28,5,1,-11,15,26,34,27
65,lak107d.map,23,30,626,20,3,2,26,306,10,23,12,6,10,20,30,31,31
66,lak107d.map,23,30,107,3,12,19,17,171,5,8,17,21,-2,-4,6,7,7
67,lak107d.map,23,30,219,7,20,15,9,303,10,26,12,3,-3,6,9,10,10
68,lak107d.map,23,30,106,3,13,19,16,244,8,25,14,4,-5,12,17,18,18
69,lak107d.map,23,30,328,10,1,12,28,574,19,25,3,4,-9,24,33,127,60
70,lak107d.map,23,30,384,12,5,10,24,293,9,6,13,23,3,1,4,5,5
71,lak107d.map,23,30,144,4,5,18,24,45,1,14,21,15,3,9,12,13,15
72,lak107d.map,23,30,44,1,15,21,14,134,4,15,18,14,-3,0,3,4,4
73,lak107d.map,23,30,141,4,8,18,21,559,18,10,4,19,-14,2,16,17,17
74,lak107d.map,23,30,193,6,16,16,13,654,21,5,1,24,-15,-11,26,27,27
75,lak107d.map,23,30,98,3,21,19,8,19,0,10,22,19,3,-11,14,15,15
76,lak107d.map,23,30,563,18,6,4,23,159,5,20,17,9,13,14,27,28,28
77,lak107d.map,23,30,101,3,18,19,11,158,5,21,17,8,-2,3,5,6,6
78,lak107d.map,23,30,128,4,21,18,8,130,4,19,18,10,0,-2,2,3,3
79,lak107d.map,23,30,385,12,4,10,25,246,8,23,14,6,4,19,23,24,24
80,lak107d.map,23,30,563,18,6,4,23,78,2,11,20,18,16,5,21,22,22
81,lak107d.map,23,30,444,14,5,8,24,175,5,4,17,25,9,-1,10,11,11
82,lak107d.map,23,30,264,8,5,14,24,440,14,9,8,20,-6,4,10,11,11
83,lak107d.map,23,30,113,3,6,19,23,653,21,6,1,23,-18,0,18,19,19
84,lak107d.map,23,30,482,16,27,6,2,516,17,23,5,6,-1,-4,5,6,6
85,lak107d.map,23,30,242,8,27,14,2,308,10,21,12,8,-2,-6,8,9,9
86,lak107d.map,23,30,170,5,9,17,20,196,6,13,16,16,-1,4,5,6,6
87,lak107d.map,23,30,326,10,3,12,26,230,7,9,15,20,3,6,9,10,10
88,lak107d.map,23,30,576,19,23,3,6,284,9,15,13,14,10,-8,18,47,65
89,lak107d.map,23,30,266,8,3,14,26,239,7,0,15,29,1,-3,4,5,5
90,lak107d.map,23,30,626,20,3,2,26,251,8,18,14,11,12,15,27,28,28
91,lak107d.map,23,30,322,10,7,12,22,292,9,7,13,22,1,0,1,2,2
92,lak107d.map,23,30,176,5,3,17,26,595,19,4,3,25,-14,1,15,16,16
93,lak107d.map,23,30,233,7,6,15,23,226,7,13,15,16,0,7,7,8,8
94,lak107d.map,23,30,624,20,5,2,24,113,3,6,19,23,17,1,18,19,19
95,lak107d.map,23,30,381,12,8,10,21,534,17,5,5,24,-5,-3,8,9,9
96,lak107d.map,23,30,300,10,29,12,0,357,11,2,11,27,-1,-27,28,29,29
97,lak107d.map,23,30,226,7,13,15,16,276,9,23,13,6,-2,10,12,13,13
98,lak107d.map,23,30,49,1,10,21,19,18,0,11,22,18,1,1,2,3,3
99,lak107d.map,23,30,233,7,6,15,23,307,10,22,12,7,-3,16,19,20,20
0,lak108d.map,23,21,316,15,19,7,1,142,6,4,16,16,9,-15,24,25,25
1,lak108d.map,23,21,96,4,8,18,12,382,18,16,4,4,-14,8,22,111,32
2,lak108d.map,23,21,218,10,12,12,8,275,13,18,9,2,-3,6,9,10,10
3,lak108d.map,23,21,205,9,4,13,16,190,9,19,13,1,0,15,15,16,16
4,lak108d.map,23,21,312,14,2,8,18,198,9,11,13,9,5,9,14,15,15
5,lak108d.map,23,21,240,11,11,11,9,117,5,8,17,12,6,-3,9,10,10
6,lak108d.map,23,21,378,18,20,4,0,444,21,17,1,3,-3,-3,6,7,7
7,lak108d.map,23,21,135,6,11,16,9,159,7,8,15,12,-1,-3,4,5,5
8,lak108d.map,23,21,88,4,16,18,4,5,0,15,22,5,4,-1,5,6,6
9,lak108d.map,23,21,80,3,3,19,17,193,9,16,13,4,-6,13,19,20,20
10,lak108d.map,23,21,240,11,11,11,9,273,13,20,9,0,-2,9,11,12,12
11,lak108d.map,23,21,152,7,15,15,5,254,12,18,10,2,-5,3,8,9,9
12,lak108d.map,23,21,250,11,1,11,19,84,4,20,18,0,7,19,26,42,28
13,lak108d.map,23,21,48,2,14,20,6,394,18,4,4,16,-16,-10,26,125,32
14,lak108d.map,23,21,143,6,3,16,17,151,7,16,15,4,-1,13,14,15,15
15,lak108d.map,23,21,180,8,8,14,12,359,17,18,5,2,-9,10,19,20,20
16,lak108d.map,23,21,91,4,13,18,7,4,0,16,22,4,4,3,7,8,8
17,lak108d.map,23,21,139,6,7,16,13,174,8,14,14,6,-2,7,9,10,10
18,lak108d.map,23,21,88,4,16,18,4,134,6,12,16,8,-2,-4,6,7,7
19,lak108d.map,23,21,393,18,5,4,15,159,7,8,15,12,11,3,14,22,48
20,lak108d.map,23,21,362,17,15,5,5,420,20,20,2,0,-3,5,8,9,9
21,lak108d.map,23,21,217,10,13,12,7,252,12,20,10,0,-2,7,9,10,10
22,lak108d.map,23,21,59,2,3,20,17,382,18,16,4,4,-16,13,29,208,39
23,lak108d.map,23,21,177,8,11,14,9,238,11,13,11,7,-3,2,5,6,6
24,lak108d.map,23,21,224,10,6,12,14,444,21,17,1,3,-11,11,22,42,31
25,lak108d.map,23,21,194,9,15,13,5,93,4,11,18,9,5,-4,9,10,10
26,lak108d.map,23,21,185,8,3,14,17,317,15,18,7,2,-7,15,22,23,23
27,lak108d.map,23,21,162,7,5,15,15,215,10,15,12,5,-3,10,13,14,14
28,lak108d.map,23,21,26,1,15,21,5,183,8,5,14,15,-7,-10,17,18,18
29,lak108d.map,23,21,177,8,11,14,9,295,14,19,8,1,-6,8,14,15,15
30,lak108d.map,23,21,251,11,0,11,20,239,11,12,11,8,0,12,12,13,13
31,lak108d.map,23,21,24,1,17,21,3,5,0,15,22,5,1,-2,3,4,4
32,lak108d.map,23,21,275,13,18,9,2,423,20,17,2,3,-7,-1,8,10,9
33,lak108d.map,23,21,373,17,4,5,16,222,10,8,12,12,7,4,11,17,22
34,lak108d.map,23,21,99,4,5,18,15,139,6,7,16,13,-2,2,4,5,5
35,lak108d.map,23,21,249,11,2,11,18,190,9,19,13,1,2,17,19,20,20
36,lak108d.map,23,21,416,19,3,3,17,132,6,14,16,6,13,11,24,25,25
37,lak108d.map,23,21,339,16,17,6,3,93,4,11,18,9,12,-6,18,21,67
38,lak108d.map,23,21,67,3,16,19,4,198,9,11,13,9,-6,-5,11,12,12
39,lak108d.map,23,21,216,10,14,12,6,127,6,19,16,1,4,5,9,10,10
40,lak108d.map,23,21,332,15,3,7,17,69,3,14,19,6,12,11,23,24,24
41,lak108d.map,23,21,90,4,14,18,6,375,17,2,5,18,-13,-12,25,28,26
42,lak108d.map,23,21,249,11,2,11,18,58,2,4,20,16,9,2,11,12,16
43,lak108d.map,23,21,273,13,20,9,0,138,6,8,16,12,7,-12,19,20,20
44,lak108d.map,23,21,290,13,3,9,17,230,10,0,12,20,3,-3,6,7,7
45,lak108d.map,23,21,194,9,15,13,5,47,2,15,20,5,7,0,7,8,8
46,lak108d.map,23,21,457,21,4,1,16,95,4,9,18,11,17,5,22,30,64
47,lak108d.map,23,21,288,13,5,9,15,173,8,15,14,5,5,10,15,16,16
48,lak108d.map,23,21,136,6,10,16,10,139,6,7,16,13,0,-3,3,4,4
49,lak108d.map,23,21,384,18,14,4,6,212,10,18,12,2,8,4,12,13,25
50,lak108d.map,23,21,291,13,2,9,18,148,7,19,15,1,6,17,23,24,24
51,lak108d.map,23,21,266,12,6,10,14,78,3,5,19,15,9,-1,10,11,11
52,lak108d.map,23,21,101,4,3,18,17,287,13,6,9,14,-9,3,12,13,13
53,lak108d.map,23,21,201,9,8,13,12,194,9,15,13,5,0,7,7,8,8
54,lak108d.map,23,21,270,12,2,10,18,95,4,9,18,11,8,7,15,16,18
55,lak108d.map,23,21,291,13,2,9,18,149,7,18,15,2,6,16,22,23,23
56,lak108d.map,23,21,400,19,19,3,1,107,5,18,17,2,14,-1,15,16,16
57,lak108d.map,23,21,192,9,17,13,3,332,15,3,7,17,-6,-14,20,21,21
58,lak108d.map,23,21,232,11,19,11,1,135,6,11,16,9,5,-8,13,14,14
59,lak108d.map,23,21,384,18,14,4,6,129,6,17,16,3,12,3,15,21,40
60,lak108d.map,23,21,269,12,3,10,17,206,9,3,13,17,3,0,3,4,4
61,lak108d.map,23,21,289,13,4,9,16,106,5,19,17,1,8,15,23,24,24
62,lak108d.map,23,21,73,3,10,19,10,109,5,16,17,4,-2,6,8,9,9
63,lak108d.map,23,21,354,16,2,6,18,92,4,12,18,8,12,10,22,23,25
64,lak108d.map,23,21,241,11,10,11,10,267,12,5,10,15,-1,-5,6,7,7
65,lak108d.map,23,21,291,13,2,9,18,239,11,12,11,8,2,10,12,13,13
66,lak108d.map,23,21,25,1,16,21,4,53,2,9,20,11,-1,-7,8,9,9
67,lak108d.map,23,21,132,6,14,16,6,191,9,18,13,2,-3,4,7,8,8
68,lak108d.map,23,21,73,3,10,19,10,11,0,9,22,11,3,-1,4,5,5
69,lak108d.map,23,21,201,9,8,13,12,157,7,10,15,10,2,2,4,5,5
70,lak108d.map,23,21,458,21,3,1,17,191,9,18,13,2,12,15,27,28,28
71,lak108d.map,23,21,362,17,15,5,5,247,11,4,11,16,6,-11,17,28,80
72,lak108d.map,23,21,244,11,7,11,13,230,10,0,12,20,1,-7,8,9,9
73,lak108d.map,23,21,39,1,2,21,18,175,8,13,14,7,-7,11,18,19,26
74,lak108d.map,23,21,332,15,3,7,17,239,11,12,11,8,4,9,13,14,14
75,lak108d.map,23,21,4,0,16,22,4,222,10,8,12,12,-10,-8,18,19,21
76,lak108d.map,23,21,34,1,7,21,13,333,15,2,7,18,-14,-5,19,24,20
77,lak108d.map,23,21,250,11,1,11,19,130,6,16,16,4,5,15,20,21,21
78,lak108d.map,23,21,5,0,15,22,5,422,20,18,2,2,-20,3,23,26,24
79,lak108d.map,23,21,394,18,4,4,16,75,3,8,19,12,15,4,19,25,58
80,lak108d.map,23,21,402,19,17,3,3,339,16,17,6,3,3,0,3,4,4
81,lak108d.map,23,21,378,18,20,4,0,3,0,17,22,3,18,-3,21,22,31
82,lak108d.map,23,21,261,12,11,10,9,311,14,3,8,17,-2,-8,10,13,16
83,lak108d.map,23,21,157,7,10,15,10,383,18,15,4,5,-11,5,16,79,27
84,lak108d.map,23,21,193,9,16,13,4,118,5,7,17,13,4,-9,13,14,14
85,lak108d.map,23,21,121,5,4,17,16,74,3,9,19,11,2,5,7,8,8
86,lak108d.map,23,21,384,18,14,4,6,31,1,10,21,10,17,-4,21,33,141
87,lak108d.map,23,21,333,15,2,7,18,374,17,3,5,17,-2,1,3,4,4
88,lak108d.map,23,21,394,18,4,4,16,396,18,2,4,18,0,-2,2,3,3
89,lak108d.map,23,21,169,8,19,14,1,362,17,15,5,5,-9,-4,13,30,14
90,lak108d.map,23,21,241,11,10,11,10,205,9,4,13,16,2,-6,8,9,9
91,lak108d.map,23,21,75,3,8,19,12,163,7,4,15,16,-4,-4,8,9,9
92,lak108d.map,23,21,176,8,12,14,8,274,13,19,9,1,-5,7,12,13,13
93,lak108d.map,23,21,181,8,7,14,13,110,5,15,17,5,3,8,11,12,12
94,lak108d.map,23,21,184,8,4,14,16,206,9,3,13,17,-1,-1,2,3,3
95,lak108d.map,23,21,185,8,3,14,17,269,12,3,10,17,-4,0,4,5,5
96,lak108d.map,23,21,131,6,15,16,5,436,20,4,2,16,-14,-11,25,89,33
97,lak108d.map,23,21,84,4,20,18,0,197,9,12,13,8,-5,-8,13,14,20
98,lak108d.map,23,21,50,2,12,20,8,95,4,9,18,11,-2,-3,5,6,6
99,lak108d.map,23,21,273,13,20,9,0,97,4,7,18,13,9,-13,22,23,24
0,lak109d.map,31,30,189,6,20,24,9,630,21,29,9,0,-15,9,24,25,25
1,lak109d.map,31,30,658,21,1,9,28,131,4,18,26,11,17,17,34,35,35
2,lak109d.map,31,30,756,25,23,5,6,244,8,25,22,4,17,2,19,20,39
3,lak109d.map,31,30,880,29,19,1,10,535,17,4,13,25,12,-15,27,154,189
4,lak109d.map,31,30,339,11,20,19,9,397,13,22,17,7,-2,2,4,5,5
5,lak109d.map,31,30,336,11,23,19,6,132,4,17,26,12,7,-6,13,14,14
6,lak109d.map,31,30,228,7,11,23,18,317,10,12,20,17,-3,1,4,5,5
7,lak109d.map,31,30,538,17,1,13,28,382,12,7,18,22,5,6,11,12,12
8,lak109d.map,31,30,688,22,1,8,28,451,15,28,15,1,7,27,34,98,163
9,lak109d.map,31,30,752,25,27,5,2,14,0,15,30,14,25,-12,37,38,38
10,lak109d.map,31,30,753,25,26,5,3,539,17,0,13,29,8,-26,34,162,106
11,lak109d.map,31,30,697,23,22,7,7,134,4,15,26,14,19,-7,26,39,102
12,lak109d.map,31,30,597,19,2,11,27,189,6,20,24,9,13,18,31,32,32
13,lak109d.map,31,30,450,15,29,15,0,535,17,4,13,25,-2,-25,27,114,86
14,lak109d.map,31,30,280,9,19,21,10,503,16,6,14,23,-7,-13,20,21,21
15,lak109d.map,31,30,368,12,21,18,8,851,28,18,2,11,-16,-3,19,47,51
16,lak109d.map,31,30,536,17,3,13,26,75,2,14,28,15,15,11,26,27,27
17,lak109d.map,31,30,788,26,21,4,8,197,6,12,24,17,20,-9,29,63,124
18,lak109d.map,31,30,504,16,5,14,24,134,4,15,26,14,12,10,22,23,23
19,lak109d.map,31,30,217,7,22,23,7,382,12,7,18,22,-5,-15,20,21,21
20,lak109d.map,31,30,258,8,11,22,18,383,12,6,18,23,-4,-5,9,10,10
21,lak109d.map,31,30,573,19,26,11,3,246,8,23,22,6,11,-3,14,15,15
22,lak109d.map,31,30,636,21,23,9,6,76,2,13,28,16,19,-10,29,35,113
23,lak109d.map,31,30,450,15,29,15,0,485,16,24,14,5,-1,-5,6,7,7
24,lak109d.map,31,30,451,15,28,15,1,693,23,26,7,3,-8,-2,10,11,11
25,lak109d.map,31,30,256,8,13,22,16,480,16,29,14,0,-8,16,24,25,25
26,lak109d.map,31,30,744,24,5,6,24,289,9,10,21,19,15,5,20,21,21
27,lak109d.map,31,30,656,21,3,9,26,452,15,27,15,2,6,24,30,97,152
28,lak109d.map,31,30,624,20,5,10,24,16,0,13,30,16,20,8,28,29,29
29,lak109d.map,31,30,16,0,13,30,16,453,15,26,15,3,-15,13,28,29,29
30,lak109d.map,31,30,453,15,26,15,3,287,9,12,21,17,6,-14,20,21,21
31,lak109d.map,31,30,336,11,23,19,6,14,0,15,30,14,11,-8,19,20,20
32,lak109d.map,31,30,321,10,8,20,21,564,18,5,12,24,-8,-3,11,12,12
33,lak109d.map,31,30,192,6,17,24,12,366,12,23,18,6,-6,6,12,13,13
34,lak109d.map,31,30,697,23,22,7,7,653,21,6,9,23,2,-16,18,156,155
35,lak109d.map,31,30,757,25,22,5,7,349,11,10,19,19,14,-12,26,106,107
36,lak109d.map,31,30,538,17,1,13,28,338,11,21,19,8,6,20,26,56,36
37,lak109d.map,31,30,382,12,7,18,22,567,18,2,12,27,-6,-5,11,12,12
38,lak109d.map,31,30,218,7,21,23,8,484,16,25,14,4,-9,4,13,14,14
39,lak109d.map,31,30,190,6,19,24,10,334,11,25,19,4,-5,6,11,12,12
40,lak109d.map,31,30,593,19,6,11,23,603,20,26,10,3,-1,20,21,101,157
41,lak109d.map,31,30,426,14,23,16,6,758,25,21,5,8,-11,-2,13,22,27
42,lak109d.map,31,30,604,20,25,10,4,693,23,26,7,3,-3,1,4,5,5
43,lak109d.map,31,30,220,7,19,23,10,654,21,5,9,24,-14,-14,28,29,29
44,lak109d.map,31,30,480,16,29,14,0,243,8,26,22,3,8,-3,11,12,12
45,lak109d.map,31,30,225,7,14,23,15,758,25,21,5,8,-18,7,25,107,54
46,lak109d.map,31,30,16,0,13,30,16,219,7,20,23,9,-7,7,14,15,15
47,lak109d.map,31,30,474,15,5,15,24,877,29,22,1,7,-14,17,31,161,151
48,lak109d.map,31,30,217,7,22,23,7,102,3,17,27,12,4,-5,9,10,10
49,lak109d.map,31,30,251,8,18,22,11,247,8,22,22,7,0,4,4,5,5
50,lak109d.map,31,30,605,20,24,10,5,165,5,14,25,15,15,-10,25,28,80
51,lak109d.map,31,30,192,6,17,24,12,186,6,23,24,6,0,6,6,7,7
52,lak109d.map,31,30,105,3,14,27,15,319,10,10,20,19,-7,-4,11,12,12
53,lak109d.map,31,30,633,21,26,9,3,422,14,27,16,2,7,1,8,9,9
54,lak109d.map,31,30,480,16,29,14,0,604,20,25,10,4,-4,-4,8,9,9
55,lak109d.map,31,30,755,25,24,5,5,15,0,14,30,15,25,-10,35,47,103
56,lak109d.map,31,30,877,29,22,1,7,743,24,6,6,23,5,-16,21,185,161
57,lak109d.map,31,30,384,12,5,18,24,252,8,17,22,12,4,12,16,17,17
58,lak109d.map,31,30,137,4,12,26,17,451,15,28,15,1,-11,16,27,28,28
59,lak109d.map,31,30,633,21,26,9,3,723,24,26,6,3,-3,0,3,4,4
60,lak109d.map,31,30,602,20,27,10,2,451,15,28,15,1,5,1,6,7,7
61,lak109d.map,31,30,754,25,25,5,4,223,7,16,23,13,18,-9,27,28,28
62,lak109d.map,31,30,816,27,23,3,6,626,20,3,10,26,7,-20,27,158,146
63,lak109d.map,31,30,452,15,27,15,2,215,7,24,23,5,8,-3,11,12,12
64,lak109d.map,31,30,304,10,25,20,4,685,22,4,8,25,-12,-21,33,80,61
65,lak109d.map,31,30,363,12,26,18,3,302,10,27,20,2,2,1,3,4,4
66,lak109d.map,31,30,821,27,18,3,11,190,6,19,24,10,21,1,22,59,103
67,lak109d.map,31,30,722,24,27,6,2,877,29,22,1,7,-5,-5,10,11,11
68,lak109d.map,31,30,691,23,28,7,1,308,10,21,20,8,13,-7,20,21,21
69,lak109d.map,31,30,75,2,14,28,15,755,25,24,5,5,-23,10,33,97,45
70,lak109d.map,31,30,332,11,27,19,2,422,14,27,16,2,-3,0,3,4,4
71,lak109d.map,31,30,724,24,25,6,4,285,9,14,21,15,15,-11,26,27,27
72,lak109d.map,31,30,849,28,20,2,9,317,10,12,20,17,18,-8,26,90,119
73,lak109d.map,31,30,849,28,20,2,9,258,8,11,22,18,20,-9,29,65,129
74,lak109d.map,31,30,633,21,26,9,3,877,29,22,1,7,-8,-4,12,13,13
75,lak109d.map,31,30,226,7,13,23,16,422,14,27,16,2,-7,14,21,22,22
76,lak109d.map,31,30,880,29,19,1,10,821,27,18,3,11,2,-1,3,4,4
77,lak109d.map,31,30,536,17,3,13,26,412,13,7,17,22,4,4,8,9,9
78,lak109d.map,31,30,848,28,21,2,8,104,3,15,27,14,25,-6,31,66,123
79,lak109d.map,31,30,275,9,24,21,5,572,19,27,11,2,-10,3,13,14,14
80,lak109d.map,31,30,363,12,26,18,3,131,4,18,26,11,8,-8,16,17,17
81,lak109d.map,31,30,752,25,27,5,2,515,17,24,13,5,8,-3,11,12,12
82,lak109d.map,31,30,134,4,15,26,14,255,8,14,22,15,-4,-1,5,6,6
83,lak109d.map,31,30,246,8,23,22,6,367,12,22,18,7,-4,-1,5,6,6
84,lak109d.map,31,30,217,7,22,23,7,684,22,5,8,24,-15,-17,32,33,33
85,lak109d.map,31,30,289,9,10,21,19,307,10,22,20,7,-1,12,13,14,14
86,lak109d.map,31,30,132,4,17,26,12,310,10,19,20,10,-6,2,8,9,9
87,lak109d.map,31,30,662,22,27,8,2,222,7,17,23,12,15,-10,25,26,26
88,lak109d.map,31,30,248,8,21,22,8,319,10,10,20,19,-2,-11,13,14,14
89,lak109d.map,31,30,425,14,24,16,5,412,13,7,17,22,1,-17,18,54,43
90,lak109d.map,31,30,787,26,22,4,7,655,21,4,9,25,5,-18,23,158,158
91,lak109d.map,31,30,310,10,19,20,10,631,21,28,9,1,-11,9,20,21,21
92,lak109d.map,31,30,785,26,24,4,5,655,21,4,9,25,5,-20,25,158,130
93,lak109d.map,31,30,284,9,15,21,14,197,6,12,24,17,3,-3,6,7,7
94,lak109d.map,31,30,163,5,16,25,13,396,13,23,17,6,-8,7,15,16,16
95,lak109d.map,31,30,656,21,3,9,26,595,19,4,11,25,2,1,3,4,4
96,lak109d.map,31,30,453,15,26,15,3,566,18,3,12,26,-3,-23,26,117,92
97,lak109d.map,31,30,227,7,12,23,17,604,20,25,10,4,-13,13,26,27,27
98,lak109d.map,31,30,304,10,25,20,4,254,8,15,22,14,2,-10,12,13,13
99,lak109d.map,31,30,787,26,22,4,7,15,0,14,30,15,26,-8,34,64,123
0,lak110d.map,14,25,137,5,12,8,12,233,9,16,4,8,-4,4,8,9,9
1,lak110d.map,14,25,302,12,22,1,2,247,9,2,4,22,3,-20,23,24,24
2,lak110d.map,14,25,321,12,3,1,21,85,3,14,10,10,9,11,20,32,21
3,lak110d.map,14,25,302,12,22,1,2,254,10,20,3,4,2,-2,4,5,5
4,lak110d.map,14,25,304,12,20,1,4,210,8,14,5,10,4,-6,10,11,11
5,lak110d.map,14,25,185,7,14,6,10,262,10,12,3,12,-3,-2,5,6,6
6,lak110d.map,14,25,260,10,14,3,10,229,9,20,4,4,1,6,7,8,8
7,lak110d.map,14,25,216,8,8,5,16,237,9,12,4,12,-1,4,5,6,6
8,lak110d.map,14,25,292,11,7,2,17,229,9,20,4,4,2,13,15,16,16
9,lak110d.map,14,25,83,3,16,10,8,207,8,17,5,7,-5,1,6,7,7
10,lak110d.map,14,25,242,9,7,4,17,195,7,4,6,20,2,-3,5,6,6
11,lak110d.map,14,25,236,9,13,4,11,303,12,21,1,3,-3,8,11,12,12
12,lak110d.map,14,25,280,11,19,2,5,348,13,1,0,23,-2,-18,20,24,27
13,lak110d.map,14,25,273,10,1,3,23,214,8,10,5,14,2,9,11,12,12
14,lak110d.map,14,25,200,8,24,5,0,198,7,1,6,23,1,-23,24,32,25
15,lak110d.map,14,25,81,3,18,10,6,170,6,4,7,20,-3,-14,17,51,26
16,lak110d.map,14,25,156,6,18,7,6,87,3,12,10,12,3,-6,9,10,10
17,lak110d.map,14,25,187,7,12,6,12,109,4,15,9,9,3,3,6,7,7
18,lak110d.map,14,25,250,10,24,3,0,235,9,14,4,10,1,-10,11,12,12
19,lak110d.map,14,25,107,4,17,9,7,285,11,14,2,10,-7,-3,10,11,11
20,lak110d.map,14,25,299,11,0,2,24,213,8,11,5,13,3,11,14,15,15
21,lak110d.map,14,25,217,8,7,5,17,204,8,20,5,4,0,13,13,14,14
22,lak110d.map,14,25,299,11,0,2,24,283,11,16,2,8,0,16,16,19,19
23,lak110d.map,14,25,242,9,7,4,17,259,10,15,3,9,-1,8,9,10,10
24,lak110d.map,14,25,219,8,5,5,19,348,13,1,0,23,-5,-4,9,10,10
25,lak110d.map,14,25,283,11,16,2,8,219,8,5,5,19,3,-11,14,15,15
26,lak110d.map,14,25,108,4,16,9,8,206,8,18,5,6,-4,2,6,7,7
27,lak110d.map,14,25,162,6,12,7,12,157,6,17,7,7,0,5,5,6,6
28,lak110d.map,14,25,36,1,13,12,11,62,2,12,11,12,-1,-1,2,3,3
29,lak110d.map,14,25,321,12,3,1,21,238,9,11,4,13,3,8,11,12,12
30,lak110d.map,14,25,276,11,23,2,1,60,2,14,11,10,9,-9,18,19,21
31,lak110d.map,14,25,105,4,19,9,5,195,7,4,6,20,-3,-15,18,39,26
32,lak110d.map,14,25,258,10,16,3,8,132,5,17,8,7,5,1,6,7,7
33,lak110d.map,14,25,137,5,12,8,12,36,1,13,12,11,4,1,5,6,6
34,lak110d.map,14,25,60,2,14,11,10,206,8,18,5,6,-6,4,10,11,11
35,lak110d.map,14,25,260,10,14,3,10,86,3,13,10,11,7,-1,8,9,9
36,lak110d.map,14,25,203,8,21,5,3,133,5,16,8,8,3,-5,8,9,9
37,lak110d.map,14,25,170,6,4,7,20,278,11,21,2,3,-5,17,22,23,37
38,lak110d.map,14,25,249,9,0,4,24,229,9,20,4,4,0,20,20,21,21
39,lak110d.map,14,25,136,5,13,8,11,109,4,15,9,9,1,2,3,4,4
40,lak110d.map,14,25,232,9,17,4,7,298,11,1,2,23,-2,-16,18,19,19
41,lak110d.map,14,25,281,11,18,2,6,215,8,9,5,15,3,-9,12,13,13
42,lak110d.map,14,25,192,7,7,6,17,187,7,12,6,12,0,5,5,9,10
43,lak110d.map,14,25,187,7,12,6,12,268,10,6,3,18,-3,-6,9,10,13
44,lak110d.map,14,25,232,9,17,4,7,213,8,11,5,13,1,-6,7,8,8
45,lak110d.map,14,25,256,10,18,3,6,229,9,20,4,4,1,2,3,4,4
46,lak110d.map,14,25,251,10,23,3,1,13,0,11,13,13,10,-12,22,23,25
47,lak110d.map,14,25,256,10,18,3,6,299,11,0,2,24,-1,-18,19,20,20
48,lak110d.map,14,25,111,4,13,9,11,183,7,16,6,8,-3,3,6,7,7
49,lak110d.map,14,25,264,10,10,3,14,196,7,3,6,21,3,-7,10,11,11
50,lak110d.map,14,25,251,10,23,3,1,238,9,11,4,13,1,-12,13,14,14
51,lak110d.map,14,25,184,7,15,6,9,279,11,20,2,4,-4,5,9,10,10
52,lak110d.map,14,25,274,10,0,3,24,282,11,17,2,7,-1,17,18,19,19
53,lak110d.map,14,25,182,7,17,6,7,254,10,20,3,4,-3,3,6,7,7
54,lak110d.map,14,25,80,3,19,10,5,302,12,22,1,2,-9,3,12,15,27
55,lak110d.map,14,25,258,10,16,3,8,62,2,12,11,12,8,-4,12,13,13
56,lak110d.map,14,25,242,9,7,4,17,181,7,18,6,6,2,11,13,16,14
57,lak110d.map,14,25,265,10,9,3,15,237,9,12,4,12,1,3,4,5,5
58,lak110d.map,14,25,86,3,13,10,11,230,9,19,4,5,-6,6,12,15,13
59,lak110d.map,14,25,84,3,15,10,9,183,7,16,6,8,-4,1,5,6,6
60,lak110d.map,14,25,112,4,12,9,12,277,11,22,2,2,-7,10,17,19,18
61,lak110d.map,14,25,277,11,22,2,2,253,10,21,3,3,1,-1,2,3,3
62,lak110d.map,14,25,209,8,15,5,9,167,6,7,7,17,2,-8,10,19,11
63,lak110d.map,14,25,296,11,3,2,21,173,6,1,7,23,5,-2,7,8,8
64,lak110d.map,14,25,203,8,21,5,3,159,6,15,7,9,2,-6,8,9,9
65,lak110d.map,14,25,283,11,16,2,8,227,9,22,4,2,2,6,8,9,9
66,lak110d.map,14,25,208,8,16,5,8,204,8,20,5,4,0,4,4,5,5
67,lak110d.map,14,25,269,10,5,3,19,223,8,1,5,23,2,-4,6,7,7
68,lak110d.map,14,25,80,3,19,10,5,346,13,3,0,21,-10,-16,26,27,38
69,lak110d.map,14,25,283,11,16,2,8,111,4,13,9,11,7,-3,10,11,11
70,lak110d.map,14,25,301,12,23,1,1,262,10,12,3,12,2,-11,13,14,14
71,lak110d.map,14,25,226,9,23,4,1,285,11,14,2,10,-2,-9,11,12,12
72,lak110d.map,14,25,220,8,4,5,20,38,1,11,12,13,7,7,14,27,18
73,lak110d.map,14,25,132,5,17,8,7,110,4,14,9,10,1,-3,4,5,5
74,lak110d.map,14,25,278,11,21,2,3,87,3,12,10,12,8,-9,17,18,20
75,lak110d.map,14,25,133,5,16,8,8,239,9,10,4,14,-4,-6,10,11,11
76,lak110d.map,14,25,136,5,13,8,11,246,9,3,4,21,-4,-10,14,15,26
77,lak110d.map,14,25,131,5,18,8,6,173,6,1,7,23,-1,-17,18,47,29
78,lak110d.map,14,25,245,9,4,4,20,231,9,18,4,6,0,14,14,15,15
79,lak110d.map,14,25,272,10,2,3,22,265,10,9,3,15,0,7,7,8,8
80,lak110d.map,14,25,292,11,7,2,17,223,8,1,5,23,3,-6,9,10,10
81,lak110d.map,14,25,298,11,1,2,23,38,1,11,12,13,10,10,20,64,24
82,lak110d.map,14,25,84,3,15,10,9,109,4,15,9,9,-1,0,1,2,2
83,lak110d.map,14,25,297,11,2,2,22,173,6,1,7,23,5,-1,6,7,7
84,lak110d.map,14,25,81,3,18,10,6,203,8,21,5,3,-5,3,8,11,9
85,lak110d.map,14,25,253,10,21,3,3,86,3,13,10,11,7,-8,15,16,18
86,lak110d.map,14,25,234,9,15,4,9,135,5,14,8,10,4,-1,5,6,6
87,lak110d.map,14,25,187,7,12,6,12,196,7,3,6,21,0,-9,9,14,13
88,lak110d.map,14,25,234,9,15,4,9,271,10,3,3,21,-1,-12,13,14,14
89,lak110d.map,14,25,217,8,7,5,17,259,10,15,3,9,-2,8,10,11,11
90,lak110d.map,14,25,38,1,11,12,13,270,10,4,3,20,-9,-7,16,20,43
91,lak110d.map,14,25,322,12,2,1,22,157,6,17,7,7,6,15,21,34,22
92,lak110d.map,14,25,136,5,13,8,11,243,9,6,4,18,-4,-7,11,12,18
93,lak110d.map,14,25,256,10,18,3,6,193,7,6,6,18,3,-12,15,23,16
94,lak110d.map,14,25,216,8,8,5,16,281,11,18,2,6,-3,10,13,14,14
95,lak110d.map,14,25,265,10,9,3,15,347,13,2,0,22,-3,-7,10,11,11
96,lak110d.map,14,25,105,4,19,9,5,219,8,5,5,19,-4,-14,18,19,27
97,lak110d.map,14,25,187,7,12,6,12,228,9,21,4,3,-2,9,11,12,12
98,lak110d.map,14,25,185,7,14,6,10,135,5,14,8,10,2,0,2,3,3
99,lak110d.map,14,25,201,8,23,5,1,231,9,18,4,6,-1,-5,6,7,7
0,lak200d.map,163,140,937,6,42,156,97,21631,154,68,8,71,-148,26,174,175,181
1,lak200d.map,163,140,11409,81,70,81,69,17426,124,73,38,66,-43,3,46,47,47
2,lak200d.map,163,140,8881,63,78,99,61,9863,70,76,92,63,-7,-2,9,10,10
3,lak200d.map,163,140,1984,14,115,148,24,4786,34,113,128,26,-20,-2,22,1199,1724
4,lak200d.map,163,140,5813,41,66,121,73,5462,39,137,123,2,2,71,73,3249,534
5,lak200d.map,163,140,5187,37,132,125,7,2987,21,92,141,47,16,-40,56,1462,2890
6,lak200d.map,163,140,3521,25,118,137,21,16874,120,65,42,74,-95,-53,148,545,4955
7,lak200d.map,163,140,1008,7,111,155,28,1479,10,60,152,79,-3,-51,54,55,98
8,lak200d.map,163,140,8151,58,108,104,31,15335,109,64,53,75,-51,-44,95,96,96
9,lak200d.map,163,140,5404,38,55,124,84,9870,70,69,92,70,-32,14,46,53,516
10,lak200d.map,163,140,1336,9,63,153,76,8090,57,29,105,110,-48,-34,82,310,386
11,lak200d.map,163,140,18267,130,72,32,67,8091,57,28,105,111,73,-44,117,118,118
12,lak200d.map,163,140,7104,50,35,112,104,9848,70,91,92,48,-20,56,76,77,77
13,lak200d.map,163,140,3956,28,103,134,36,9460,67,59,95,80,-39,-44,83,108,477
14,lak200d.map,163,140,17842,127,77,35,62,5650,40,89,122,50,87,12,99,264,768
15,lak200d.map,163,140,5594,39,5,123,134,5115,36,64,126,75,3,59,62,741,2210
16,lak200d.map,163,140,20924,149,75,13,64,17837,127,82,35,57,22,7,29,30,30
17,lak200d.map,163,140,4960,35,79,127,60,4468,31,11,131,128,4,-68,72,2085,607
18,lak200d.map,163,140,2706,19,93,143,46,9294,66,85,96,54,-47,-8,55,94,56
19,lak200d.map,163,140,5950,42,69,120,70,3199,22,20,140,119,20,-49,69,1768,412
20,lak200d.map,163,140,4275,30,64,132,75,4614,32,5,130,134,-2,-59,61,1394,590
21,lak200d.map,163,140,3139,22,80,140,59,2166,15,73,147,66,7,-7,14,15,15
22,lak200d.map,163,140,5704,40,35,122,104,4804,34,95,128,44,6,60,66,606,519
23,lak200d.map,163,140,20926,149,73,13,66,17150,122,69,40,70,27,-4,31,32,32
24,lak200d.map,163,140,7745,55,94,107,45,5606,40,133,122,6,15,39,54,3385,758
25,lak200d.map,163,140,1369,9,30,153,109,4812,34,87,128,52,-25,57,82,1569,422
26,lak200d.map,163,140,5033,35,6,127,133,9178,65,61,97,78,-30,55,85,772,2983
27,lak200d.map,163,140,7537,53,22,109,117,4239,30,100,132,39,23,78,101,828,122
28,lak200d.map,163,140,13084,93,75,69,64,7917,56,62,106,77,37,-13,50,51,51
29,lak200d.map,163,140,3993,28,66,134,73,7890,56,89,106,50,-28,23,51,63,138
30,lak200d.map,163,140,4040,28,19,134,120,19393,138,66,24,73,-110,47,157,841,4530
31,lak200d.map,163,140,186,1,93,161,46,10118,72,101,90,38,-71,8,79,435,1599
32,lak200d.map,163,140,5493,39,106,123,33,21071,150,68,12,71,-111,-38,149,152,256
33,lak200d.map,163,140,7363,52,56,110,83,9167,65,72,97,67,-13,16,29,30,30
34,lak200d.map,163,140,19665,140,74,22,65,18827,134,72,28,67,6,-2,8,9,9
35,lak200d.map,163,140,16867,120,72,42,67,4925,35,114,127,25,85,42,127,242,138
36,lak200d.map,163,140,4961,35,78,127,61,3596,25,43,137,96,10,-35,45,1083,254
37,lak200d.map,163,140,6296,44,3,118,136,9847,70,92,92,47,-26,89,115,884,5376
38,lak200d.map,163,140,9320,66,59,96,80,2178,15,61,147,78,51,2,53,54,98
39,lak200d.map,163,140,5185,37,134,125,5,22335,159,64,3,75,-122,-70,192,654,5821
40,lak200d.map,163,140,16457,117,62,45,77,13927,99,72,63,67,18,10,28,29,29
41,lak200d.map,163,140,8571,61,108,101,31,3172,22,47,140,92,39,-61,100,2158,163
42,lak200d.map,163,140,10577,75,62,87,77,10123,72,96,90,43,3,34,37,38,38
43,lak200d.map,163,140,9235,65,4,97,135,5763,41,116,121,23,24,112,136,2271,5368
44,lak200d.map,163,140,2968,21,111,141,28,15757,112,62,50,77,-91,-49,140,375,4672
45,lak200d.map,163,140,2010,14,89,148,50,8931,63,28,99,111,-49,-61,110,222,2482
46,lak200d.map,163,140,9984,71,95,91,44,7583,54,116,108,23,17,21,38,39,39
47,lak200d.map,163,140,10576,75,63,87,76,15463,110,76,52,63,-35,13,48,70,49
48,lak200d.map,163,140,6080,43,79,119,60,3318,23,41,139,98,20,-38,58,938,237
49,lak200d.map,163,140,6193,44,106,118,33,11698,83,61,79,78,-39,-45,84,90,288
50,lak200d.map,163,140,6906,49,93,113,46,5675,40,64,122,75,9,-29,38,93,39
51,lak200d.map,163,140,1189,8,70,154,69,3711,26,68,136,71,-18,-2,20,21,21
52,lak200d.map,163,140,17979,128,80,34,59,5902,42,117,120,22,86,37,123,297,1761
53,lak200d.map,163,140,3265,23,94,139,45,8045,57,74,105,65,-34,-20,54,89,241
54,lak200d.map,163,140,5600,40,139,122,0,2212,15,27,147,112,25,-112,137,544,310
55,lak200d.map,163,140,602,4,97,158,42,3963,28,96,134,43,-24,-1,25,1223,972
56,lak200d.map,163,140,8342,59,57,103,82,8318,59,81,103,58,0,24,24,25,25
57,lak200d.map,163,140,8532,60,7,102,132,5094,36,85,126,54,24,78,102,2061,5279
58,lak200d.map,163,140,21488,153,71,9,68,9137,65,102,97,37,88,31,119,120,120
59,lak200d.map,163,140,3009,21,70,141,69,12794,91,85,71,54,-70,15,85,104,89
60,lak200d.map,163,140,2450,17,69,145,70,1927,13,32,149,107,4,-37,41,207,96
61,lak200d.map,163,140,10437,74,62,88,77,6231,44,68,118,71,30,6,36,37,37
62,lak200d.map,163,140,4420,31,59,131,80,3741,26,38,136,101,5,-21,26,914,271
63,lak200d.map,163,140,3439,24,60,138,79,8887,63,72,99,67,-39,12,51,52,52
64,lak200d.map,163,140,16308,116,71,46,68,8591,61,88,101,51,55,17,72,73,73
65,lak200d.map,163,140,11395,81,84,81,55,7079,50,60,112,79,31,-24,55,56,56
66,lak200d.map,163,140,4406,31,73,131,66,12671,90,68,72,71,-59,-5,64,65,65
67,lak200d.map,163,140,3249,23,110,139,29,8179,58,80,104,59,-35,-30,65,291,2377
68,lak200d.map,163,140,2355,16,24,146,115,10019,71,60,91,79,-55,36,91,408,1868
69,lak200d.map,163,140,12368,88,91,74,48,10542,75,97,87,42,13,6,19,20,20
70,lak200d.map,163,140,3968,28,91,134,48,10971,78,88,84,51,-50,-3,53,54,54
71,lak200d.map,163,140,3160,22,59,140,80,7212,51,67,111,72,-29,8,37,38,38
72,lak200d.map,163,140,7500,53,59,109,80,7391,52,28,110,111,1,-31,32,33,33
73,lak200d.map,163,140,5360,38,99,124,40,18413,131,66,31,73,-93,-33,126,131,265
74,lak200d.map,163,140,19948,142,71,20,68,9541,68,118,94,21,74,47,121,122,122
75,lak200d.map,163,140,8195,58,64,104,75,5791,41,88,121,51,17,24,41,146,42
76,lak200d.map,163,140,17282,123,77,39,62,19246,137,73,25,66,-14,-4,18,19,19
77,lak200d.map,163,140,6969,49,30,113,109,5393,38,66,124,73,11,36,47,282,50
78,lak200d.map,163,140,22331,159,68,3,71,7484,53,75,109,64,106,7,113,114,114
79,lak200d.map,163,140,6512,46,67,116,72,13236,94,63,68,76,-48,-4,52,53,53
80,lak200d.map,163,140,18134,129,65,33,74,6831,48,28,114,111,81,-37,118,119,119
81,lak200d.map,163,140,9042,64,57,98,82,7692,54,7,108,132,10,-50,60,4015,945
82,lak200d.map,163,140,6209,44,90,118,49,18554,132,65,30,74,-88,-25,113,114,164
83,lak200d.map,163,140,5569,39,30,123,109,1298,9,101,153,38,30,71,101,496,1663
84,lak200d.map,163,140,4128,29,71,133,68,5600,40,139,122,0,-11,68,79,2159,517
85,lak200d.map,163,140,6788,48,71,114,68,8639,61,40,101,99,-13,-31,44,45,45
86,lak200d.map,163,140,19666,140,73,22,66,18130,129,69,33,70,11,-4,15,16,16
87,lak200d.map,163,140,15187,108,72,54,67,8779,62,40,100,99,46,-32,78,79,79
88,lak200d.map,163,140,16875,120,64,42,75,1909,13,50,149,89,107,-14,121,993,137
89,lak200d.map,163,140,6963,49,36,113,103,2749,19,50,143,89,30,14,44,377,188
90,lak200d.map,163,140,9860,70,79,92,60,2727,19,72,143,67,51,-7,58,59,59
91,lak200d.map,163,140,766,5,73,157,66,5455,38,4,124,135,-33,-69,102,104,134
92,lak200d.map,163,140,18421,131,58,31,81,11269,80,70,82,69,51,12,63,64,141
93,lak200d.map,163,140,12651,90,88,72,51,3741,26,38,136,101,64,-50,114,2585,166
94,lak200d.map,163,140,8817,62,2,100,137,4740,33,19,129,120,29,17,46,337,50
95,lak200d.map,163,140,11531,82,88,80,51,4101,29,98,133,41,53,10,63,64,64
96,lak200d.map,163,140,2210,15,29,147,110,9127,65,112,97,27,-50,83,133,465,4063
97,lak200d.map,163,140,6964,49,35,113,104,11693,83,66,79,73,-34,31,65,66,66
98,lak200d.map,163,140,8985,64,114,98,25,12370,88,89,74,50,-24,-25,49,50,50
99,lak200d.map,163,140,5321,38,138,124,1,1883,13,76,149,63,25,-62,87,442,411
0,lak201d.map,158,250,26670,106,79,51,170,18254,73,245,84,4,33,166,199,869,212
1,lak201d.map,158,250,20771,83,228,74,21,30047,120,202,37,47,-37,-26,63,288,64
2,lak201d.map,158,250,8224,32,25,125,224,15671,62,78,95,171,-30,53,83,84,202
3,lak201d.map,158,250,19046,76,203,81,46,5231,20,18,137,231,56,-185,241,5254,5294
4,lak201d.map,158,250,25677,102,72,55,177,3423,13,76,144,173,89,4,93,123,372
5,lak201d.map,158,250,30057,120,192,37,57,26706,106,43,51,206,14,-149,163,377,472
6,lak201d.map,158,250,12096,48,153,109,96,7597,30,152,127,97,18,-1,19,20,20
7,lak201d.map,158,250,8620,34,129,123,120,2622,10,127,147,122,24,-2,26,291,186
8,lak201d.map,158,250,9388,37,111,120,138,11862,47,137,110,112,-10,26,36,37,37
9,lak201d.map,158,250,9484,37,15,120,234,8597,34,152,123,97,3,137,140,539,251
10,lak201d.map,158,250,27313,109,186,48,63,24247,96,2,61,247,13,-184,197,2711,1003
11,lak201d.map,158,250,38280,153,219,4,30,22994,91,5,66,244,62,-214,276,4252,1124
12,lak201d.map,158,250,9225,36,24,121,225,15924,63,75,94,174,-27,51,78,535,156
13,lak201d.map,158,250,32868,131,131,26,118,25038,100,211,57,38,31,80,111,2194,4628
14,lak201d.map,158,250,6636,26,113,131,136,24679,98,70,59,179,-72,-43,115,266,271
15,lak201d.map,158,250,24283,97,216,60,33,25508,102,241,55,8,-5,25,30,31,31
16,lak201d.map,158,250,28540,114,209,43,40,18981,75,18,82,231,39,-191,230,2046,1493
17,lak201d.map,158,250,23769,95,230,62,19,25348,101,151,56,98,-6,-79,85,861,601
18,lak201d.map,158,250,32385,129,114,28,135,8398,33,101,124,148,96,-13,109,1722,2360
19,lak201d.map,158,250,27033,108,216,49,33,32899,131,100,26,149,-23,-116,139,1342,1666
20,lak201d.map,158,250,26283,105,216,52,33,27021,108,228,49,21,-3,12,15,33,29
21,lak201d.map,158,250,26634,106,115,51,134,9374,37,125,120,124,69,10,79,1694,2920
22,lak201d.map,158,250,12634,50,115,107,134,28892,115,107,42,142,-65,-8,73,2395,2783
23,lak201d.map,158,250,22753,91,246,66,3,25490,101,9,56,240,-10,-237,247,5509,2617
24,lak201d.map,158,250,11672,46,77,111,172,10920,43,79,114,170,3,2,5,6,6
25,lak201d.map,158,250,19212,76,37,81,212,12223,48,26,109,223,28,-11,39,1510,1286
26,lak201d.map,158,250,31449,125,50,32,199,18030,72,219,85,30,53,169,222,1338,249
27,lak201d.map,158,250,8970,35,29,122,220,10918,43,81,114,168,-8,52,60,61,144
28,lak201d.map,158,250,22680,90,69,67,180,37323,149,176,8,73,-59,107,166,2093,945
29,lak201d.map,158,250,14416,57,83,100,166,9619,38,130,119,119,19,47,66,93,911
30,lak201d.map,158,250,35074,140,175,17,74,13102,52,147,105,102,88,-28,116,7219,5125
31,lak201d.map,158,250,3918,15,81,142,168,30063,120,186,37,63,-105,105,210,2858,1942
32,lak201d.map,158,250,26076,104,173,53,76,30549,122,200,35,49,-18,27,45,53,54
33,lak201d.map,158,250,20554,82,195,75,54,20932,83,67,74,182,-1,-128,129,1311,1414
34,lak201d.map,158,250,4121,16,128,141,121,19468,77,31,80,218,-61,-97,158,1441,553
35,lak201d.map,158,250,25017,100,232,57,17,24853,99,146,58,103,1,-86,87,1108,729
36,lak201d.map,158,250,30570,122,179,35,70,25542,102,207,55,42,20,28,48,616,175
37,lak201d.map,158,250,36825,147,174,10,75,7099,28,150,129,99,119,-24,143,6372,5352
38,lak201d.map,158,250,25136,100,113,57,136,11715,46,34,111,215,54,-79,133,2238,1898
39,lak201d.map,158,250,25756,103,243,54,6,22214,88,35,69,214,15,-208,223,4475,2660
40,lak201d.map,158,250,20980,83,19,74,230,20741,82,8,75,241,1,-11,12,29,35
41,lak201d.map,158,250,30284,121,215,36,34,35790,143,209,14,40,-22,-6,28,44,29
42,lak201d.map,158,250,20200,80,49,77,200,24141,96,108,61,141,-16,59,75,673,197
43,lak201d.map,158,250,25890,103,109,54,140,875,3,124,154,125,100,15,115,1980,2689
44,lak201d.map,158,250,22024,88,225,69,24,21166,84,83,73,166,4,-142,146,3351,1311
45,lak201d.map,158,250,23890,95,109,62,140,2431,9,68,148,181,86,-41,127,817,2424
46,lak201d.map,158,250,23497,93,2,64,247,26107,104,142,53,107,-11,140,151,906,1814
47,lak201d.map,158,250,31952,127,47,30,202,34858,139,141,18,108,-12,94,106,697,1065
48,lak201d.map,158,250,33544,134,205,23,44,25299,101,200,56,49,33,-5,38,129,265
49,lak201d.map,158,250,26052,104,197,53,52,8143,32,106,125,143,72,-91,163,4406,5230
50,lak201d.map,158,250,10692,42,57,115,192,4981,19,18,138,231,23,-39,62,585,155
51,lak201d.map,158,250,36778,147,221,10,28,28966,115,33,42,216,32,-188,220,1511,734
52,lak201d.map,158,250,26705,106,44,51,205,25093,100,156,57,93,6,112,118,305,119
53,lak201d.map,158,250,25906,103,93,54,156,19179,76,70,81,179,27,-23,50,59,295
54,lak201d.map,158,250,29692,118,57,39,192,36532,146,217,11,32,-28,160,188,629,2325
55,lak201d.map,158,250,29214,116,35,41,214,11127,44,122,113,127,72,87,159,1866,1096
56,lak201d.map,158,250,37577,150,172,7,77,9732,38,17,119,232,112,-155,267,3102,5930
57,lak201d.map,158,250,36830,147,169,10,80,10638,42,111,115,138,105,-58,163,4612,5731
58,lak201d.map,158,250,21552,86,197,71,52,25186,100,63,57,186,-14,-134,148,548,991
59,lak201d.map,158,250,38072,152,177,5,72,25579,102,170,55,79,50,-7,57,236,147
60,lak201d.map,158,250,27712,110,37,47,212,36819,147,180,10,69,-37,143,180,639,642
61,lak201d.map,158,250,29033,116,216,41,33,34074,136,175,21,74,-20,-41,61,91,62
62,lak201d.map,158,250,19968,79,31,78,218,24369,97,130,60,119,-18,99,117,949,407
63,lak201d.map,158,250,21538,86,211,71,38,34394,137,105,20,144,-51,-106,157,1975,1205
64,lak201d.map,158,250,25497,101,2,56,247,35365,141,134,16,115,-40,132,172,1209,2542
65,lak201d.map,158,250,11924,47,75,110,174,21910,87,89,70,160,-40,14,54,166,57
66,lak201d.map,158,250,37280,149,219,8,30,19781,79,218,78,31,70,-1,71,224,310
67,lak201d.map,158,250,35368,141,131,16,118,1162,4,87,153,162,137,-44,181,1610,2800
68,lak201d.map,158,250,9690,38,59,119,190,8475,33,24,124,225,5,-35,40,89,41
69,lak201d.map,158,250,19197,76,52,81,197,22751,91,248,66,1,-15,196,211,1836,2784
70,lak201d.map,158,250,27002,108,247,49,2,12844,51,155,106,94,57,-92,149,7186,5403
71,lak201d.map,158,250,36534,146,215,11,34,22286,89,213,68,36,57,-2,59,60,94
72,lak201d.map,158,250,3884,15,115,142,134,9223,36,26,121,223,-21,-89,110,440,764
73,lak201d.map,158,250,8641,34,108,123,141,32452,129,47,28,202,-95,-61,156,691,226
74,lak201d.map,158,250,24955,99,44,58,205,22383,89,116,68,133,10,72,82,390,221
75,lak201d.map,158,250,21312,85,187,72,62,34138,136,111,21,138,-51,-76,127,1709,1303
76,lak201d.map,158,250,7864,31,135,126,114,25503,102,246,55,3,-71,111,182,5166,5868
77,lak201d.map,158,250,9165,36,84,121,165,23781,95,218,62,31,-59,134,193,4649,3647
78,lak201d.map,158,250,28411,113,88,44,161,10399,41,100,116,149,72,12,84,1207,1327
79,lak201d.map,158,250,9467,37,32,120,217,22678,90,71,67,178,-53,39,92,673,727
80,lak201d.map,158,250,12653,50,96,107,153,21926,87,73,70,176,-37,-23,60,217,835
81,lak201d.map,158,250,38281,153,218,4,31,22310,89,189,68,60,64,-29,93,94,207
82,lak201d.map,158,250,14352,57,147,100,102,8881,35,118,122,131,22,-29,51,65,52
83,lak201d.map,158,250,7971,31,28,126,221,22062,88,187,69,62,-57,159,216,4586,2915
84,lak201d.map,158,250,19772,79,227,78,22,19967,79,32,78,217,0,-195,195,2407,2073
85,lak201d.map,158,250,19712,78,37,79,212,23243,92,6,65,243,-14,-31,45,46,104
86,lak201d.map,158,250,22570,90,179,67,70,25205,100,44,57,205,-10,-135,145,332,941
87,lak201d.map,158,250,23788,95,211,62,38,15167,60,82,97,167,35,-129,164,3161,2285
88,lak201d.map,158,250,23256,93,243,64,6,19197,76,52,81,197,17,-191,208,2812,2065
89,lak201d.map,158,250,26323,105,176,52,73,29215,116,34,41,215,-11,-142,153,181,264
90,lak201d.map,158,250,24330,97,169,60,80,19942,79,57,78,192,18,-112,130,687,886
91,lak201d.map,158,250,7225,28,24,129,225,33895,135,104,22,145,-107,80,187,1852,1998
92,lak201d.map,158,250,6480,25,19,132,230,25820,103,179,54,70,-78,160,238,3080,4160
93,lak201d.map,158,250,10620,42,129,115,120,8383,33,116,124,133,9,-13,22,23,23
94,lak201d.map,158,250,29037,116,212,41,37,30446,121,53,36,196,-5,-159,164,849,513
95,lak201d.map,158,250,8355,33,144,124,105,24629,98,120,59,129,-65,-24,89,3229,2386
96,lak201d.map,158,250,35308,141,191,16,58,33381,133,118,24,131,8,-73,81,2243,1267
97,lak201d.map,158,250,9088,36,161,121,88,4983,19,16,138,233,17,-145,162,1832,491
98,lak201d.map,158,250,25656,102,93,55,156,32646,130,103,27,146,-28,10,38,61,39
99,lak201d.map,158,250,25208,100,41,57,208,33141,132,108,25,141,-32,67,99,207,112
0,lak202d.map,177,155,15746,101,63,75,91,27269,175,10,1,144,-74,-53,127,1028,2809
1,lak202d.map,177,155,1898,12,116,164,38,10587,68,107,108,47,-56,-9,65,1411,906
2,lak202d.map,177,155,14240,91,19,85,135,10273,66,111,110,43,25,92,117,1827,1799
3,lak202d.map,177,155,17487,112,27,64,127,9471,61,138,115,16,51,111,162,3474,3384
4,lak202d.map,177,155,9850,63,69,113,85,11670,75,109,101,45,-12,40,52,210,309
5,lak202d.map,177,155,24316,156,18,20,136,10293,66,91,110,63,90,73,163,1835,1772
6,lak202d.map,177,155,10100,65,129,111,25,11517,74,107,102,47,-9,-22,31,1134,1499
7,lak202d.map,177,155,4995,32,119,144,35,9358,60,96,116,58,-28,-23,51,52,86
8,lak202d.map,177,155,13385,86,99,90,55,1433,9,116,167,38,77,17,94,1009,582
9,lak202d.map,177,155,9698,62,66,114,88,18734,120,20,56,134,-58,-46,104,1143,1119
10,lak202d.map,177,155,9369,60,85,116,69,10013,64,61,112,93,-4,-24,28,29,29
11,lak202d.map,177,155,9573,61,36,115,118,7333,47,106,129,48,14,70,84,676,121
12,lak202d.map,177,155,14866,95,13,81,141,19172,123,47,53,107,-28,34,62,73,192
13,lak202d.map,177,155,8946,57,43,119,111,14348,92,66,84,88,-35,23,58,259,203
14,lak202d.map,177,155,7963,51,96,125,58,22158,142,6,34,148,-91,-90,181,569,534
15,lak202d.map,177,155,17974,115,5,61,149,10215,65,14,111,140,50,9,59,60,119
16,lak202d.map,177,155,21220,136,14,40,140,9748,62,16,114,138,74,2,76,77,77
17,lak202d.map,177,155,19024,122,40,54,114,16226,104,48,72,106,18,8,26,32,28
18,lak202d.map,177,155,9116,58,28,118,126,13253,85,76,91,78,-27,48,75,157,76
19,lak202d.map,177,155,9324,60,130,116,24,16207,104,67,72,87,-44,-63,107,710,2361
20,lak202d.map,177,155,11995,77,94,99,60,9391,60,63,116,91,17,-31,48,49,49
21,lak202d.map,177,155,7443,48,151,128,3,22310,143,9,33,145,-95,-142,237,1076,3237
22,lak202d.map,177,155,9785,63,134,113,20,1579,10,125,166,29,53,-9,62,257,475
23,lak202d.map,177,155,15112,97,77,79,77,12645,81,64,95,90,16,-13,29,30,30
24,lak202d.map,177,155,14625,94,99,82,55,15017,96,17,80,137,-2,-82,84,1564,1698
25,lak202d.map,177,155,11145,71,14,105,140,19030,122,34,54,120,-51,20,71,143,95
26,lak202d.map,177,155,2507,16,127,160,27,18103,116,31,60,123,-100,-96,196,3631,1386
27,lak202d.map,177,155,9467,61,142,115,12,11988,77,101,99,53,-16,-41,57,943,987
28,lak202d.map,177,155,15897,102,67,74,87,11996,77,93,99,61,25,26,51,738,464
29,lak202d.map,177,155,14032,90,72,86,82,14857,95,22,81,132,-5,-50,55,1425,1614
30,lak202d.map,177,155,1901,12,113,164,41,14550,93,19,83,135,-81,-94,175,2453,2197
31,lak202d.map,177,155,13081,84,93,92,61,14961,96,73,80,81,-12,-20,32,641,731
32,lak202d.map,177,155,14657,94,67,82,87,11609,74,15,102,139,20,-52,72,718,918
33,lak202d.map,177,155,12593,81,116,95,38,19652,126,32,50,122,-45,-84,129,2926,1772
34,lak202d.map,177,155,6416,41,93,135,61,8530,55,149,121,5,-14,56,70,314,340
35,lak202d.map,177,155,7523,48,71,128,83,24166,155,13,21,141,-107,-58,165,166,339
36,lak202d.map,177,155,25414,163,5,13,149,21838,140,16,36,138,23,11,34,35,75
37,lak202d.map,177,155,19028,122,36,54,118,7815,50,89,126,65,72,53,125,1648,2386
38,lak202d.map,177,155,17170,110,34,66,120,8636,55,43,121,111,55,9,64,793,1198
39,lak202d.map,177,155,23546,151,13,25,141,8655,55,24,121,130,96,11,107,108,108
40,lak202d.map,177,155,15945,102,19,74,135,9683,62,81,114,73,40,62,102,559,1288
41,lak202d.map,177,155,17340,111,19,65,135,8503,54,21,122,133,57,2,59,307,251
42,lak202d.map,177,155,5298,34,126,142,28,9910,63,9,113,145,-29,-117,146,165,621
43,lak202d.map,177,155,10278,66,106,110,48,24479,157,10,19,144,-91,-96,187,960,3421
44,lak202d.map,177,155,19675,126,9,50,145,9558,61,51,115,103,65,42,107,108,165
45,lak202d.map,177,155,7769,50,135,126,19,14506,93,63,83,91,-43,-72,115,697,1721
46,lak202d.map,177,155,12149,78,95,98,59,5126,33,143,143,11,45,48,93,151,94
47,lak202d.map,177,155,6547,42,117,134,37,18566,119,33,57,121,-77,-84,161,2771,1307
48,lak202d.map,177,155,9368,60,86,116,68,9776,63,143,113,11,-3,57,60,1084,657
49,lak202d.map,177,155,15897,102,67,74,87,24308,156,26,20,128,-54,-41,95,1995,2575
50,lak202d.map,177,155,18746,120,8,56,146,10397,67,142,109,12,53,134,187,3772,880
51,lak202d.map,177,155,8609,55,70,121,84,18893,121,16,55,138,-66,-54,120,1035,814
52,lak202d.map,177,155,17506,112,8,64,146,13559,87,80,89,74,25,72,97,1894,884
53,lak202d.map,177,155,17034,109,15,67,139,9314,60,140,116,14,49,125,174,3300,2254
54,lak202d.map,177,155,14080,90,24,86,130,7350,47,89,129,65,43,65,108,987,1986
55,lak202d.map,177,155,7995,51,64,125,90,7597,49,152,127,2,2,88,90,964,1061
56,lak202d.map,177,155,8773,56,61,120,93,22934,147,5,29,149,-91,-56,147,569,224
57,lak202d.map,177,155,15651,100,3,76,151,8540,55,139,121,15,45,136,181,2358,833
58,lak202d.map,177,155,8432,54,92,122,62,11530,74,94,102,60,-20,2,22,23,23
59,lak202d.map,177,155,17782,114,42,62,112,10991,70,13,106,141,44,-29,73,163,150
60,lak202d.map,177,155,1588,10,116,166,38,13254,85,75,91,79,-75,-41,116,1340,1273
61,lak202d.map,177,155,12699,81,10,95,144,6679,43,140,133,14,38,130,168,1351,571
62,lak202d.map,177,155,9474,61,135,115,19,7167,46,117,130,37,15,-18,33,357,201
63,lak202d.map,177,155,12075,77,14,99,140,10047,64,27,112,127,13,13,26,27,27
64,lak202d.map,177,155,10937,70,67,106,87,15283,98,61,78,93,-28,-6,34,44,145
65,lak202d.map,177,155,22924,147,15,29,139,17660,113,9,63,145,34,-6,40,41,58
66,lak202d.map,177,155,18744,120,10,56,144,25091,161,18,15,136,-41,8,49,87,50
67,lak202d.map,177,155,12793,82,71,94,83,10163,65,66,111,88,17,-5,22,23,31
68,lak202d.map,177,155,11026,71,133,105,21,18559,119,40,57,114,-48,-93,141,3708,4406
69,lak202d.map,177,155,14936,96,98,80,56,5595,36,139,140,15,60,41,101,391,698
70,lak202d.map,177,155,18720,120,34,56,120,18732,120,22,56,132,0,-12,12,47,51
71,lak202d.map,177,155,12960,83,59,93,95,1591,10,113,166,41,73,54,127,1457,407
72,lak202d.map,177,155,15583,100,71,76,83,26647,171,12,5,142,-71,-59,130,913,2471
73,lak202d.map,177,155,16420,105,9,71,145,19214,123,5,53,149,-18,-4,22,23,23
74,lak202d.map,177,155,26482,170,22,6,132,18707,120,47,56,107,50,25,75,686,627
75,lak202d.map,177,155,11456,73,13,103,141,8991,58,153,118,1,15,140,155,2095,758
76,lak202d.map,177,155,8947,57,42,119,112,14868,95,11,81,143,-38,-31,69,95,70
77,lak202d.map,177,155,10839,69,10,107,144,9855,63,64,113,90,6,54,60,264,134
78,lak202d.map,177,155,12072,77,17,99,137,15091,97,98,79,56,-20,81,101,878,543
79,lak202d.map,177,155,3901,25,128,151,26,11166,72,148,104,6,-47,20,67,163,663
80,lak202d.map,177,155,26954,173,15,3,139,24156,155,23,21,131,18,8,26,27,27
81,lak202d.map,177,155,14097,90,7,86,147,12638,81,71,95,83,9,64,73,928,863
82,lak202d.map,177,155,18243,117,46,59,108,14190,91,69,85,85,26,23,49,1890,2098
83,lak202d.map,177,155,9906,63,13,113,141,15642,100,12,76,142,-37,-1,38,39,39
84,lak202d.map,177,155,10682,68,12,108,142,805,5,124,171,30,63,112,175,635,368
85,lak202d.map,177,155,23857,153,12,23,142,15588,100,66,76,88,53,54,107,2642,877
86,lak202d.map,177,155,18400,118,44,58,110,12152,78,92,98,62,40,48,88,1716,2563
87,lak202d.map,177,155,5929,38,115,138,39,9718,62,46,114,108,-24,-69,93,112,390
88,lak202d.map,177,155,9956,64,118,112,36,7684,49,65,127,89,15,-53,68,300,855
89,lak202d.map,177,155,2677,17,112,159,42,15797,101,12,75,142,-84,-100,184,309,2382
90,lak202d.map,177,155,14938,96,96,80,58,9903,63,16,113,138,33,-80,113,390,462
91,lak202d.map,177,155,17012,109,37,67,117,23079,148,15,28,139,-39,-22,61,309,226
92,lak202d.map,177,155,9472,61,137,115,17,4833,31,126,145,28,30,-11,41,187,161
93,lak202d.map,177,155,23698,152,16,24,138,9887,63,32,113,122,89,16,105,245,314
94,lak202d.map,177,155,18588,119,11,57,143,10991,70,13,106,141,49,2,51,52,136
95,lak202d.map,177,155,16391,105,38,71,116,15799,101,10,75,144,4,-28,32,117,425
96,lak202d.map,177,155,8388,54,136,122,18,6700,43,119,133,35,11,-17,28,161,126
97,lak202d.map,177,155,7345,47,94,129,60,9718,62,46,114,108,-15,-48,63,74,311
98,lak202d.map,177,155,8227,53,142,123,12,8071,52,143,124,11,1,1,2,3,3
99,lak202d.map,177,155,5597,36,137,140,17,9317,60,137,116,17,-24,0,24,43,57
0,lak203d.map,84,112,3086,27,49,56,62,2399,21,64,62,47,6,15,21,22,22
1,lak203d.map,84,112,4682,41,21,42,90,6524,58,83,25,28,-17,62,79,80,174
2,lak203d.map,84,112,4489,40,102,43,9,5053,45,98,38,13,-5,-4,9,10,10
3,lak203d.map,84,112,1267,11,76,72,35,5157,46,106,37,5,-35,30,65,991,2339
4,lak203d.map,84,112,5369,47,6,36,105,4746,42,69,41,42,5,63,68,94,69
5,lak203d.map,84,112,4849,43,78,40,33,4780,42,35,41,76,1,-43,44,45,45
6,lak203d.map,84,112,5490,49,109,34,2,4714,42,101,41,10,7,-8,15,16,16
7,lak203d.map,84,112,1625,14,54,69,57,5012,44,27,39,84,-30,-27,57,133,102
8,lak203d.map,84,112,4744,42,71,41,40,1285,11,58,72,53,31,-13,44,612,916
9,lak203d.map,84,112,4904,43,23,40,88,8403,75,108,8,3,-32,85,117,393,148
10,lak203d.map,84,112,7531,67,84,16,27,6507,58,100,25,11,9,16,25,26,26
11,lak203d.map,84,112,1610,14,69,69,42,5582,49,17,34,94,-35,-52,87,267,1542
12,lak203d.map,84,112,6619,59,100,24,11,6069,54,90,29,21,5,-10,15,22,16
13,lak203d.map,84,112,9316,83,91,0,20,2199,19,40,64,71,64,-51,115,194,453
14,lak203d.map,84,112,4564,40,27,43,84,9206,82,89,1,22,-42,62,104,106,263
15,lak203d.map,84,112,4229,37,26,46,85,3639,32,56,51,55,5,30,35,103,177
16,lak203d.map,84,112,7841,70,110,13,1,4522,40,69,43,42,30,-41,71,138,952
17,lak203d.map,84,112,5113,45,38,38,73,4701,41,2,42,109,4,-36,40,51,41
18,lak203d.map,84,112,5704,50,7,33,104,397,3,50,80,61,47,43,90,211,225
19,lak203d.map,84,112,5498,49,101,34,10,4326,38,41,45,70,11,-60,71,142,72
20,lak203d.map,84,112,4828,43,99,40,12,5093,45,58,38,53,-2,-41,43,44,44
21,lak203d.map,84,112,4454,39,25,44,86,2974,26,49,57,62,13,24,37,87,178
22,lak203d.map,84,112,8634,77,101,6,10,4614,41,89,42,22,36,-12,48,61,213
23,lak203d.map,84,112,4329,38,38,45,73,4843,43,84,40,27,-5,46,51,52,63
24,lak203d.map,84,112,617,5,54,78,57,5057,45,94,38,17,-40,40,80,984,992
25,lak203d.map,84,112,1045,9,74,74,37,5655,50,56,33,55,-41,-18,59,937,1311
26,lak203d.map,84,112,5473,48,14,35,97,7303,65,88,18,23,-17,74,91,195,302
27,lak203d.map,84,112,5134,45,17,38,94,8871,79,88,4,23,-34,71,105,179,292
28,lak203d.map,84,112,953,8,54,75,57,9186,82,109,1,2,-74,55,129,1317,1647
29,lak203d.map,84,112,4338,38,29,45,82,1642,14,37,69,74,24,8,32,131,282
30,lak203d.map,84,112,2168,19,71,64,40,9316,83,91,0,20,-64,20,84,854,1768
31,lak203d.map,84,112,1863,16,40,67,71,8743,78,104,5,7,-62,64,126,740,229
32,lak203d.map,84,112,624,5,47,78,64,594,5,77,78,34,0,30,30,34,34
33,lak203d.map,84,112,2408,21,55,62,56,4493,40,98,43,13,-19,43,62,1008,988
34,lak203d.map,84,112,841,7,54,76,57,5325,47,50,36,61,-40,-4,44,612,362
35,lak203d.map,84,112,7416,66,87,17,24,4947,44,92,39,19,22,5,27,28,28
36,lak203d.map,84,112,5340,47,35,36,76,4870,43,57,40,54,4,22,26,27,27
37,lak203d.map,84,112,5185,46,78,37,33,5309,47,66,36,45,-1,-12,13,14,14
38,lak203d.map,84,112,3849,34,70,49,41,5109,45,42,38,69,-11,-28,39,42,260
39,lak203d.map,84,112,8535,76,88,7,23,4983,44,56,39,55,32,-32,64,65,65
40,lak203d.map,84,112,6848,61,95,22,16,835,7,60,76,51,54,-35,89,1545,1008
41,lak203d.map,84,112,5497,49,102,34,9,967,8,40,75,71,41,-62,103,230,685
42,lak203d.map,84,112,7080,63,87,20,24,5150,45,1,38,110,18,-86,104,202,253
43,lak203d.map,84,112,1523,13,44,70,67,6407,57,88,26,23,-44,44,88,621,665
44,lak203d.map,84,112,4322,38,45,45,66,405,3,42,80,69,35,-3,38,51,179
45,lak203d.map,84,112,5152,46,111,37,0,5685,50,26,33,85,-4,-85,89,265,115
46,lak203d.map,84,112,722,6,61,77,50,2396,21,67,62,44,-15,6,21,56,23
47,lak203d.map,84,112,9096,81,87,2,24,2307,20,44,63,67,61,-43,104,816,513
48,lak203d.map,84,112,5990,53,57,30,54,622,5,49,78,62,48,-8,56,384,701
49,lak203d.map,84,112,2617,23,70,60,41,7747,69,92,14,19,-46,22,68,766,1757
50,lak203d.map,84,112,1299,11,44,72,67,8639,77,96,6,15,-66,52,118,740,1039
51,lak203d.map,84,112,2865,25,46,58,65,5938,53,109,30,2,-28,63,91,1376,957
52,lak203d.map,84,112,5944,53,103,30,8,5513,49,86,34,25,4,-17,21,41,153
53,lak203d.map,84,112,6964,62,91,21,20,1303,11,40,72,71,51,-51,102,181,617
54,lak203d.map,84,112,1406,12,49,71,62,7183,64,96,19,15,-52,47,99,922,1158
55,lak203d.map,84,112,5298,47,77,36,34,4938,44,101,39,10,3,24,27,28,28
56,lak203d.map,84,112,8969,80,102,3,9,9084,81,99,2,12,-1,-3,4,5,5
57,lak203d.map,84,112,4731,42,84,41,27,6188,55,83,28,28,-13,-1,14,15,15
58,lak203d.map,84,112,5104,45,47,38,64,6274,56,109,27,2,-11,62,73,366,241
59,lak203d.map,84,112,6297,56,86,27,25,847,7,48,76,63,49,-38,87,808,981
60,lak203d.map,84,112,4210,37,45,46,66,1844,16,59,67,52,21,14,35,192,412
61,lak203d.map,84,112,7194,64,85,19,26,2405,21,58,62,53,43,-27,70,1240,781
62,lak203d.map,84,112,3411,30,60,53,51,5797,51,26,32,85,-21,-34,55,99,642
63,lak203d.map,84,112,1736,15,55,68,56,8871,79,88,4,23,-64,33,97,904,1412
64,lak203d.map,84,112,2648,23,39,60,72,5460,48,27,35,84,-25,-12,37,63,109
65,lak203d.map,84,112,5443,48,44,35,67,8974,80,97,3,14,-32,53,85,357,602
66,lak203d.map,84,112,4968,44,71,39,40,4965,44,74,39,37,0,3,3,4,4
67,lak203d.map,84,112,5627,50,84,33,27,2205,19,34,64,77,31,-50,81,139,419
68,lak203d.map,84,112,4714,42,101,41,10,5751,51,72,32,39,-9,-29,38,39,46
69,lak203d.map,84,112,2081,18,46,65,65,2750,24,49,59,62,-6,3,9,10,10
70,lak203d.map,84,112,504,4,55,79,56,9077,81,106,2,5,-77,51,128,1273,1674
71,lak203d.map,84,112,4896,43,31,40,80,5073,45,78,38,33,-2,47,49,50,50
72,lak203d.map,84,112,1377,12,78,71,33,1965,17,50,66,61,-5,-28,33,122,305
73,lak203d.map,84,112,6507,58,100,25,11,2071,18,56,65,55,40,-44,84,1372,892
74,lak203d.map,84,112,8986,80,85,3,26,939,8,68,75,43,72,-17,89,2237,1004
75,lak203d.map,84,112,5136,45,15,38,96,713,6,70,77,41,39,55,94,188,222
76,lak203d.map,84,112,5287,47,88,36,23,8535,76,88,7,23,-29,0,29,30,30
77,lak203d.map,84,112,4851,43,76,40,35,4087,36,56,47,55,7,-20,27,38,28
78,lak203d.map,84,112,5146,45,5,38,106,6734,60,97,23,14,-15,92,107,268,301
79,lak203d.map,84,112,1066,9,53,74,58,5270,47,105,36,6,-38,52,90,976,1053
80,lak203d.map,84,112,7953,71,110,12,1,5109,45,42,38,69,26,-68,94,448,1060
81,lak203d.map,84,112,4729,42,86,41,25,6971,62,84,21,27,-20,-2,22,23,23
82,lak203d.map,84,112,7840,70,111,13,0,1197,10,34,73,77,60,-77,137,251,2113
83,lak203d.map,84,112,5137,45,14,38,97,2983,26,40,57,71,19,26,45,144,63
84,lak203d.map,84,112,5332,47,43,36,68,3622,32,73,51,38,15,30,45,74,49
85,lak203d.map,84,112,5137,45,14,38,97,5220,46,43,37,68,-1,29,30,52,42
86,lak203d.map,84,112,7417,66,86,17,25,635,5,36,78,75,61,-50,111,175,885
87,lak203d.map,84,112,2524,22,51,61,60,957,8,50,75,61,14,-1,15,16,16
88,lak203d.map,84,112,5947,53,100,30,11,7395,66,108,17,3,-13,8,21,22,22
89,lak203d.map,84,112,4817,43,110,40,1,5197,46,66,37,45,-3,-44,47,48,48
90,lak203d.map,84,112,5124,45,27,38,84,4862,43,65,40,46,2,38,40,41,41
91,lak203d.map,84,112,3187,28,60,55,51,9308,83,99,0,12,-55,39,94,824,1836
92,lak203d.map,84,112,8973,80,98,3,13,1190,10,41,73,70,70,-57,127,856,740
93,lak203d.map,84,112,1755,15,36,68,75,4324,38,43,45,68,-23,7,30,83,32
94,lak203d.map,84,112,4856,43,71,40,40,4325,38,42,45,69,5,-29,34,35,35
95,lak203d.map,84,112,5670,50,41,33,70,2519,22,56,61,55,28,15,43,264,133
96,lak203d.map,84,112,3977,35,54,48,57,1265,11,78,72,33,24,24,48,1324,1054
97,lak203d.map,84,112,5266,47,109,36,2,3186,28,61,55,50,19,-48,67,1372,707
98,lak203d.map,84,112,4298,38,69,45,42,164,1,59,82,52,37,-10,47,530,954
99,lak203d.map,84,112,1298,11,45,72,66,6070,54,89,29,22,-43,44,87,807,714
0,lak250d.map,200,170,31769,186,20,13,149,19116,112,93,87,76,74,73,147,1555,1048
1,lak250d.map,200,170,19160,112,49,87,120,8333,49,166,150,3,63,117,180,1048,1568
2,lak250d.map,200,170,20408,120,161,79,8,30205,177,54,22,115,-57,-107,164,1560,1555
3,lak250d.map,200,170,5449,32,160,167,9,2765,16,124,183,45,16,-36,52,72,53
4,lak250d.map,200,170,18807,110,62,89,107,26711,157,148,42,21,-47,86,133,1048,1560
5,lak250d.map,200,170,20141,118,88,81,81,17102,100,67,99,102,18,-21,39,236,112
6,lak250d.map,200,170,32752,192,57,7,112,27265,160,104,39,65,32,47,79,1555,1560
7,lak250d.map,200,170,7803,45,16,154,153,31149,183,130,16,39,-138,114,252,1142,1560
8,lak250d.map,200,170,19305,113,74,86,95,10867,63,12,136,157,50,-62,112,1048,1142
9,lak250d.map,200,170,18984,111,55,88,114,29291,172,118,27,51,-61,63,124,1048,1560
10,lak250d.map,200,170,28754,169,145,30,24,28100,165,119,34,50,4,-26,30,113,31
11,lak250d.map,200,170,8987,52,22,147,147,10388,61,151,138,18,-9,129,138,1142,1568
12,lak250d.map,200,170,3201,18,28,181,141,10748,63,131,136,38,-45,103,148,1142,1568
13,lak250d.map,200,170,20235,119,164,80,5,20340,119,59,80,110,0,-105,105,1560,1048
14,lak250d.map,200,170,28953,170,116,29,53,9036,53,143,146,26,117,27,144,1560,1568
15,lak250d.map,200,170,33593,197,66,2,103,8863,52,146,147,23,145,80,225,1555,1568
16,lak250d.map,200,170,10229,60,140,139,29,27045,159,154,40,15,-99,14,113,1568,1560
17,lak250d.map,200,170,8170,48,159,151,10,3701,21,38,178,131,27,-121,148,1568,1142
18,lak250d.map,200,170,7846,46,143,153,26,31903,187,56,12,113,-141,-87,228,1568,1555
19,lak250d.map,200,170,7664,45,155,154,14,31894,187,65,12,104,-142,-90,232,1568,1555
20,lak250d.map,200,170,28189,165,30,34,139,30895,181,44,18,125,-16,14,30,44,34
21,lak250d.map,200,170,18537,109,162,90,7,32950,193,29,6,140,-84,-133,217,1560,1555
22,lak250d.map,200,170,15569,91,70,108,99,30756,180,13,19,156,-89,-57,146,1048,1555
23,lak250d.map,200,170,29234,171,5,28,164,9207,54,142,145,27,117,137,254,1555,1568
24,lak250d.map,200,170,8193,48,136,151,33,28695,168,34,31,135,-120,-102,222,1568,1555
25,lak250d.map,200,170,20151,118,78,81,91,8151,47,8,152,161,71,-70,141,1048,1142
26,lak250d.map,200,170,27914,164,135,35,34,31734,186,55,13,114,-22,-80,102,1560,1555
27,lak250d.map,200,170,8830,51,9,148,160,9607,56,82,143,87,-5,73,78,1142,1048
28,lak250d.map,200,170,26304,154,45,45,124,19320,113,59,86,110,41,14,55,1555,1048
29,lak250d.map,200,170,6634,39,165,160,4,4781,28,148,171,21,11,-17,28,29,29
30,lak250d.map,200,170,32416,190,53,9,116,5251,30,18,169,151,160,-35,195,1555,1142
31,lak250d.map,200,170,29778,175,141,24,28,30302,178,127,21,42,-3,-14,17,18,18
32,lak250d.map,200,170,29353,172,56,27,113,29205,171,34,28,135,1,-22,23,83,99
33,lak250d.map,200,170,26881,158,148,41,21,18092,106,97,93,72,52,-51,103,1560,1048
34,lak250d.map,200,170,26808,157,51,42,118,29383,172,26,27,143,-15,-25,40,56,59
35,lak250d.map,200,170,4226,24,23,175,146,29907,175,12,24,157,-151,-11,162,1142,1555
36,lak250d.map,200,170,29722,174,27,25,142,28287,166,102,33,67,8,75,83,1555,1560
37,lak250d.map,200,170,9905,58,124,141,45,33591,197,68,2,101,-139,-56,195,1568,1555
38,lak250d.map,200,170,28104,165,115,34,54,6982,41,157,158,12,124,42,166,1560,1568
39,lak250d.map,200,170,32104,188,25,11,144,8845,52,164,147,5,136,139,275,1555,1568
40,lak250d.map,200,170,29097,171,142,28,27,30587,179,12,20,157,-8,-130,138,1560,1555
41,lak250d.map,200,170,29961,176,128,23,41,19156,112,53,87,116,64,-75,139,1560,1048
42,lak250d.map,200,170,2352,13,27,186,142,31773,186,16,13,153,-173,-11,184,1142,1555
43,lak250d.map,200,170,1340,7,19,192,150,19661,115,58,84,111,-108,39,147,1142,1048
44,lak250d.map,200,170,28962,170,107,29,62,32253,189,46,10,123,-19,-61,80,1560,1555
45,lak250d.map,200,170,8864,52,145,147,24,7483,44,166,155,3,8,21,29,30,30
46,lak250d.map,200,170,8184,48,145,151,24,9506,55,13,144,156,-7,-132,139,1568,1142
47,lak250d.map,200,170,29800,175,119,24,50,19457,114,92,85,77,61,-27,88,1560,1048
48,lak250d.map,200,170,10408,61,131,138,38,3097,18,132,181,37,43,1,44,126,159
49,lak250d.map,200,170,1000,5,19,194,150,7503,44,146,155,23,-39,127,166,1142,1568
50,lak250d.map,200,170,6322,37,137,162,32,1173,6,16,193,153,31,-121,152,1568,1142
51,lak250d.map,200,170,26713,157,146,42,23,12841,75,78,124,91,82,-68,150,1560,1048
52,lak250d.map,200,170,20138,118,91,81,78,6778,39,21,160,148,79,-70,149,1048,1142
53,lak250d.map,200,170,27090,159,109,40,60,2927,17,132,182,37,142,23,165,1560,1568
54,lak250d.map,200,170,29233,171,6,28,163,5591,32,18,167,151,139,12,151,1555,1142
55,lak250d.map,200,170,18443,108,86,91,83,17956,105,63,94,106,3,-23,26,86,97
56,lak250d.map,200,170,5297,31,142,168,27,9549,56,140,143,29,-25,-2,27,28,28
57,lak250d.map,200,170,28440,167,119,32,50,10013,58,16,141,153,109,-103,212,1560,1142
58,lak250d.map,200,170,5802,34,147,165,22,26366,155,153,44,16,-121,6,127,1568,1560
59,lak250d.map,200,170,29113,171,126,28,43,16591,97,68,102,101,74,-58,132,1560,1048
60,lak250d.map,200,170,29188,171,51,28,118,2679,15,40,184,129,156,-11,167,1555,1142
61,lak250d.map,200,170,4561,26,28,173,141,28339,166,50,33,119,-140,22,162,1142,1555
62,lak250d.map,200,170,28179,165,40,34,129,11989,70,80,129,89,95,40,135,1555,1048
63,lak250d.map,200,170,21597,127,162,72,7,33135,194,14,5,155,-67,-148,215,1560,1555
64,lak250d.map,200,170,994,5,25,194,144,31909,187,50,12,119,-182,25,207,1142,1555
65,lak250d.map,200,170,15226,89,73,110,96,24494,144,155,55,14,-55,82,137,1048,1560
66,lak250d.map,200,170,27700,162,9,37,160,17095,100,74,99,95,62,65,127,1555,1048
67,lak250d.map,200,170,32452,190,17,9,152,5759,33,20,166,149,157,3,160,1555,1142
68,lak250d.map,200,170,18973,111,66,88,103,27086,159,113,40,56,-48,47,95,1048,1560
69,lak250d.map,200,170,10228,60,141,139,28,8533,50,136,149,33,10,-5,15,16,16
70,lak250d.map,200,170,9357,55,162,144,7,30727,180,42,19,127,-125,-120,245,1568,1555
71,lak250d.map,200,170,27725,163,154,36,15,20133,118,96,81,73,45,-58,103,1560,1048
72,lak250d.map,200,170,19899,117,160,82,9,25788,151,51,48,118,-34,-109,143,1560,1555
73,lak250d.map,200,170,29723,174,26,25,143,4059,23,20,176,149,151,-6,157,1555,1142
74,lak250d.map,200,170,2260,13,119,186,50,6637,39,162,160,7,-26,43,69,70,89
75,lak250d.map,200,170,16080,94,69,105,100,30311,178,118,21,51,-84,49,133,1048,1560
76,lak250d.map,200,170,28761,169,138,30,31,29035,170,34,29,135,-1,-104,105,1560,1555
77,lak250d.map,200,170,25786,151,53,48,116,5426,31,13,168,156,120,-40,160,1555,1142
78,lak250d.map,200,170,33257,195,62,4,107,28939,170,130,29,39,25,68,93,1555,1560
79,lak250d.map,200,170,26132,153,47,46,122,19478,114,71,85,98,39,24,63,1555,1048
80,lak250d.map,200,170,1512,8,17,191,152,33459,196,30,3,139,-188,13,201,1142,1555
81,lak250d.map,200,170,5978,35,141,164,28,2863,16,26,183,143,19,-115,134,1568,1142
82,lak250d.map,200,170,32064,188,65,11,104,10214,60,155,139,14,128,90,218,1555,1568
83,lak250d.map,200,170,13859,81,80,118,89,6445,37,14,162,155,44,-66,110,1048,1142
84,lak250d.map,200,170,29027,170,42,29,127,29975,176,114,23,55,-6,72,78,1555,1560
85,lak250d.map,200,170,29787,175,132,24,37,21940,129,159,70,10,46,27,73,82,76
86,lak250d.map,200,170,5297,31,142,168,27,8318,48,11,151,158,-17,-131,148,1568,1142
87,lak250d.map,200,170,8177,48,152,151,17,29539,173,40,26,129,-125,-112,237,1568,1555
88,lak250d.map,200,170,27482,161,57,38,112,29526,173,53,26,116,-12,-4,16,17,17
89,lak250d.map,200,170,18778,110,91,89,78,6302,37,157,162,12,73,66,139,1048,1568
90,lak250d.map,200,170,32922,193,57,6,112,28215,165,4,34,165,28,-53,81,1055,619
91,lak250d.map,200,170,2248,13,131,186,38,10630,62,79,137,90,-49,-52,101,1568,1048
92,lak250d.map,200,170,19818,116,71,83,98,9538,56,151,143,18,60,80,140,1048,1568
93,lak250d.map,200,170,5248,30,21,169,148,1666,9,33,190,136,21,12,33,34,71
94,lak250d.map,200,170,14204,83,75,116,94,21596,127,163,72,6,-44,88,132,1048,1560
95,lak250d.map,200,170,19560,115,159,84,10,2015,11,24,188,145,104,-135,239,1560,1142
96,lak250d.map,200,170,32118,188,11,11,158,3103,18,126,181,43,170,115,285,1555,1568
97,lak250d.map,200,170,30588,179,11,20,158,10967,64,82,135,87,115,71,186,1555,1048
98,lak250d.map,200,170,3042,17,17,182,152,29974,176,115,23,54,-159,98,257,1142,1560
99,lak250d.map,200,170,5121,30,148,169,21,4958,29,141,170,28,1,-7,8,9,9
0,lak300d.map,106,266,21353,80,192,25,73,22190,83,153,22,112,-3,-39,42,43,43
1,lak300d.map,106,266,18469,69,150,36,115,23519,88,154,17,111,-19,4,23,24,24
2,lak300d.map,106,266,17520,65,35,40,230,16843,63,180,42,85,2,145,147,632,1316
3,lak300d.map,106,266,22923,86,218,19,47,11541,43,162,62,103,43,-56,99,100,100
4,lak300d.map,106,266,8075,30,170,75,95,27796,104,133,1,132,-74,-37,111,188,130
5,lak300d.map,106,266,17618,66,203,39,62,16730,62,27,43,238,4,-176,180,1900,841
6,lak300d.map,106,266,2106,7,21,98,244,17870,67,217,38,48,-60,196,256,1606,4761
7,lak300d.map,106,266,25388,95,147,10,118,20678,77,69,28,196,18,-78,96,97,97
8,lak300d.map,106,266,11486,43,217,62,48,26679,100,186,5,79,-57,-31,88,89,89
9,lak300d.map,106,266,19784,74,165,31,100,14676,55,219,50,46,19,54,73,74,74
10,lak300d.map,106,266,10187,38,186,67,79,23190,87,217,18,48,-49,31,80,81,81
11,lak300d.map,106,266,26692,100,173,5,92,19349,72,68,33,197,28,-105,133,452,134
12,lak300d.map,106,266,14181,53,182,52,83,11774,44,195,61,70,9,13,22,23,23
13,lak300d.map,106,266,22219,83,124,22,141,24719,92,18,13,247,-9,-106,115,116,196
14,lak300d.map,106,266,19726,74,223,31,42,9399,35,176,70,89,39,-47,86,87,87
15,lak300d.map,106,266,3821,14,168,91,97,9102,34,207,71,58,-20,39,59,60,90
16,lak300d.map,106,266,3275,12,182,93,83,9397,35,178,70,87,-23,-4,27,28,28
17,lak300d.map,106,266,22754,85,121,20,144,21922,82,155,23,110,3,34,37,38,38
18,lak300d.map,106,266,15512,58,181,47,84,23882,89,57,16,208,-31,-124,155,157,384
19,lak300d.map,106,266,16008,60,217,45,48,23887,89,52,16,213,-29,-165,194,196,449
20,lak300d.map,106,266,23676,89,263,16,2,11687,43,16,62,249,46,-247,293,3097,3525
21,lak300d.map,106,266,24850,93,153,12,112,23917,89,22,16,243,4,-131,135,289,413
22,lak300d.map,106,266,5092,19,227,86,38,5303,19,16,86,249,0,-211,211,5447,1995
23,lak300d.map,106,266,15176,57,251,48,14,24951,93,52,12,213,-36,-199,235,237,494
24,lak300d.map,106,266,17065,64,224,41,41,24551,92,186,13,79,-28,-38,66,67,67
25,lak300d.map,106,266,5042,18,11,87,254,20062,75,153,30,112,-57,142,199,1432,644
26,lak300d.map,106,266,22433,84,176,21,89,24841,93,162,12,103,-9,-14,23,24,24
27,lak300d.map,106,266,21033,79,246,26,19,23379,87,28,18,237,-8,-218,226,283,1781
28,lak300d.map,106,266,23053,86,88,19,177,19302,72,115,33,150,14,27,41,53,42
29,lak300d.map,106,266,11171,41,0,64,265,5092,19,227,86,38,22,227,249,1995,5441
30,lak300d.map,106,266,14684,55,211,50,54,11695,43,8,62,257,12,-203,215,4041,1702
31,lak300d.map,106,266,10084,37,23,68,242,23615,88,58,17,207,-51,35,86,87,97
32,lak300d.map,106,266,24809,93,194,12,71,6463,24,186,81,79,69,-8,77,80,104
33,lak300d.map,106,266,4290,16,231,89,34,25060,94,209,11,56,-78,-22,100,101,101
34,lak300d.map,106,266,82,0,183,105,82,21438,80,107,25,158,-80,-76,156,224,229
35,lak300d.map,106,266,25369,95,166,10,99,19517,73,166,32,99,22,0,22,23,23
36,lak300d.map,106,266,23091,86,50,19,215,5644,21,207,84,58,65,157,222,495,268
37,lak300d.map,106,266,8291,31,220,74,45,26140,98,193,7,72,-67,-27,94,95,95
38,lak300d.map,106,266,23766,89,173,16,92,25118,94,151,11,114,-5,-22,27,28,28
39,lak300d.map,106,266,17595,66,226,39,39,9559,35,16,70,249,31,-210,241,4375,1514
40,lak300d.map,106,266,18969,71,182,34,83,12859,48,174,57,91,23,-8,31,32,32
41,lak300d.map,106,266,19346,72,71,33,194,21956,82,121,23,144,-10,50,60,61,125
42,lak300d.map,106,266,27785,104,144,1,121,22826,85,49,20,216,19,-95,114,115,127
43,lak300d.map,106,266,25488,95,47,10,218,22480,84,129,21,136,11,82,93,96,119
44,lak300d.map,106,266,20656,77,91,28,174,5829,21,22,84,243,56,-69,125,154,126
45,lak300d.map,106,266,22034,82,43,23,222,16247,61,244,44,21,21,201,222,530,224
46,lak300d.map,106,266,9394,35,181,70,84,23759,89,180,16,85,-54,-1,55,56,56
47,lak300d.map,106,266,16544,62,213,43,52,27285,102,112,3,153,-40,-101,141,158,201
48,lak300d.map,106,266,25640,96,161,9,104,18190,68,163,37,102,28,2,30,31,31
49,lak300d.map,106,266,19106,71,45,34,220,16462,61,29,44,236,10,-16,26,27,27
50,lak300d.map,106,266,25009,94,260,11,5,22588,84,21,21,244,10,-239,249,343,2021
51,lak300d.map,106,266,23707,89,232,16,33,26077,98,256,7,9,-9,24,33,131,95
52,lak300d.map,106,266,22425,84,184,21,81,24134,90,71,15,194,-6,-113,119,120,120
53,lak300d.map,106,266,17139,64,150,41,115,18487,69,132,36,133,-5,-18,23,24,24
54,lak300d.map,106,266,6360,23,23,82,242,23579,88,94,17,171,-65,71,136,137,165
55,lak300d.map,106,266,16868,63,155,42,110,5038,18,15,87,250,45,-140,185,969,1818
56,lak300d.map,106,266,24833,93,170,12,95,22493,84,116,21,149,9,-54,63,64,64
57,lak300d.map,106,266,15395,57,32,48,233,18959,71,192,34,73,-14,160,174,623,1580
58,lak300d.map,106,266,14136,53,227,52,38,23991,90,214,15,51,-37,-13,50,51,51
59,lak300d.map,106,266,14345,53,18,52,247,5903,22,214,83,51,31,196,227,2058,5023
60,lak300d.map,106,266,7768,29,211,76,54,18691,70,194,35,71,-41,-17,58,61,59
61,lak300d.map,106,266,19232,72,185,33,80,3701,13,22,92,243,59,-163,222,3228,1200
62,lak300d.map,106,266,25541,96,260,9,5,9285,34,24,71,241,62,-236,298,3637,4291
63,lak300d.map,106,266,18752,70,133,35,132,22226,83,117,22,148,-13,-16,29,30,45
64,lak300d.map,106,266,6690,25,225,80,40,14444,54,185,51,80,-29,-40,69,77,75
65,lak300d.map,106,266,7249,27,198,78,67,25490,95,45,10,220,-68,-153,221,271,595
66,lak300d.map,106,266,5634,21,217,84,48,9639,36,202,69,63,-15,-15,30,31,31
67,lak300d.map,106,266,12594,47,173,58,92,23823,89,116,16,149,-42,-57,99,106,153
68,lak300d.map,106,266,4032,15,223,90,42,13817,51,14,54,251,-36,-209,245,5329,2051
69,lak300d.map,106,266,24667,92,70,13,195,18387,69,232,36,33,23,162,185,302,186
70,lak300d.map,106,266,24872,93,131,12,134,9906,37,201,68,64,56,70,126,145,172
71,lak300d.map,106,266,17689,66,132,39,133,23722,89,217,16,48,-23,85,108,109,109
72,lak300d.map,106,266,18193,68,160,37,105,23039,86,102,19,163,-18,-58,76,82,122
73,lak300d.map,106,266,24882,93,121,12,144,15444,58,249,47,16,35,128,163,186,165
74,lak300d.map,106,266,8593,32,184,73,81,1102,4,227,101,38,28,43,71,128,117
75,lak300d.map,106,266,6442,24,207,81,58,17955,67,132,38,133,-43,-75,118,164,178
76,lak300d.map,106,266,19787,74,162,31,103,20461,76,20,29,245,-2,-142,144,253,269
77,lak300d.map,106,266,22296,83,47,22,218,20892,78,121,27,144,5,74,79,80,80
78,lak300d.map,106,266,19997,75,218,30,47,22461,84,148,21,117,-9,-70,79,80,80
79,lak300d.map,106,266,21731,81,80,24,185,27551,103,112,2,153,-22,32,54,237,141
80,lak300d.map,106,266,27534,103,129,2,136,12046,45,189,60,76,58,60,118,136,139
81,lak300d.map,106,266,10706,40,199,65,66,20701,77,46,28,219,-37,-153,190,236,485
82,lak300d.map,106,266,25538,96,263,9,2,17638,66,183,39,82,30,-80,110,338,1518
83,lak300d.map,106,266,10152,38,221,67,44,21649,81,162,24,103,-43,-59,102,118,105
84,lak300d.map,106,266,26400,99,199,6,66,24619,92,118,13,147,7,-81,88,761,186
85,lak300d.map,106,266,21657,81,154,24,111,8075,30,170,75,95,51,16,67,71,112
86,lak300d.map,106,266,881,3,182,102,83,15762,59,197,46,68,-56,15,71,72,78
87,lak300d.map,106,266,13904,52,193,53,72,21467,80,78,25,187,-28,-115,143,146,250
88,lak300d.map,106,266,8859,33,184,72,81,23357,87,50,18,215,-54,-134,188,234,461
89,lak300d.map,106,266,26752,100,113,5,152,19489,73,194,32,71,27,81,108,109,109
90,lak300d.map,106,266,15231,57,196,48,69,26879,101,252,4,13,-44,56,100,2293,295
91,lak300d.map,106,266,8330,31,181,74,84,12315,46,186,59,79,-15,5,20,21,21
92,lak300d.map,106,266,12292,46,209,59,56,14599,54,30,51,235,-8,-179,187,3795,1235
93,lak300d.map,106,266,14866,55,29,50,236,19716,74,233,31,32,-19,204,223,662,2469
94,lak300d.map,106,266,19232,72,185,33,80,16338,61,153,44,112,11,-32,43,99,44
95,lak300d.map,106,266,10985,41,186,64,79,23714,89,225,16,40,-48,39,87,286,88
96,lak300d.map,106,266,20272,76,209,29,56,4315,16,206,89,59,60,-3,63,64,64
97,lak300d.map,106,266,15923,59,36,46,229,14916,56,245,49,20,3,209,212,830,3720
98,lak300d.map,106,266,23476,88,197,17,68,21716,81,95,24,170,7,-102,109,395,110
99,lak300d.map,106,266,24562,92,175,13,90,4868,18,185,87,80,74,10,84,85,85
0,lak302d.map,283,191,42320,221,81,61,109,46385,242,27,40,163,-21,-54,75,392,513
1,lak302d.map,283,191,20705,108,113,174,77,33732,176,74,106,116,-68,-39,107,7928,5170
2,lak302d.map,283,191,45386,237,71,45,119,29607,155,188,127,2,82,117,199,1147,333
3,lak302d.map,283,191,17750,92,12,190,178,20879,109,130,173,60,-17,118,135,1846,2997
4,lak302d.map,283,191,18994,99,105,183,85,22254,116,92,166,98,-17,-13,30,1091,566
5,lak302d.map,283,191,11797,61,44,221,146,19839,103,24,179,166,-42,-20,62,473,514
6,lak302d.map,283,191,17741,92,21,190,169,11790,61,51,221,139,31,30,61,826,1248
7,lak302d.map,283,191,32649,170,11,112,179,6791,35,84,247,106,135,73,208,437,218
8,lak302d.map,283,191,25216,132,186,150,4,40978,214,86,68,104,-82,-100,182,702,528
9,lak302d.map,283,191,19256,100,34,182,156,29965,156,21,126,169,-56,-13,69,431,418
10,lak302d.map,283,191,25211,131,0,151,190,7750,40,80,242,110,91,80,171,2066,343
11,lak302d.map,283,191,40565,212,117,70,73,16398,85,27,197,163,127,-90,217,4579,3659
12,lak302d.map,283,191,18332,95,3,187,187,19141,100,149,182,41,-5,146,151,2746,3484
13,lak302d.map,283,191,49953,261,88,21,102,31516,165,189,117,1,96,101,197,1306,2825
14,lak302d.map,283,191,21872,114,92,168,98,49209,257,68,25,122,-143,-24,167,6942,13407
15,lak302d.map,283,191,21442,112,140,170,50,40775,213,98,69,92,-101,-42,143,2747,3212
16,lak302d.map,283,191,26970,141,151,141,39,38126,199,73,83,117,-58,-78,136,3478,3281
17,lak302d.map,283,191,17022,89,167,193,23,41911,219,108,63,82,-130,-59,189,2834,3423
18,lak302d.map,283,191,5642,29,87,253,103,47509,248,49,34,141,-219,-38,257,5405,4076
19,lak302d.map,283,191,39083,204,71,78,119,17662,92,100,190,90,112,29,141,4680,7063
20,lak302d.map,283,191,35635,186,81,96,109,29783,155,12,127,178,31,-69,100,2486,3215
21,lak302d.map,283,191,47504,248,54,34,136,20113,105,132,177,58,143,78,221,5126,4197
22,lak302d.map,283,191,10460,54,44,228,146,18694,97,23,185,167,-43,-21,64,894,515
23,lak302d.map,283,191,26784,140,146,142,44,25764,134,20,148,170,6,-126,132,9597,5286
24,lak302d.map,283,191,48472,253,41,29,149,37651,197,166,85,24,56,125,181,2504,592
25,lak302d.map,283,191,18872,98,36,184,154,51873,271,78,11,112,-173,42,215,1426,3323
26,lak302d.map,283,191,11817,61,24,221,166,24051,125,14,157,176,-64,-10,74,146,90
27,lak302d.map,283,191,21701,113,72,169,118,16061,84,173,198,17,29,101,130,1572,2108
28,lak302d.map,283,191,22248,116,98,166,92,2763,14,101,268,89,102,3,105,1103,2128
29,lak302d.map,283,191,46148,241,73,41,117,34117,178,71,104,119,63,-2,65,66,107
30,lak302d.map,283,191,46769,244,25,38,165,36730,192,132,90,58,52,107,159,1467,1308
31,lak302d.map,283,191,47725,249,24,33,166,46934,245,51,37,139,4,27,31,53,32
32,lak302d.map,283,191,34435,180,135,102,55,28629,149,20,133,170,31,-115,146,6108,3961
33,lak302d.map,283,191,18515,96,11,186,179,26167,137,190,145,0,-41,179,220,3081,4599
34,lak302d.map,283,191,19955,104,99,178,91,37285,195,150,87,40,-91,51,142,2644,1811
35,lak302d.map,283,191,10116,52,6,230,184,8309,43,94,239,96,9,88,97,325,355
36,lak302d.map,283,191,40016,209,93,73,97,8314,43,89,239,101,166,-4,170,5786,9488
37,lak302d.map,283,191,52627,275,88,7,102,10245,53,68,229,122,222,-20,242,3864,5846
38,lak302d.map,283,191,11408,59,51,223,139,47115,246,61,36,129,-187,10,197,4354,5087
39,lak302d.map,283,191,47510,248,48,34,142,19958,104,96,178,94,144,48,192,8224,5535
40,lak302d.map,283,191,39197,205,148,77,42,20046,104,8,178,182,101,-140,241,7801,9910
41,lak302d.map,283,191,19338,101,143,181,47,23334,122,158,160,32,-21,15,36,235,173
42,lak302d.map,283,191,20344,106,92,176,98,38982,204,172,78,18,-98,80,178,2297,1936
43,lak302d.map,283,191,25803,135,172,147,18,28470,149,179,133,11,-14,7,21,22,22
44,lak302d.map,283,191,37284,195,151,87,39,36141,189,148,93,42,6,-3,9,10,10
45,lak302d.map,283,191,37361,195,74,87,116,50530,264,84,18,106,-69,10,79,294,216
46,lak302d.map,283,191,38633,202,139,80,51,34043,178,145,104,45,24,6,30,31,31
47,lak302d.map,283,191,9304,48,54,234,136,23976,125,89,157,101,-77,35,112,1514,993
48,lak302d.map,283,191,673,3,90,279,100,41701,218,127,64,63,-215,37,252,5571,5191
49,lak302d.map,283,191,11754,61,87,221,103,19266,100,24,182,166,-39,-63,102,2580,862
50,lak302d.map,283,191,34008,178,180,104,10,34111,178,77,104,113,0,-103,103,2561,1118
51,lak302d.map,283,191,19672,102,0,180,190,48483,253,30,29,160,-151,30,181,1057,206
52,lak302d.map,283,191,17081,89,108,193,82,20895,109,114,173,76,-20,6,26,32,37
53,lak302d.map,283,191,21804,114,160,168,30,45575,238,73,44,117,-124,-87,211,4231,4684
54,lak302d.map,283,191,48102,251,29,31,161,31894,166,2,116,188,85,-27,112,137,451
55,lak302d.map,283,191,31240,163,83,119,107,29407,153,6,129,184,10,-77,87,1749,3647
56,lak302d.map,283,191,20689,108,129,174,61,36407,190,73,92,117,-82,-56,138,6949,3654
57,lak302d.map,283,191,32001,167,86,115,104,46727,244,67,38,123,-77,-19,96,193,97
58,lak302d.map,283,191,16320,85,105,197,85,42316,221,85,61,105,-136,-20,156,5077,4547
59,lak302d.map,283,191,36280,189,9,93,181,16844,88,154,194,36,101,145,246,5576,6481
60,lak302d.map,283,191,16705,87,102,195,88,19907,104,147,178,43,-17,45,62,70,256
61,lak302d.map,283,191,52453,274,71,8,119,32118,168,160,114,30,106,89,195,3312,373
62,lak302d.map,283,191,17024,89,165,193,25,21874,114,90,168,100,-25,-75,100,2667,1469
63,lak302d.map,283,191,38833,203,130,79,60,17875,93,78,189,112,110,-52,162,5065,4220
64,lak302d.map,283,191,31156,163,167,119,23,40365,211,126,71,64,-48,-41,89,281,157
65,lak302d.map,283,191,24801,129,28,153,162,33814,177,183,105,7,-48,155,203,4263,11089
66,lak302d.map,283,191,37644,197,173,85,17,40165,210,135,72,55,-13,-38,51,266,520
67,lak302d.map,283,191,35188,184,146,98,44,23350,122,142,160,48,62,-4,66,1302,1266
68,lak302d.map,283,191,50524,264,90,18,100,35183,184,151,98,39,80,61,141,782,2004
69,lak302d.map,283,191,29785,155,10,127,180,28270,148,188,134,2,7,178,185,4448,9069
70,lak302d.map,283,191,32388,169,81,113,109,49205,257,72,25,118,-88,-9,97,98,98
71,lak302d.map,283,191,25776,134,8,148,182,11375,59,84,223,106,75,76,151,1147,1142
72,lak302d.map,283,191,28440,148,18,134,172,37669,197,148,85,42,-49,130,179,5524,6193
73,lak302d.map,283,191,25626,134,158,148,32,32084,167,3,115,187,-33,-155,188,8180,4283
74,lak302d.map,283,191,41572,217,65,65,125,10886,56,0,226,190,161,-65,226,1770,6707
75,lak302d.map,283,191,16903,88,95,194,95,38511,201,70,81,120,-113,-25,138,8644,4919
76,lak302d.map,283,191,19348,101,133,181,57,23669,123,14,159,176,-22,-119,141,4245,3146
77,lak302d.map,283,191,40553,212,129,70,61,26583,139,156,143,34,73,27,100,1726,769
78,lak302d.map,283,191,40923,214,141,68,49,19327,101,154,181,36,113,13,126,3157,3230
79,lak302d.map,283,191,13474,70,86,212,104,47542,248,16,34,174,-178,-70,248,4036,6320
80,lak302d.map,283,191,10658,55,37,227,153,17164,89,25,193,165,-34,-12,46,1285,502
81,lak302d.map,283,191,34196,179,183,103,7,39005,204,149,78,41,-25,-34,59,60,125
82,lak302d.map,283,191,22832,119,87,163,103,22635,118,93,164,97,1,6,7,8,8
83,lak302d.map,283,191,33840,177,157,105,33,44684,233,9,49,181,-56,-148,204,2550,2225
84,lak302d.map,283,191,26001,136,165,146,25,18311,95,24,187,166,41,-141,182,6083,2988
85,lak302d.map,283,191,37752,197,65,85,125,35171,184,163,98,27,13,98,111,858,1281
86,lak302d.map,283,191,17737,92,25,190,165,34491,180,79,102,111,-88,54,142,6814,3138
87,lak302d.map,283,191,16926,88,72,194,118,38511,201,70,81,120,-113,-2,115,10571,8193
88,lak302d.map,283,191,28076,146,0,136,190,33829,177,168,105,22,-31,168,199,4216,6474
89,lak302d.map,283,191,18052,94,92,188,98,46943,245,42,37,148,-151,-50,201,5917,7868
90,lak302d.map,283,191,20435,106,1,176,189,13550,70,10,212,180,36,9,45,46,62
91,lak302d.map,283,191,25032,131,179,151,11,46149,241,72,41,118,-110,-107,217,771,1122
92,lak302d.map,283,191,25058,131,153,151,37,15468,80,2,202,188,51,-151,202,3613,2579
93,lak302d.map,283,191,8501,44,93,238,97,43343,226,13,56,177,-182,-80,262,3160,713
94,lak302d.map,283,191,34592,181,169,101,21,37070,194,174,88,16,-13,5,18,57,25
95,lak302d.map,283,191,298,1,83,281,107,20367,106,69,176,121,-105,-14,119,597,388
96,lak302d.map,283,191,44883,234,1,48,189,38407,201,174,81,16,33,173,206,4020,2654
97,lak302d.map,283,191,27514,144,180,138,10,18779,98,129,184,61,46,-51,97,125,507
98,lak302d.map,283,191,41555,217,82,65,108,9479,49,70,233,120,168,-12,180,5323,9417
99,lak302d.map,283,191,19168,100,122,182,68,47898,250,42,32,148,-150,-80,230,5036,7999
0,lak303d.map,192,191,14698,76,8,115,182,27789,145,96,46,94,-69,88,157,267,224
1,lak303d.map,192,191,29490,154,114,37,76,20067,105,178,86,12,49,64,113,1157,1489
2,lak303d.map,192,191,17872,93,81,98,109,8455,44,139,147,51,49,58,107,161,115
3,lak303d.map,192,191,24773,129,56,62,134,33334,174,90,17,100,-45,34,79,91,125
4,lak303d.map,192,191,8325,43,78,148,112,13254,69,115,122,75,-26,37,63,10255,8343
5,lak303d.map,192,191,20008,104,46,87,144,23308,122,184,69,6,-18,138,156,2115,2298
6,lak303d.map,192,191,35051,183,92,8,98,25334,132,68,59,122,51,-24,75,121,113
7,lak303d.map,192,191,11320,59,139,132,51,18798,98,110,93,80,-39,-29,68,70,77
8,lak303d.map,192,191,28178,147,89,44,101,10167,53,146,138,44,94,57,151,3095,4052
9,lak303d.map,192,191,4817,25,148,166,42,14010,73,123,118,67,-48,-25,73,81,74
10,lak303d.map,192,191,10394,54,110,137,80,15419,80,51,111,139,-26,-59,85,117,694
11,lak303d.map,192,191,24205,126,51,65,139,30703,160,47,31,143,-34,-4,38,310,347
12,lak303d.map,192,191,10426,54,78,137,112,28402,148,56,43,134,-94,-22,116,3356,2169
13,lak303d.map,192,191,17931,93,22,98,168,15287,80,183,111,7,13,161,174,8407,9878
14,lak303d.map,192,191,6656,34,28,157,162,32719,171,132,20,58,-137,104,241,1159,3840
15,lak303d.map,192,191,21395,112,187,79,3,29389,153,24,38,166,-41,-163,204,2579,2464
16,lak303d.map,192,191,8699,45,86,146,104,17043,89,146,102,44,-44,60,104,7375,8716
17,lak303d.map,192,191,24005,125,60,66,130,18862,98,46,93,144,27,-14,41,42,56
18,lak303d.map,192,191,8747,45,38,146,152,21171,110,29,81,161,-65,-9,74,596,511
19,lak303d.map,192,191,24123,126,133,65,57,19395,101,86,90,104,25,-47,72,6786,3819
20,lak303d.map,192,191,34297,179,82,12,108,29332,153,81,38,109,26,-1,27,33,85
21,lak303d.map,192,191,16090,84,144,107,46,33678,176,128,15,62,-92,-16,108,2761,2133
22,lak303d.map,192,191,24409,127,38,64,152,19771,103,92,88,98,24,54,78,11434,5533
23,lak303d.map,192,191,29363,153,50,38,140,29167,152,55,39,135,1,5,6,7,7
24,lak303d.map,192,191,24460,128,178,63,12,7950,41,71,150,119,87,-107,194,7762,4282
25,lak303d.map,192,191,19964,104,90,87,100,16621,87,186,104,4,17,96,113,1418,1816
26,lak303d.map,192,191,27200,142,112,49,78,22702,118,26,73,164,24,-86,110,558,115
27,lak303d.map,192,191,7593,39,46,152,144,3531,18,97,173,93,21,51,72,458,1151
28,lak303d.map,192,191,34667,181,94,10,96,16134,84,100,107,90,97,6,103,8398,3852
29,lak303d.map,192,191,28633,149,16,42,174,15091,79,188,112,2,70,172,242,6013,5085
30,lak303d.map,192,191,24019,125,46,66,144,33871,177,126,14,64,-52,80,132,153,265
31,lak303d.map,192,191,30097,157,80,34,110,17596,92,166,99,24,65,86,151,3509,1750
32,lak303d.map,192,191,19053,99,46,92,144,29127,152,95,39,95,-53,49,102,128,148
33,lak303d.map,192,191,19531,102,141,89,49,21748,113,25,78,165,-11,-116,127,5125,6121
34,lak303d.map,192,191,15625,81,36,110,154,24846,130,174,61,16,-49,138,187,2441,3066
35,lak303d.map,192,191,27812,145,73,46,117,19527,102,145,89,45,43,72,115,2528,1222
36,lak303d.map,192,191,25538,133,55,58,135,7539,39,100,152,90,94,45,139,673,1195
37,lak303d.map,192,191,11827,61,14,130,176,10070,52,52,139,138,9,38,47,116,158
38,lak303d.map,192,191,26009,136,157,55,33,18633,97,84,94,106,39,-73,112,4435,2714
39,lak303d.map,192,191,20600,107,27,84,163,7486,39,153,152,37,68,126,194,9278,6209
40,lak303d.map,192,191,17865,93,88,98,102,34293,179,86,12,104,-86,-2,88,3774,10252
41,lak303d.map,192,191,6136,32,166,159,24,7532,39,107,152,83,-7,-59,66,9239,9689
42,lak303d.map,192,191,20834,109,175,82,15,5877,30,43,161,147,79,-132,211,7878,6726
43,lak303d.map,192,191,17584,92,178,99,12,9306,48,52,143,138,44,-126,170,7439,8295
44,lak303d.map,192,191,7146,37,111,154,79,13309,69,60,122,130,-32,-51,83,87,94
45,lak303d.map,192,191,14978,78,110,113,80,9995,52,127,139,63,26,17,43,52,49
46,lak303d.map,192,191,25389,132,13,59,177,9975,52,147,139,43,80,134,214,8680,6498
47,lak303d.map,192,191,5965,31,146,160,44,25062,131,149,60,41,-100,3,103,2715,1478
48,lak303d.map,192,191,2569,13,104,178,86,12230,64,184,127,6,-51,80,131,8238,9261
49,lak303d.map,192,191,28297,148,161,43,29,26300,137,57,54,133,11,-104,115,756,1434
50,lak303d.map,192,191,27068,141,53,50,137,18823,98,85,93,105,43,32,75,11401,4543
51,lak303d.map,192,191,3337,17,100,174,90,15437,80,33,111,157,-63,-67,130,144,572
52,lak303d.map,192,191,25818,135,157,56,33,11123,58,145,133,45,77,-12,89,1026,1425
53,lak303d.map,192,191,9093,47,74,144,116,31966,167,121,24,69,-120,47,167,1742,3587
54,lak303d.map,192,191,10363,54,141,137,49,6765,35,110,156,80,19,-31,50,9265,7804
55,lak303d.map,192,191,8808,46,168,145,22,34679,181,82,10,108,-135,-86,221,4524,5717
56,lak303d.map,192,191,31394,164,120,27,70,22462,117,75,74,115,47,-45,92,9117,3725
57,lak303d.map,192,191,19451,101,30,90,160,9214,48,144,143,46,53,114,167,8662,6301
58,lak303d.map,192,191,32340,169,129,22,61,24646,129,183,62,7,40,54,94,872,1178
59,lak303d.map,192,191,28370,148,88,43,102,7476,39,163,152,27,109,75,184,4333,4436
60,lak303d.map,192,191,21035,110,165,81,25,31988,167,99,24,91,-57,-66,123,1110,2252
61,lak303d.map,192,191,20056,105,189,86,1,28191,147,76,44,114,-42,-113,155,1544,1105
62,lak303d.map,192,191,28361,148,97,43,93,29724,155,71,36,119,-7,-26,33,34,34
63,lak303d.map,192,191,8246,43,157,148,33,26958,141,163,50,27,-98,6,104,1509,1702
64,lak303d.map,192,191,29713,155,82,36,108,32558,170,102,21,88,-15,20,35,36,60
65,lak303d.map,192,191,8923,46,53,145,137,35228,184,106,7,84,-138,53,191,983,2584
66,lak303d.map,192,191,7212,37,45,154,145,35061,183,82,8,108,-146,37,183,1932,1997
67,lak303d.map,192,191,25392,132,10,59,180,5439,28,99,163,91,104,89,193,1844,313
68,lak303d.map,192,191,26868,140,62,51,128,24774,129,55,62,135,11,-7,18,19,19
69,lak303d.map,192,191,1050,5,95,186,95,15854,83,189,108,1,-78,94,172,8174,9119
70,lak303d.map,192,191,23906,125,159,66,31,24588,128,50,63,140,-3,-109,112,1495,1822
71,lak303d.map,192,191,23928,125,137,66,53,10927,57,150,134,40,68,13,81,1587,3225
72,lak303d.map,192,191,10931,57,146,134,44,29143,152,79,39,111,-95,-67,162,3966,3623
73,lak303d.map,192,191,13515,70,45,121,145,7158,37,99,154,91,33,54,87,101,94
74,lak303d.map,192,191,26002,136,164,55,26,8509,44,85,147,105,92,-79,171,8571,3562
75,lak303d.map,192,191,33906,177,91,14,99,20483,107,144,84,46,70,53,123,3288,1280
76,lak303d.map,192,191,28995,151,36,40,154,30077,157,100,34,90,-6,64,70,1171,1132
77,lak303d.map,192,191,12248,64,166,127,24,31989,167,98,24,92,-103,-68,171,3661,3289
78,lak303d.map,192,191,14161,74,163,117,27,14774,77,123,114,67,-3,-40,43,504,146
79,lak303d.map,192,191,20008,104,46,87,144,22383,117,154,74,36,-13,108,121,3444,3776
80,lak303d.map,192,191,22849,119,70,72,120,16892,88,106,103,84,31,36,67,68,182
81,lak303d.map,192,191,23717,124,157,67,33,28990,151,41,40,149,-27,-116,143,1856,2464
82,lak303d.map,192,191,18625,97,92,94,98,20917,109,92,82,98,-12,0,12,16,15
83,lak303d.map,192,191,29344,153,69,38,121,12185,63,38,128,152,90,-31,121,1479,1064
84,lak303d.map,192,191,13708,71,43,120,147,16663,87,144,104,46,-16,101,117,7630,6185
85,lak303d.map,192,191,20776,108,42,83,148,10252,53,61,138,129,55,19,74,75,78
86,lak303d.map,192,191,29955,156,31,35,159,26469,138,79,53,111,18,48,66,347,351
87,lak303d.map,192,191,34272,179,107,12,83,17043,89,146,102,44,90,39,129,2731,1564
88,lak303d.map,192,191,19958,104,96,87,94,34870,182,82,9,108,-78,-14,92,3845,10077
89,lak303d.map,192,191,31213,163,110,28,80,20343,106,93,85,97,57,-17,74,8484,3734
90,lak303d.map,192,191,16084,84,150,107,40,22679,118,49,73,141,-34,-101,135,5142,4624
91,lak303d.map,192,191,24073,126,183,65,7,12172,63,51,128,139,63,-132,195,4982,3322
92,lak303d.map,192,191,7098,37,159,154,31,10477,54,27,137,163,-17,-132,149,7869,9450
93,lak303d.map,192,191,12361,64,53,127,137,24460,128,178,63,12,-64,125,189,3142,5074
94,lak303d.map,192,191,12658,66,138,125,52,20828,109,181,82,9,-43,43,86,618,139
95,lak303d.map,192,191,9208,48,150,143,40,3525,18,103,173,87,30,-47,77,9250,8585
96,lak303d.map,192,191,5397,28,141,163,49,32911,172,131,19,59,-144,-10,154,4824,2281
97,lak303d.map,192,191,13761,72,181,119,9,14922,78,166,113,24,-6,-15,21,22,22
98,lak303d.map,192,191,29886,156,100,35,90,22951,120,159,71,31,36,59,95,1300,718
99,lak303d.map,192,191,35058,183,85,8,105,26197,137,160,54,30,46,75,121,2292,426
0,lak304d.map,192,191,23008,120,102,71,88,33335,174,89,17,101,-54,-13,67,7472,4450
1,lak304d.map,192,191,13392,70,168,121,22,14414,75,101,116,89,-5,-67,72,2850,1252
2,lak304d.map,192,191,29652,155,143,36,47,31399,164,115,27,75,-9,-28,37,804,1124
3,lak304d.map,192,191,8545,44,49,147,141,27290,142,22,49,168,-98,-27,125,2735,1033
4,lak304d.map,192,191,24475,128,163,63,27,32205,168,73,23,117,-40,-90,130,3819,1915
5,lak304d.map,192,191,12261,64,153,127,37,8175,42,37,149,153,22,-116,138,4589,5701
6,lak304d.map,192,191,18240,95,95,96,95,2758,14,106,177,84,81,11,92,3691,2475
7,lak304d.map,192,191,4665,24,109,167,81,27988,146,88,45,102,-122,-21,143,2963,2317
8,lak304d.map,192,191,17873,93,80,98,110,15026,78,62,113,128,15,-18,33,34,34
9,lak304d.map,192,191,4283,22,109,169,81,8517,44,77,147,113,-22,-32,54,159,93
10,lak304d.map,192,191,22154,115,1,76,189,31427,164,87,27,103,-49,86,135,1564,2174
11,lak304d.map,192,191,7694,40,136,151,54,13399,70,161,121,29,-30,25,55,176,59
12,lak304d.map,192,191,14243,74,81,117,109,25908,135,67,56,123,-61,-14,75,2117,1110
13,lak304d.map,192,191,10069,52,53,139,137,20926,109,83,82,107,-57,30,87,264,430
14,lak304d.map,192,191,21792,114,172,77,18,24202,126,54,65,136,-12,-118,130,1595,1342
15,lak304d.map,192,191,7968,41,53,150,137,8281,43,122,148,68,-2,69,71,6187,6283
16,lak304d.map,192,191,8555,44,39,147,151,31196,163,127,28,63,-119,88,207,3587,2066
17,lak304d.map,192,191,17811,93,142,98,48,9411,49,138,142,52,44,-4,48,935,343
18,lak304d.map,192,191,11592,60,58,131,132,6909,36,157,155,33,24,99,123,5190,5593
19,lak304d.map,192,191,27587,144,107,47,83,13300,69,69,122,121,75,-38,113,1954,3468
20,lak304d.map,192,191,20488,107,139,84,51,29063,152,159,39,31,-45,20,65,280,370
21,lak304d.map,192,191,13476,70,84,121,106,11710,61,131,130,59,9,47,56,2325,2382
22,lak304d.map,192,191,26281,137,76,54,114,10758,56,128,135,62,81,52,133,1637,3892
23,lak304d.map,192,191,34638,181,123,10,67,19631,102,41,89,149,79,-82,161,255,236
24,lak304d.map,192,191,16057,84,177,107,13,28220,147,47,44,143,-63,-130,193,4225,7769
25,lak304d.map,192,191,24322,127,125,64,65,2571,13,102,178,88,114,-23,137,1209,1851
26,lak304d.map,192,191,26394,138,154,53,36,23061,120,49,71,141,18,-105,123,892,712
27,lak304d.map,192,191,20250,106,186,85,4,23180,121,121,70,69,-15,-65,80,2049,2456
28,lak304d.map,192,191,2164,11,127,180,63,2727,14,137,177,53,-3,10,13,14,14
29,lak304d.map,192,191,15435,80,35,111,155,20303,106,133,85,57,-26,98,124,126,333
30,lak304d.map,192,191,5780,30,140,161,50,24999,130,21,61,169,-100,-119,219,6270,9294
31,lak304d.map,192,191,27173,142,139,49,51,8927,46,49,145,141,96,-90,186,2758,412
32,lak304d.map,192,191,27072,141,49,50,141,26397,138,151,53,39,3,102,105,482,848
33,lak304d.map,192,191,4616,24,158,167,32,12242,64,172,127,18,-40,14,54,239,57
34,lak304d.map,192,191,35219,184,115,7,75,17543,91,28,100,162,93,-87,180,3617,2434
35,lak304d.map,192,191,12776,66,20,125,170,9237,48,121,143,69,18,101,119,6471,3402
36,lak304d.map,192,191,15664,82,188,109,2,15841,82,11,109,179,0,-177,177,5102,6257
37,lak304d.map,192,191,15275,79,4,112,186,19204,100,86,91,104,-21,82,103,576,1124
38,lak304d.map,192,191,1969,10,131,181,59,9582,50,158,141,32,-40,27,67,2092,2724
39,lak304d.map,192,191,24358,127,89,64,101,17422,91,149,100,41,36,60,96,546,103
40,lak304d.map,192,191,10656,55,39,136,151,13804,72,138,119,52,-17,99,116,4791,3180
41,lak304d.map,192,191,10620,55,75,136,115,28982,151,49,40,141,-96,-26,122,4953,12202
42,lak304d.map,192,191,3720,19,99,172,91,28295,148,163,43,27,-129,64,193,1983,1774
43,lak304d.map,192,191,10737,56,149,135,41,4737,24,37,167,153,32,-112,144,4890,6121
44,lak304d.map,192,191,4846,25,119,166,71,7726,40,104,151,86,-15,-15,30,68,32
45,lak304d.map,192,191,32169,168,109,23,81,25311,132,91,59,99,36,-18,54,3235,2306
46,lak304d.map,192,191,10648,55,47,136,143,22760,119,159,72,31,-64,112,176,5995,1292
47,lak304d.map,192,191,13556,70,4,121,186,17678,92,84,99,106,-22,80,102,107,407
48,lak304d.map,192,191,34064,178,124,13,66,23662,123,21,68,169,55,-103,158,2306,560
49,lak304d.map,192,191,19963,104,91,87,99,28612,149,37,42,153,-45,-54,99,2780,3035
50,lak304d.map,192,191,22731,119,188,72,2,13492,70,68,121,122,49,-120,169,1331,4032
51,lak304d.map,192,191,8072,42,140,149,50,10833,56,53,135,137,-14,-87,101,4258,6857
52,lak304d.map,192,191,9833,51,98,140,92,6262,32,40,159,150,19,-58,77,4215,7631
53,lak304d.map,192,191,18976,99,123,92,67,29819,156,167,35,23,-57,44,101,367,225
54,lak304d.map,192,191,13610,71,141,120,49,33510,175,105,16,85,-104,-36,140,814,176
55,lak304d.map,192,191,27098,141,23,50,167,20798,108,20,83,170,33,-3,36,580,1176
56,lak304d.map,192,191,14041,73,92,118,98,12245,64,169,127,21,9,77,86,1588,2911
57,lak304d.map,192,191,28953,151,78,40,112,8643,45,142,146,48,106,64,170,3006,1853
58,lak304d.map,192,191,8568,44,26,147,164,26044,136,122,55,68,-92,96,188,5571,449
59,lak304d.map,192,191,19890,104,164,87,26,21802,114,162,77,28,-10,-2,12,13,13
60,lak304d.map,192,191,29355,153,58,38,132,16734,87,73,104,117,66,15,81,1339,1637
61,lak304d.map,192,191,12808,67,179,124,11,15214,79,65,112,125,-12,-114,126,2583,2567
62,lak304d.map,192,191,5218,27,129,164,61,23516,123,167,68,23,-96,38,134,3216,8086
63,lak304d.map,192,191,21414,112,168,79,22,16758,87,49,104,141,25,-119,144,2321,5546
64,lak304d.map,192,191,27730,145,155,46,35,7477,39,162,152,28,106,7,113,2516,2231
65,lak304d.map,192,191,22947,120,163,71,27,34118,178,70,13,120,-58,-93,151,3920,2167
66,lak304d.map,192,191,17313,90,67,101,123,23477,122,15,69,175,-32,-52,84,281,775
67,lak304d.map,192,191,20921,109,88,82,102,6846,35,29,156,161,74,-59,133,553,354
68,lak304d.map,192,191,21748,113,25,78,165,19623,102,49,89,141,11,24,35,110,45
69,lak304d.map,192,191,36173,189,116,2,74,26790,140,140,51,50,49,24,73,634,566
70,lak304d.map,192,191,10083,52,39,139,151,15134,79,145,112,45,-27,106,133,4217,3345
71,lak304d.map,192,191,21038,110,162,81,28,33934,177,63,14,127,-67,-99,166,3970,2345
72,lak304d.map,192,191,24004,125,61,66,129,8716,45,69,146,121,80,8,88,10941,5406
73,lak304d.map,192,191,28024,146,52,45,138,17549,91,22,100,168,55,-30,85,2379,993
74,lak304d.map,192,191,19951,104,103,87,87,24383,127,64,64,126,-23,-39,62,3442,2034
75,lak304d.map,192,191,23177,121,124,70,66,24930,130,90,61,100,-9,-34,43,162,200
76,lak304d.map,192,191,24075,126,181,65,9,7583,39,56,152,134,87,-125,212,7180,6046
77,lak304d.map,192,191,15262,79,17,112,173,18230,95,105,96,85,-16,88,104,397,1381
78,lak304d.map,192,191,23057,120,53,71,137,21487,112,95,79,95,8,42,50,1849,2482
79,lak304d.map,192,191,31618,165,87,26,103,35043,183,100,8,90,-18,13,31,2376,2302
80,lak304d.map,192,191,20515,107,112,84,78,31207,163,116,28,74,-56,4,60,2081,1553
81,lak304d.map,192,191,22601,118,127,73,63,15381,80,89,111,101,38,-38,76,95,394
82,lak304d.map,192,191,21104,110,96,81,94,20050,104,4,87,186,6,-92,98,2456,1607
83,lak304d.map,192,191,34512,180,58,11,132,17211,90,169,101,21,90,111,201,5776,6806
84,lak304d.map,192,191,30592,160,158,31,32,34111,178,77,13,113,-18,-81,99,7346,2717
85,lak304d.map,192,191,8107,42,105,149,85,9316,48,42,143,148,-6,-63,69,3910,7207
86,lak304d.map,192,191,22504,117,33,74,157,33871,177,126,14,64,-60,93,153,278,1894
87,lak304d.map,192,191,27354,143,149,48,41,13356,69,13,122,177,74,-136,210,783,460
88,lak304d.map,192,191,31217,163,106,28,84,23154,121,147,70,43,42,41,83,119,134
89,lak304d.map,192,191,14272,74,52,117,138,21121,110,79,81,111,-36,27,63,65,258
90,lak304d.map,192,191,11412,59,47,132,143,13519,70,41,121,149,-11,-6,17,41,23
91,lak304d.map,192,191,4429,23,154,168,36,19381,101,100,90,90,-78,-54,132,1477,2320
92,lak304d.map,192,191,7147,37,110,154,80,7349,38,99,153,91,-1,-11,12,16,18
93,lak304d.map,192,191,28986,151,45,40,145,25942,135,33,56,157,16,-12,28,29,29
94,lak304d.map,192,191,10834,56,52,135,138,29132,152,90,39,100,-96,38,134,2182,1085
95,lak304d.map,192,191,17267,90,113,101,77,14485,75,30,116,160,15,-83,98,1018,652
96,lak304d.map,192,191,13228,69,141,122,49,26534,138,14,53,176,-69,-127,196,5777,4507
97,lak304d.map,192,191,15195,79,84,112,106,11204,58,64,133,126,21,-20,41,693,359
98,lak304d.map,192,191,18256,95,79,96,111,4468,23,115,168,75,72,36,108,5216,2491
99,lak304d.map,192,191,16478,86,138,105,52,23711,124,163,67,27,-38,25,63,1425,888
0,lak307d.map,81,80,2769,34,30,46,49,2026,25,53,55,26,9,23,32,33,33
1,lak307d.map,81,80,4816,60,63,20,16,2493,31,66,49,13,29,3,32,33,33
2,lak307d.map,81,80,3226,40,53,40,26,5455,68,64,12,15,-28,11,39,40,40
3,lak307d.map,81,80,1640,20,39,60,40,3787,47,52,33,27,-27,13,40,41,41
4,lak307d.map,81,80,2944,36,15,44,64,4585,57,54,23,25,-21,39,60,61,61
5,lak307d.map,81,80,3897,48,22,32,57,1092,13,27,67,52,35,5,40,41,41
6,lak307d.map,81,80,1771,22,68,58,11,4252,53,67,27,12,-31,-1,32,33,33
7,lak307d.map,81,80,5780,72,59,8,20,2044,25,35,55,44,47,-24,71,72,72
8,lak307d.map,81,80,4755,59,44,21,35,2844,35,35,45,44,24,-9,33,34,34
9,lak307d.map,81,80,537,6,22,74,57,4019,50,60,30,19,-44,38,82,83,83
10,lak307d.map,81,80,3769,47,70,33,9,2741,34,58,46,21,13,-12,25,26,26
11,lak307d.map,81,80,4339,54,60,26,19,1823,22,16,58,63,32,-44,76,77,77
12,lak307d.map,81,80,4099,51,60,29,19,1655,20,24,60,55,31,-36,67,68,68
13,lak307d.map,81,80,2114,26,45,54,34,5228,65,51,15,28,-39,6,45,46,46
14,lak307d.map,81,80,5132,64,67,16,12,1701,21,58,59,21,43,-9,52,53,130
15,lak307d.map,81,80,3089,38,30,42,49,1902,23,17,57,62,15,-13,28,29,29
16,lak307d.map,81,80,2224,27,15,53,64,3883,48,36,32,43,-21,21,42,43,43
17,lak307d.map,81,80,2696,33,23,47,56,1073,13,46,67,33,20,23,43,44,44
18,lak307d.map,81,80,2072,25,7,55,72,3995,49,4,31,75,-24,-3,27,225,160
19,lak307d.map,81,80,1808,22,31,58,48,2303,28,16,52,63,-6,-15,21,22,22
20,lak307d.map,81,80,2548,31,11,49,68,3727,46,32,34,47,-15,21,36,37,37
21,lak307d.map,81,80,1249,15,30,65,49,3100,38,19,42,60,-23,-11,34,35,35
22,lak307d.map,81,80,2984,37,55,43,24,3626,45,53,35,26,-8,-2,10,11,11
23,lak307d.map,81,80,4456,55,23,25,56,4823,60,56,20,23,-5,33,38,39,39
24,lak307d.map,81,80,2954,36,5,44,74,3994,49,5,31,74,-13,0,13,135,177
25,lak307d.map,81,80,1812,22,27,58,52,4111,51,48,29,31,-29,21,50,51,51
26,lak307d.map,81,80,2532,31,27,49,52,2814,35,65,45,14,-4,38,42,43,43
27,lak307d.map,81,80,941,11,18,69,61,1799,22,40,58,39,-11,22,33,34,34
28,lak307d.map,81,80,5953,74,46,6,33,5150,64,49,16,30,10,3,13,14,14
29,lak307d.map,81,80,3452,43,67,37,12,4773,59,26,21,53,-16,-41,57,58,58
30,lak307d.map,81,80,5814,72,25,8,54,4806,60,73,20,6,12,48,60,185,61
31,lak307d.map,81,80,1217,15,62,65,17,1172,14,27,66,52,1,-35,36,49,37
32,lak307d.map,81,80,688,8,31,72,48,4770,59,29,21,50,-51,-2,53,54,54
33,lak307d.map,81,80,5640,70,39,10,40,3824,47,15,33,64,23,-24,47,48,48
34,lak307d.map,81,80,352,4,47,76,32,1734,21,25,59,54,-17,-22,39,40,40
35,lak307d.map,81,80,4405,55,74,25,5,4061,50,18,30,61,5,-56,61,62,62
36,lak307d.map,81,80,2896,36,63,44,16,4699,58,20,22,59,-22,-43,65,66,66
37,lak307d.map,81,80,1896,23,23,57,56,3185,39,14,41,65,-16,-9,25,40,26
38,lak307d.map,81,80,3209,40,70,40,9,1940,24,59,56,20,16,-11,27,28,28
39,lak307d.map,81,80,1216,15,63,65,16,5214,65,65,15,14,-50,2,52,53,53
40,lak307d.map,81,80,2270,28,49,52,30,2495,31,64,49,15,-3,15,18,19,19
41,lak307d.map,81,80,1905,23,14,57,65,3622,45,57,35,22,-22,43,65,66,66
42,lak307d.map,81,80,3761,47,78,33,1,5172,64,27,16,52,-17,-51,68,69,69
43,lak307d.map,81,80,922,11,37,69,42,6364,79,35,1,44,-68,-2,70,71,71
44,lak307d.map,81,80,1653,20,26,60,53,1533,19,66,61,13,1,40,41,42,42
45,lak307d.map,81,80,2811,35,68,45,11,1148,14,51,66,28,21,-17,38,39,39
46,lak307d.map,81,80,3289,41,70,39,9,5335,66,24,14,55,-25,-46,71,72,86
47,lak307d.map,81,80,3773,47,66,33,13,2205,27,34,53,45,20,-32,52,53,53
48,lak307d.map,81,80,4304,53,15,27,64,1293,16,66,64,13,37,51,88,89,89
49,lak307d.map,81,80,816,10,63,70,16,1454,18,65,62,14,-8,2,10,12,11
50,lak307d.map,81,80,2112,26,47,54,32,2533,31,26,49,53,-5,-21,26,27,27
51,lak307d.map,81,80,4604,57,35,23,44,3901,48,18,32,61,9,-17,26,27,27
52,lak307d.map,81,80,4698,58,21,22,58,3499,43,20,37,59,15,-1,16,17,17
53,lak307d.map,81,80,3866,48,53,32,26,603,7,36,73,43,41,-17,58,59,59
54,lak307d.map,81,80,5316,66,43,14,36,2101,26,58,54,21,40,15,55,56,56
55,lak307d.map,81,80,3139,39,60,41,19,2030,25,49,55,30,14,-11,25,26,26
56,lak307d.map,81,80,1769,22,70,58,9,987,12,52,68,27,10,-18,28,29,29
57,lak307d.map,81,80,5547,69,52,11,27,2894,36,65,44,14,33,13,46,47,47
58,lak307d.map,81,80,1068,13,51,67,28,5334,66,25,14,54,-53,-26,79,80,126
59,lak307d.map,81,80,3490,43,29,37,50,3514,43,5,37,74,0,-24,24,401,91
60,lak307d.map,81,80,6105,76,54,4,25,1934,24,65,56,14,52,11,63,64,64
61,lak307d.map,81,80,5561,69,38,11,41,2985,37,54,43,25,32,16,48,49,55
62,lak307d.map,81,80,2795,34,4,46,75,1407,17,32,63,47,17,28,45,46,132
63,lak307d.map,81,80,5064,63,55,17,24,3514,43,5,37,74,20,-50,70,1876,137
64,lak307d.map,81,80,4929,61,30,19,49,5050,63,69,17,10,-2,39,41,42,44
65,lak307d.map,81,80,4505,56,54,24,25,3731,46,28,34,51,10,-26,36,37,37
66,lak307d.map,81,80,1376,17,63,63,16,3379,42,60,38,19,-25,-3,28,29,29
67,lak307d.map,81,80,277,3,42,77,37,3886,48,33,32,46,-45,-9,54,55,55
68,lak307d.map,81,80,1145,14,54,66,25,4124,51,35,29,44,-37,-19,56,57,70
69,lak307d.map,81,80,3940,49,59,31,20,4142,51,17,29,62,-2,-42,44,45,45
70,lak307d.map,81,80,1770,22,69,58,10,3510,43,9,37,70,-21,-60,81,165,82
71,lak307d.map,81,80,1809,22,30,58,49,4827,60,52,20,27,-38,22,60,61,61
72,lak307d.map,81,80,5064,63,55,17,24,5574,69,25,11,54,-6,-30,36,37,37
73,lak307d.map,81,80,4849,60,30,20,49,4350,54,49,26,30,6,19,25,26,26
74,lak307d.map,81,80,837,10,42,70,37,3006,37,33,43,46,-27,-9,36,37,37
75,lak307d.map,81,80,4376,54,23,26,56,2009,25,70,55,9,29,47,76,77,77
76,lak307d.map,81,80,5970,74,29,6,50,918,11,41,69,38,63,12,75,76,76
77,lak307d.map,81,80,5811,72,28,8,51,5323,66,36,14,43,6,8,14,15,15
78,lak307d.map,81,80,5888,73,31,7,48,4426,55,53,25,26,18,22,40,41,41
79,lak307d.map,81,80,1422,17,17,63,62,2567,32,72,48,7,-15,55,70,71,71
80,lak307d.map,81,80,6284,78,35,2,44,3476,43,43,37,36,35,8,43,44,44
81,lak307d.map,81,80,4425,55,54,25,25,6277,78,42,2,37,-23,-12,35,36,36
82,lak307d.map,81,80,6439,80,40,0,39,5583,69,16,11,63,11,-24,35,90,37
83,lak307d.map,81,80,2773,34,26,46,53,4255,53,64,27,15,-19,38,57,58,58
84,lak307d.map,81,80,3496,43,23,37,56,4970,62,69,18,10,-19,46,65,66,66
85,lak307d.map,81,80,2362,29,37,51,42,3539,44,60,36,19,-15,23,38,39,39
86,lak307d.map,81,80,2578,32,61,48,18,3063,38,56,42,23,-6,-5,11,12,12
87,lak307d.map,81,80,4614,57,25,23,54,4511,56,48,24,31,1,23,24,25,25
88,lak307d.map,81,80,3561,44,38,36,41,3588,44,11,36,68,0,-27,27,28,28
89,lak307d.map,81,80,499,6,60,74,19,2215,27,24,53,55,-21,-36,57,58,58
90,lak307d.map,81,80,3896,48,23,32,56,2777,34,22,46,57,14,-1,15,16,16
91,lak307d.map,81,80,5625,70,54,10,25,5818,72,21,8,58,-2,-33,35,36,36
92,lak307d.map,81,80,4048,50,31,30,48,918,11,41,69,38,39,10,49,50,50
93,lak307d.map,81,80,4912,61,47,19,32,3004,37,35,43,44,24,-12,36,37,37
94,lak307d.map,81,80,3858,48,61,32,18,1830,22,9,58,70,26,-52,78,79,79
95,lak307d.map,81,80,4498,56,61,24,18,2036,25,43,55,36,31,-18,49,50,50
96,lak307d.map,81,80,1428,17,11,63,68,3565,44,34,36,45,-27,23,50,51,51
97,lak307d.map,81,80,936,11,23,69,56,2043,25,36,55,43,-14,13,27,28,28
98,lak307d.map,81,80,117,1,42,79,37,4453,55,26,25,53,-54,-16,70,71,71
99,lak307d.map,81,80,858,10,21,70,58,6111,76,48,4,31,-66,27,93,96,94
0,lak308d.map,314,296,73330,247,77,66,218,12836,43,187,270,108,204,110,314,4112,5276
1,lak308d.map,314,296,9324,31,147,282,148,89652,302,35,11,260,-271,-112,383,10605,5441
2,lak308d.map,314,296,49817,168,206,145,89,46530,157,237,156,58,11,31,42,72,46
3,lak308d.map,314,296,49664,167,63,146,232,48921,165,214,148,81,2,151,153,308,655
4,lak308d.map,314,296,9601,32,166,281,129,28379,95,36,218,259,-63,-130,193,267,514
5,lak308d.map,314,296,45786,154,93,159,202,49266,166,165,147,130,-12,72,84,85,141
6,lak308d.map,314,296,87572,295,43,18,252,29549,99,50,214,245,196,7,203,3677,3409
7,lak308d.map,314,296,78070,263,73,50,222,68598,231,73,82,222,32,0,32,33,33
8,lak308d.map,314,296,84010,283,53,30,242,9013,30,162,283,133,253,109,362,5246,6410
9,lak308d.map,314,296,42292,142,35,171,260,20788,70,227,243,68,72,192,264,4261,2883
10,lak308d.map,314,296,10559,35,96,278,199,15943,53,40,260,255,-18,-56,74,643,414
11,lak308d.map,314,296,49537,167,190,146,105,26003,87,44,226,251,80,-146,226,553,416
12,lak308d.map,314,296,49514,167,213,146,82,11196,37,51,276,244,130,-162,292,2250,926
13,lak308d.map,314,296,9069,30,106,283,189,79549,268,74,45,221,-238,-32,270,5564,4593
14,lak308d.map,314,296,45940,155,235,158,60,47740,161,211,152,84,-6,-24,30,110,44
15,lak308d.map,314,296,11419,38,124,275,171,49301,166,130,147,165,-128,6,134,3369,2612
16,lak308d.map,314,296,19832,67,295,246,0,49238,166,193,147,102,-99,-102,201,705,1764
17,lak308d.map,314,296,79851,269,68,44,227,48695,164,144,149,151,105,76,181,216,307
18,lak308d.map,314,296,62624,211,127,102,168,49350,166,81,147,214,45,-46,91,826,659
19,lak308d.map,314,296,18308,61,43,252,252,19039,64,200,249,95,-3,157,160,1981,2372
20,lak308d.map,314,296,84311,284,48,29,247,9671,32,96,281,199,252,48,300,4464,5295
21,lak308d.map,314,296,28075,94,44,219,251,48959,165,176,148,119,-71,132,203,358,505
22,lak308d.map,314,296,69163,233,100,80,195,79563,268,60,45,235,-35,-40,75,178,78
23,lak308d.map,314,296,21542,72,65,241,230,11671,39,168,274,127,33,103,136,789,237
24,lak308d.map,314,296,10544,35,111,278,184,73020,246,91,67,204,-211,-20,231,5560,4057
25,lak308d.map,314,296,18458,62,189,251,106,10802,36,149,277,146,26,-40,66,67,67
26,lak308d.map,314,296,8146,27,141,286,154,71547,241,84,72,211,-214,-57,271,5897,4895
27,lak308d.map,314,296,18010,60,45,253,250,42979,145,236,168,59,-85,191,276,2734,3057
28,lak308d.map,314,296,46084,155,91,158,204,47428,160,227,153,68,-5,136,141,554,306
29,lak308d.map,314,296,12833,43,190,270,105,36954,124,45,189,250,-81,-145,226,837,1983
30,lak308d.map,314,296,15302,51,89,262,206,82831,279,48,34,247,-228,-41,269,4657,4352
31,lak308d.map,314,296,20787,70,228,243,67,41499,140,236,173,59,-70,8,78,79,79
32,lak308d.map,314,296,19160,64,79,249,216,88757,299,42,14,253,-235,-37,272,4314,4191
33,lak308d.map,314,296,27476,92,51,221,244,8357,28,226,285,69,64,175,239,4155,3772
34,lak308d.map,314,296,37952,128,231,185,64,6961,23,142,290,153,105,-89,194,780,1560
35,lak308d.map,314,296,37066,125,229,188,66,47442,160,213,153,82,-35,-16,51,248,133
36,lak308d.map,314,296,59065,199,134,114,161,50735,171,176,142,119,28,42,70,426,147
37,lak308d.map,314,296,20344,68,79,245,216,71549,241,82,72,213,-173,3,176,4005,3575
38,lak308d.map,314,296,19928,67,199,246,96,57883,195,132,118,163,-128,-67,195,1987,2227
39,lak308d.map,314,296,19166,64,73,249,222,29367,99,232,214,63,-35,159,194,2559,2333
40,lak308d.map,314,296,12203,41,228,272,67,42679,144,240,169,55,-103,12,115,185,121
41,lak308d.map,314,296,48925,165,210,148,85,50719,171,192,142,103,-6,-18,24,25,25
42,lak308d.map,314,296,89043,300,52,13,243,84908,286,43,27,252,14,-9,23,83,425
43,lak308d.map,314,296,15792,53,191,260,104,47550,160,105,153,190,-107,-86,193,3794,2701
44,lak308d.map,314,296,2519,8,144,305,151,48087,162,160,151,135,-154,16,170,3654,3105
45,lak308d.map,314,296,33992,114,47,199,248,47290,159,69,154,226,-45,22,67,148,147
46,lak308d.map,314,296,19536,66,295,247,0,41800,141,231,172,64,-75,-64,139,457,1257
47,lak308d.map,314,296,18328,61,23,252,272,11387,38,156,275,139,23,133,156,1171,1287
48,lak308d.map,314,296,46835,158,228,155,67,18743,63,200,250,95,95,-28,123,569,686
49,lak308d.map,314,296,7752,26,239,287,56,12099,40,36,273,259,-14,-203,217,3717,3984
50,lak308d.map,314,296,44065,148,38,165,257,36757,124,242,189,53,24,204,228,1403,1330
51,lak308d.map,314,296,54626,184,133,129,162,37252,125,43,188,252,59,-90,149,436,980
52,lak308d.map,314,296,11086,37,161,276,134,39423,133,240,180,55,-96,79,175,264,440
53,lak308d.map,314,296,91417,308,46,5,249,38740,130,35,183,260,178,-11,189,2949,4610
54,lak308d.map,314,296,18672,63,271,250,24,41396,139,43,174,252,-76,-228,304,3461,3231
55,lak308d.map,314,296,20771,70,244,243,51,66814,225,81,88,214,-155,-163,318,604,568
56,lak308d.map,314,296,70673,238,70,75,225,31141,105,234,208,61,133,164,297,547,474
57,lak308d.map,314,296,18650,63,293,250,2,41791,141,240,172,55,-78,-53,131,700,756
58,lak308d.map,314,296,48040,162,207,151,88,21325,72,282,241,13,90,75,165,1513,1286
59,lak308d.map,314,296,15546,52,141,261,154,39618,133,45,180,250,-81,-96,177,411,1912
60,lak308d.map,314,296,64426,217,101,96,194,67374,227,113,86,182,-10,12,22,23,23
61,lak308d.map,314,296,19315,65,220,248,75,84023,283,40,30,255,-218,-180,398,1469,3832
62,lak308d.map,314,296,21057,71,254,242,41,71246,240,89,73,206,-169,-165,334,605,572
63,lak308d.map,314,296,23392,79,287,234,8,66188,223,115,90,180,-144,-172,316,804,3173
64,lak308d.map,314,296,53138,179,141,134,154,7551,25,144,288,151,154,3,157,3613,3577
65,lak308d.map,314,296,8738,29,141,284,154,11965,40,170,273,125,-11,29,40,41,72
66,lak308d.map,314,296,11155,37,92,276,203,19495,65,40,248,255,-28,-52,80,358,384
67,lak308d.map,314,296,20682,69,37,244,258,17237,58,226,255,69,11,189,200,3164,1744
68,lak308d.map,314,296,27186,91,45,222,250,89954,303,29,10,266,-212,-16,228,5672,2978
69,lak308d.map,314,296,50174,169,145,144,150,14615,49,184,264,111,120,39,159,2376,2610
70,lak308d.map,314,296,12323,41,108,272,187,43469,146,42,167,253,-105,-66,171,221,1523
71,lak308d.map,314,296,21366,72,241,241,54,9942,33,121,280,174,39,-120,159,495,229
72,lak308d.map,314,296,22300,75,195,238,100,77775,262,72,51,223,-187,-123,310,3227,4622
73,lak308d.map,314,296,38239,129,240,184,55,74223,250,72,63,223,-121,-168,289,430,539
74,lak308d.map,314,296,47811,161,140,152,155,49068,165,67,148,228,-4,-73,77,78,78
75,lak308d.map,314,296,10116,34,243,279,52,83423,281,48,32,247,-247,-195,442,1366,694
76,lak308d.map,314,296,26996,91,235,222,60,12589,42,138,271,157,49,-97,146,1500,380
77,lak308d.map,314,296,37546,126,45,187,250,46727,157,40,156,255,-31,-5,36,37,37
78,lak308d.map,314,296,11400,38,143,275,152,21700,73,203,240,92,-35,60,95,218,650
79,lak308d.map,314,296,61433,207,134,106,161,3111,10,144,303,151,197,10,207,4239,4835
80,lak308d.map,314,296,31138,105,237,208,58,40509,136,42,177,253,-31,-195,226,1735,1854
81,lak308d.map,314,296,11793,39,46,274,249,65916,222,91,91,204,-183,45,228,3441,2654
82,lak308d.map,314,296,45786,154,93,159,202,13822,46,89,267,206,108,-4,112,1119,2168
83,lak308d.map,314,296,43568,147,239,166,56,58766,198,137,115,158,-51,-102,153,161,362
84,lak308d.map,314,296,20723,70,292,243,3,42588,143,35,170,260,-73,-257,330,3386,4571
85,lak308d.map,314,296,41690,140,45,173,250,50398,170,217,143,78,-30,172,202,208,570
86,lak308d.map,314,296,20448,69,271,244,24,34590,116,41,197,254,-47,-230,277,3252,2756
87,lak308d.map,314,296,70649,238,94,75,201,10130,34,229,279,66,204,135,339,2775,1302
88,lak308d.map,314,296,45246,152,41,161,254,5479,18,144,295,151,134,103,237,661,284
89,lak308d.map,314,296,77777,262,70,51,225,70653,238,90,75,205,24,20,44,45,66
90,lak308d.map,314,296,47500,160,155,153,140,21645,73,258,240,37,87,103,190,1265,1327
91,lak308d.map,314,296,22218,75,277,238,18,14063,47,144,266,151,28,-133,161,1919,353
92,lak308d.map,314,296,7813,26,178,287,117,20526,69,193,244,102,-43,15,58,99,59
93,lak308d.map,314,296,41395,139,44,174,251,81636,275,59,38,236,-136,15,151,2478,2931
94,lak308d.map,314,296,9312,31,159,282,136,19831,66,0,247,295,-35,-159,194,1861,798
95,lak308d.map,314,296,50704,171,207,142,88,48758,164,81,149,214,7,-126,133,623,214
96,lak308d.map,314,296,48490,163,53,150,242,48940,165,195,148,100,-2,142,144,253,285
97,lak308d.map,314,296,9929,33,134,280,161,46983,158,80,155,215,-125,-54,179,2547,1761
98,lak308d.map,314,296,58178,196,133,117,162,15500,52,187,261,108,144,54,198,2665,2756
99,lak308d.map,314,296,33397,112,50,201,245,22191,74,8,239,287,38,-42,80,662,175
0,lak400d.map,418,362,47664,131,119,286,242,45829,126,144,291,217,5,25,30,31,31
1,lak400d.map,418,362,32394,89,185,328,176,19763,54,146,363,215,35,-39,74,75,75
2,lak400d.map,418,362,91505,252,80,165,281,131802,364,327,53,34,-112,247,359,14396,14358
3,lak400d.map,418,362,78762,217,153,200,208,31685,87,170,330,191,130,17,147,811,3700
4,lak400d.map,418,362,99472,274,77,143,284,92914,256,119,161,242,18,42,60,70,68
5,lak400d.map,418,362,104913,289,66,128,295,91092,251,131,166,230,38,65,103,198,112
6,lak400d.map,418,362,114697,316,56,101,305,116266,321,297,96,64,-5,241,246,10059,4226
7,lak400d.map,418,362,72208,199,191,218,170,97227,268,150,149,211,-69,-41,110,111,170
8,lak400d.map,418,362,116869,322,56,95,305,80215,221,148,196,213,101,92,193,505,365
9,lak400d.map,418,362,120868,333,39,84,322,47711,131,72,286,289,202,33,235,17091,6251
10,lak400d.map,418,362,124098,342,67,75,294,94450,260,31,157,330,82,-36,118,120,439
11,lak400d.map,418,362,39653,109,166,308,195,37839,104,170,313,191,5,4,9,10,10
12,lak400d.map,418,362,83418,230,203,187,158,88567,244,122,173,239,-14,-81,95,96,96
13,lak400d.map,418,362,121202,334,67,83,294,29099,80,222,337,139,254,155,409,1206,3920
14,lak400d.map,418,362,28393,78,204,339,157,58820,162,185,255,176,-84,-19,103,104,104
15,lak400d.map,418,362,21097,58,260,359,101,124493,343,34,74,327,-285,-226,511,6770,1990
16,lak400d.map,418,362,20337,56,296,361,65,122379,338,338,79,23,-282,42,324,10104,7437
17,lak400d.map,418,362,9673,26,100,391,261,108861,300,100,117,261,-274,0,274,9612,12337
18,lak400d.map,418,362,106323,293,104,124,257,87892,242,73,175,288,51,-31,82,3780,1493
19,lak400d.map,418,362,103076,284,93,133,268,46607,128,90,289,271,156,-3,159,12815,6018
20,lak400d.map,418,362,77765,214,64,203,297,123142,340,299,77,62,-126,235,361,10360,13659
21,lak400d.map,418,362,105609,291,94,126,267,110706,305,65,112,296,-14,-29,43,44,44
22,lak400d.map,418,362,31007,85,124,332,237,138615,382,30,35,331,-297,-94,391,7663,17650
23,lak400d.map,418,362,93001,256,32,161,329,25079,69,260,348,101,187,228,415,3953,20350
24,lak400d.map,418,362,56640,156,193,261,168,80133,221,230,196,131,-65,37,102,184,212
25,lak400d.map,418,362,47003,129,56,288,305,47975,132,170,285,191,-3,114,117,240,253
26,lak400d.map,418,362,121953,336,40,81,321,45811,126,162,291,199,210,122,332,11908,4507
27,lak400d.map,418,362,11505,31,78,386,283,101282,279,77,138,284,-248,-1,249,10364,13378
28,lak400d.map,418,362,93635,258,122,159,239,92956,256,77,161,284,2,-45,47,5409,2252
29,lak400d.map,418,362,91145,251,78,166,283,27275,75,236,342,125,176,158,334,3576,25816
30,lak400d.map,418,362,32412,89,167,328,194,118759,328,338,89,23,-239,171,410,11721,1241
31,lak400d.map,418,362,136433,376,40,41,321,104523,288,94,129,267,88,54,142,284,155
32,lak400d.map,418,362,136083,375,28,42,333,127772,352,13,65,348,23,-15,38,39,39
33,lak400d.map,418,362,12201,33,106,384,255,96893,267,122,150,239,-234,16,250,8017,6579
34,lak400d.map,418,362,114328,315,63,102,298,113556,313,111,104,250,2,48,50,1347,706
35,lak400d.map,418,362,126986,350,75,67,286,24763,68,214,349,147,282,139,421,1217,5918
36,lak400d.map,418,362,120848,333,59,84,302,42589,117,126,300,235,216,67,283,14422,6615
37,lak400d.map,418,362,28488,78,109,339,252,90325,249,174,168,187,-171,65,236,4933,3147
38,lak400d.map,418,362,120866,333,41,84,320,45831,126,142,291,219,207,101,308,14388,5708
39,lak400d.map,418,362,120072,331,111,86,250,42289,116,64,301,297,215,-47,262,14516,9186
40,lak400d.map,418,362,114024,314,5,103,356,118433,327,302,90,59,-13,297,310,11724,11314
41,lak400d.map,418,362,125638,347,337,70,24,106367,293,60,124,301,54,-277,331,5049,9682
42,lak400d.map,418,362,116620,322,305,95,56,92903,256,130,161,231,66,-175,241,2854,1269
43,lak400d.map,418,362,138613,382,32,35,329,80157,221,206,196,155,161,174,335,855,579
44,lak400d.map,418,362,79803,220,198,197,163,115556,319,283,98,78,-99,85,184,453,222
45,lak400d.map,418,362,44720,123,167,294,194,80954,223,133,194,228,-100,-34,134,2338,1496
46,lak400d.map,418,362,109248,301,75,116,286,126021,348,316,69,45,-47,241,288,8702,4982
47,lak400d.map,418,362,33219,91,84,326,277,85293,235,138,182,223,-144,54,198,6750,7747
48,lak400d.map,418,362,124509,343,18,74,343,36015,99,184,318,177,244,166,410,1493,3572
49,lak400d.map,418,362,123379,340,62,77,299,127804,353,343,64,18,-13,281,294,11886,5080
50,lak400d.map,418,362,44334,122,191,295,170,122622,338,95,79,266,-216,-96,312,9464,1357
51,lak400d.map,418,362,101836,281,247,136,114,99782,275,129,142,232,6,-118,124,1577,1270
52,lak400d.map,418,362,32347,89,232,328,129,38596,106,137,311,224,-17,-95,112,3173,927
53,lak400d.map,418,362,109586,302,99,115,262,105795,292,270,125,91,10,171,181,4724,2705
54,lak400d.map,418,362,92262,254,47,163,314,124063,342,102,75,259,-88,55,143,1140,2782
55,lak400d.map,418,362,89336,246,77,171,284,85602,236,191,181,170,10,114,124,2861,10056
56,lak400d.map,418,362,25956,71,107,346,254,93350,257,45,160,316,-186,-62,248,18167,12620
57,lak400d.map,418,362,40032,110,149,307,212,78764,217,151,200,210,-107,2,109,4023,2165
58,lak400d.map,418,362,125524,346,89,71,272,102567,283,240,134,121,63,151,214,6621,5151
59,lak400d.map,418,362,114017,314,12,103,349,45851,126,122,291,239,188,110,298,15410,15093
60,lak400d.map,418,362,22576,62,229,355,132,123051,339,28,78,333,-277,-201,478,6728,1907
61,lak400d.map,418,362,82340,227,195,190,166,102397,282,48,135,313,-55,-147,202,258,564
62,lak400d.map,418,362,91904,253,43,164,318,43740,120,61,297,300,133,18,151,16118,14575
63,lak400d.map,418,362,139708,385,23,32,338,20812,57,183,360,178,328,160,488,1493,7331
64,lak400d.map,418,362,50573,139,106,278,255,111502,308,355,109,6,-169,249,418,13107,10769
65,lak400d.map,418,362,38286,105,85,312,276,132526,366,327,51,34,-261,242,503,8762,11063
66,lak400d.map,418,362,77397,213,70,204,291,26223,72,202,345,159,141,132,273,3545,25810
67,lak400d.map,418,362,92899,256,134,161,227,73758,203,89,214,272,53,-45,98,169,207
68,lak400d.map,418,362,48074,132,71,285,290,101482,280,239,137,122,-148,168,316,1877,6612
69,lak400d.map,418,362,125569,346,44,71,317,129571,357,24,60,337,-11,-20,31,32,32
70,lak400d.map,418,362,75905,209,114,208,247,114470,316,283,101,78,-107,169,276,482,1154
71,lak400d.map,418,362,77338,213,129,204,232,78722,217,193,200,168,-4,64,68,380,413
72,lak400d.map,418,362,130706,361,337,56,24,37791,104,218,313,143,257,-119,376,6906,1739
73,lak400d.map,418,362,123410,340,31,77,330,142979,394,10,23,351,-54,-21,75,169,76
74,lak400d.map,418,362,21078,58,279,359,82,84198,232,147,185,214,-174,-132,306,2422,924
75,lak400d.map,418,362,80924,223,163,194,198,25590,70,111,347,250,153,-52,205,2626,5724
76,lak400d.map,418,362,97319,268,58,149,303,23647,65,244,352,117,203,186,389,3907,20764
77,lak400d.map,418,362,22939,63,228,354,133,41103,113,164,304,197,-50,-64,114,152,3000
78,lak400d.map,418,362,24329,67,286,350,75,42515,117,200,300,161,-50,-86,136,160,306
79,lak400d.map,418,362,28706,79,253,338,108,28127,77,108,340,253,2,-145,147,148,148
80,lak400d.map,418,362,83432,230,189,187,172,95146,262,59,155,302,-32,-130,162,7465,2873
81,lak400d.map,418,362,109574,302,111,115,250,101463,280,258,137,103,22,147,169,3572,2280
82,lak400d.map,418,362,147657,407,38,10,323,128170,354,339,63,22,53,301,354,12055,5305
83,lak400d.map,418,362,44368,122,157,295,204,122733,339,346,78,15,-217,189,406,7462,1200
84,lak400d.map,418,362,90401,249,98,168,263,41449,114,180,303,181,135,82,217,2940,5913
85,lak400d.map,418,362,77993,215,198,202,163,41543,114,86,303,275,101,-112,213,2924,1644
86,lak400d.map,418,362,76972,212,133,205,228,10068,27,67,390,294,185,-66,251,4661,10076
87,lak400d.map,418,362,110330,304,79,113,282,122987,339,92,78,269,-35,13,48,62,49
88,lak400d.map,418,362,117634,324,15,93,346,102373,282,72,135,289,42,57,99,424,1143
89,lak400d.map,418,362,57740,159,179,258,182,88143,243,184,174,177,-84,5,89,90,90
90,lak400d.map,418,362,114451,316,302,101,59,26142,72,283,345,78,244,-19,263,7036,9788
91,lak400d.map,418,362,86442,238,75,179,286,73229,202,256,215,105,36,181,217,3866,11457
92,lak400d.map,418,362,82750,228,147,189,214,137519,379,40,38,321,-151,-107,258,454,710
93,lak400d.map,418,362,118283,326,90,91,271,16541,45,110,372,251,281,20,301,13367,14649
94,lak400d.map,418,362,10032,27,103,390,258,33424,92,241,325,120,-65,138,203,275,674
95,lak400d.map,418,362,74749,206,184,211,177,128895,356,338,61,23,-150,154,304,687,632
96,lak400d.map,418,362,98585,272,240,145,121,18347,50,114,367,247,222,-126,348,589,2644
97,lak400d.map,418,362,30225,83,182,334,179,29414,81,269,336,92,2,87,89,90,90
98,lak400d.map,418,362,27240,75,271,342,90,141139,389,40,28,321,-314,-231,545,6744,1489
99,lak400d.map,418,362,32848,90,93,327,268,77397,213,70,204,291,-123,-23,146,24668,16025
0,lak401d.map,592,401,126089,314,225,277,175,195396,487,291,104,109,-173,66,239,10479,3233
1,lak401d.map,592,401,65536,163,227,428,173,69695,173,78,418,322,-10,-149,159,2902,2201
2,lak401d.map,592,401,195969,488,119,103,281,188620,470,250,121,150,18,131,149,5122,9031
3,lak401d.map,592,401,92673,231,358,360,42,191423,477,254,114,146,-246,-104,350,6401,8000
4,lak401d.map,592,401,92272,230,358,361,42,104652,260,8,331,392,-30,-350,380,5043,5647
5,lak401d.map,592,401,143720,358,238,233,162,44677,111,234,480,166,247,-4,251,2720,4458
6,lak401d.map,592,401,61928,154,226,437,174,182152,454,302,137,98,-300,76,376,23805,8514
7,lak401d.map,592,401,221504,552,248,39,152,114862,286,224,305,176,266,-24,290,305,2644
8,lak401d.map,592,401,68324,170,246,421,154,106191,264,73,327,327,-94,-173,267,6537,1366
9,lak401d.map,592,401,212726,530,204,61,196,222719,555,236,36,164,-25,32,57,58,174
10,lak401d.map,592,401,174283,434,151,157,249,186588,465,277,126,123,-31,126,157,8349,5406
11,lak401d.map,592,401,84346,210,264,381,136,51819,129,310,462,90,81,46,127,1378,2019
12,lak401d.map,592,401,66700,166,266,425,134,105854,263,9,328,391,-97,-257,354,8391,2007
13,lak401d.map,592,401,219117,546,229,45,171,214990,536,346,55,54,10,117,127,7688,4158
14,lak401d.map,592,401,142922,356,234,235,166,180612,450,238,141,162,-94,4,98,460,101
15,lak401d.map,592,401,85257,212,155,379,245,200252,499,247,92,153,-287,92,379,4999,11434
16,lak401d.map,592,401,192184,479,295,112,105,69906,174,268,417,132,305,-27,332,13544,20868
17,lak401d.map,592,401,217459,542,283,49,117,64740,161,221,430,179,381,-62,443,5908,7683
18,lak401d.map,592,401,178729,445,116,146,284,72111,179,68,412,332,266,-48,314,14457,25062
19,lak401d.map,592,401,196705,490,185,101,215,78071,194,123,397,277,296,-62,358,12095,21589
20,lak401d.map,592,401,77146,192,246,399,154,142507,355,248,236,152,-163,2,165,2697,2792
21,lak401d.map,592,401,177875,443,168,148,232,182924,456,332,135,68,-13,164,177,9362,6208
22,lak401d.map,592,401,64908,161,53,430,347,69134,172,238,419,162,-11,185,196,2343,3794
23,lak401d.map,592,401,212348,529,181,62,219,116700,291,391,300,9,238,210,448,14045,8064
24,lak401d.map,592,401,68729,171,242,420,158,144133,359,226,232,174,-188,-16,204,2753,2769
25,lak401d.map,592,401,192259,479,220,112,180,66332,165,233,426,167,314,13,327,3999,4135
26,lak401d.map,592,401,182289,454,165,137,235,232243,579,336,12,64,-125,171,296,13854,7621
27,lak401d.map,592,401,120384,300,316,291,84,188241,469,228,122,172,-169,-88,257,1203,6184
28,lak401d.map,592,401,181359,452,293,139,107,67519,168,249,423,151,284,-44,328,11331,24134
29,lak401d.map,592,401,106528,265,137,326,263,193402,482,280,109,120,-217,143,360,14730,3824
30,lak401d.map,592,401,230859,575,116,16,284,47014,117,303,474,97,458,187,645,24521,30998
31,lak401d.map,592,401,63274,157,83,434,317,214708,535,227,56,173,-378,144,522,4652,11443
32,lak401d.map,592,401,52307,130,223,461,177,197805,493,288,98,112,-363,65,428,21271,7940
33,lak401d.map,592,401,224337,559,222,32,178,39467,98,231,493,169,461,9,470,5122,5666
34,lak401d.map,592,401,223816,558,342,33,58,182966,456,290,135,110,102,-52,154,2082,2262
35,lak401d.map,592,401,142926,356,230,235,170,95878,239,361,352,39,117,131,248,4444,2653
36,lak401d.map,592,401,73170,182,212,409,188,104013,259,246,332,154,-77,34,111,592,191
37,lak401d.map,592,401,57053,142,289,449,111,112823,281,258,310,142,-139,-31,170,3012,7648
38,lak401d.map,592,401,137721,343,222,248,178,107631,268,237,323,163,75,15,90,91,363
39,lak401d.map,592,401,62091,154,63,437,337,66022,164,142,427,258,-10,79,89,1588,796
40,lak401d.map,592,401,56299,140,241,451,159,219935,548,213,43,187,-408,-28,436,7585,7124
41,lak401d.map,592,401,54315,135,220,456,180,223230,556,126,35,274,-421,-94,515,31019,10735
42,lak401d.map,592,401,148955,371,216,220,184,73988,184,196,407,204,187,-20,207,2727,3092
43,lak401d.map,592,401,97622,243,221,348,179,87590,218,228,373,172,25,7,32,54,52
44,lak401d.map,592,401,177905,443,138,148,262,85610,213,203,378,197,230,65,295,10860,23406
45,lak401d.map,592,401,112842,281,239,310,161,217620,542,122,49,278,-261,-117,378,21042,5988
46,lak401d.map,592,401,73970,184,214,407,186,62324,155,231,436,169,29,17,46,47,123
47,lak401d.map,592,401,108245,269,24,322,376,52629,131,302,460,98,138,278,416,9250,8647
48,lak401d.map,592,401,62306,155,249,436,151,211023,526,303,65,97,-371,54,425,13333,10145
49,lak401d.map,592,401,217797,543,346,48,54,79262,197,135,394,265,346,-211,557,16060,31761
50,lak401d.map,592,401,218693,545,252,46,148,80046,199,153,392,247,346,-99,445,10088,6497
51,lak401d.map,592,401,80056,199,143,392,257,178303,444,141,147,259,-245,-2,247,24684,12922
52,lak401d.map,592,401,144106,359,253,232,147,232459,579,120,12,280,-220,-133,353,14374,5924
53,lak401d.map,592,401,107232,267,235,324,165,175070,436,166,155,234,-169,-69,238,15981,3869
54,lak401d.map,592,401,147729,368,239,223,161,69627,173,146,418,254,195,-93,288,7724,3422
55,lak401d.map,592,401,106097,264,167,327,233,68633,171,338,420,62,93,171,264,3926,6473
56,lak401d.map,592,401,185316,462,346,129,54,87621,218,197,373,203,244,-149,393,12715,27289
57,lak401d.map,592,401,125121,312,391,279,9,67899,169,270,422,130,143,-121,264,5040,2885
58,lak401d.map,592,401,88067,219,152,372,248,233879,583,304,8,96,-364,152,516,35416,22335
59,lak401d.map,592,401,151739,378,239,213,161,183333,457,324,134,76,-79,85,164,11159,4922
60,lak401d.map,592,401,82748,206,258,385,142,154942,386,244,205,156,-180,-14,194,6785,5028
61,lak401d.map,592,401,67952,169,217,422,183,66073,164,91,427,309,5,-126,131,2723,2579
62,lak401d.map,592,401,215499,537,238,54,162,53511,133,222,458,178,404,-16,420,4970,4138
63,lak401d.map,592,401,204338,509,171,82,229,21819,54,235,537,165,455,64,519,8362,19981
64,lak401d.map,592,401,124873,311,238,280,162,215043,536,293,55,107,-225,55,280,3182,2578
65,lak401d.map,592,401,196646,490,244,101,156,197519,492,173,99,227,-2,-71,73,3444,2172
66,lak401d.map,592,401,176898,441,343,150,57,113181,282,301,309,99,159,-42,201,6826,16994
67,lak401d.map,592,401,61513,153,240,438,160,212735,530,195,61,205,-377,-45,422,11224,6645
68,lak401d.map,592,401,140536,350,214,241,186,59523,148,225,443,175,202,11,213,1594,3358
69,lak401d.map,592,401,213924,533,209,58,191,205094,511,217,80,183,22,8,30,473,369
70,lak401d.map,592,401,208393,519,126,72,274,153724,383,259,208,141,136,133,269,6094,13765
71,lak401d.map,592,401,49875,124,249,467,151,104708,261,353,330,47,-137,104,241,11498,4418
72,lak401d.map,592,401,180524,450,326,141,74,4182,10,228,581,172,440,-98,538,10663,28239
73,lak401d.map,592,401,189458,472,214,119,186,55847,139,292,452,108,333,78,411,15565,7029
74,lak401d.map,592,401,193389,482,293,109,107,158591,395,204,196,196,87,-89,176,3378,7459
75,lak401d.map,592,401,85665,213,148,378,252,157745,393,248,198,152,-180,100,280,7576,8889
76,lak401d.map,592,401,111682,278,196,313,204,207202,516,114,75,286,-238,-82,320,21986,6634
77,lak401d.map,592,401,86752,216,264,375,136,4178,10,232,581,168,206,-32,238,262,1525
78,lak401d.map,592,401,29445,73,228,518,172,212582,530,348,61,52,-457,120,577,31254,12144
79,lak401d.map,592,401,63153,157,204,434,196,188287,469,182,122,218,-312,-22,334,23516,10082
80,lak401d.map,592,401,70310,175,265,416,135,106422,265,243,326,157,-90,-22,112,1299,1764
81,lak401d.map,592,401,114784,286,302,305,98,114841,286,245,305,155,0,-57,57,203,109
82,lak401d.map,592,401,106516,265,149,326,251,45463,113,250,478,150,152,101,253,840,8336
83,lak401d.map,592,401,47812,119,307,472,93,65109,162,253,429,147,-43,-54,97,1047,1752
84,lak401d.map,592,401,158944,396,252,195,148,107954,269,315,322,85,127,63,190,10164,6492
85,lak401d.map,592,401,98275,245,370,346,30,164958,411,253,180,147,-166,-117,283,5266,6244
86,lak401d.map,592,401,100680,251,371,340,29,186167,464,297,127,103,-213,-74,287,15764,15281
87,lak401d.map,592,401,7785,19,234,572,166,81580,203,223,388,177,-184,-11,195,598,196
88,lak401d.map,592,401,57096,142,246,449,154,63554,158,204,433,196,-16,-42,58,80,59
89,lak401d.map,592,401,108619,270,51,321,349,85589,213,224,378,176,57,173,230,1979,3422
90,lak401d.map,592,401,52624,131,307,460,93,69139,172,233,419,167,-41,-74,115,388,2056
91,lak401d.map,592,401,229828,573,345,18,55,181476,452,176,139,224,121,-169,290,9236,12635
92,lak401d.map,592,401,159787,398,211,193,189,80462,200,138,391,262,198,-73,271,4667,6127
93,lak401d.map,592,401,127537,318,381,273,19,198308,494,186,97,214,-176,-195,371,16497,17530
94,lak401d.map,592,401,59520,148,228,443,172,187893,468,175,123,225,-320,-53,373,23076,7595
95,lak401d.map,592,401,117185,292,307,299,93,139707,348,241,243,159,-56,-66,122,1387,2165
96,lak401d.map,592,401,46688,116,228,475,172,77196,192,196,399,204,-76,-32,108,1033,112
97,lak401d.map,592,401,155379,387,208,204,192,177735,443,308,148,92,-56,100,156,8243,4180
98,lak401d.map,592,401,17411,43,232,548,168,63847,159,312,432,88,-116,80,196,3325,1337
99,lak401d.map,592,401,107754,268,114,323,286,73710,183,73,408,327,85,-41,126,4624,6464
0,lak403d.map,458,206,24179,117,128,340,77,71558,347,129,110,76,-230,1,231,377,1199
1,lak403d.map,458,206,44666,216,35,241,170,16138,78,135,379,70,138,100,238,816,342
2,lak403d.map,458,206,55378,268,35,189,170,83486,405,149,52,56,-137,114,251,428,443
3,lak403d.map,458,206,55772,270,53,187,152,38406,186,115,271,90,84,62,146,525,169
4,lak403d.map,458,206,78339,380,146,77,59,50764,246,117,211,88,134,-29,163,164,585
5,lak403d.map,458,206,35729,173,114,284,91,60124,291,27,166,178,-118,-87,205,892,618
6,lak403d.map,458,206,42204,204,25,253,180,53918,261,53,196,152,-57,28,85,86,121
7,lak403d.map,458,206,42402,205,33,252,172,51266,248,27,209,178,-43,-6,49,1246,949
8,lak403d.map,458,206,57979,281,112,176,93,30367,147,120,310,85,134,8,142,145,371
9,lak403d.map,458,206,38827,188,106,269,99,54685,265,110,192,95,-77,4,81,391,1037
10,lak403d.map,458,206,77128,374,121,83,84,27673,134,136,323,69,240,15,255,256,256
11,lak403d.map,458,206,59395,288,138,169,67,46862,227,105,230,100,61,-33,94,95,95
12,lak403d.map,458,206,61666,299,133,158,72,63331,307,116,150,89,-8,-17,25,26,26
13,lak403d.map,458,206,36737,178,136,279,69,92167,447,120,10,85,-269,-16,285,286,286
14,lak403d.map,458,206,72185,350,120,107,85,53701,260,64,197,141,90,-56,146,147,147
15,lak403d.map,458,206,59277,287,50,170,155,16558,80,127,377,78,207,77,284,701,414
16,lak403d.map,458,206,57667,279,12,178,193,40620,197,167,260,38,82,155,237,1288,1034
17,lak403d.map,458,206,57610,279,69,178,136,39805,193,158,264,47,86,89,175,854,744
18,lak403d.map,458,206,59250,287,77,170,128,61509,298,84,159,121,-11,7,18,19,19
19,lak403d.map,458,206,82906,402,111,55,94,76503,371,128,86,77,31,17,48,49,49
20,lak403d.map,458,206,38291,185,24,272,181,70934,344,135,113,70,-159,111,270,275,1223
21,lak403d.map,458,206,4603,22,134,435,71,29541,143,122,314,83,-121,-12,133,326,134
22,lak403d.map,458,206,42202,204,27,253,178,39285,190,60,267,145,14,33,47,121,663
23,lak403d.map,458,206,37850,183,53,274,152,16149,78,124,379,81,105,71,176,809,2780
24,lak403d.map,458,206,41603,201,8,256,197,56533,274,116,183,89,-73,108,181,286,8409
25,lak403d.map,458,206,11609,56,132,401,73,51857,251,54,206,151,-195,-78,273,402,649
26,lak403d.map,458,206,37652,182,45,275,160,53335,258,18,199,187,-76,-27,103,2036,1059
27,lak403d.map,458,206,8112,39,127,418,78,44992,218,121,239,84,-179,-6,185,310,186
28,lak403d.map,458,206,54776,265,19,192,186,41692,202,125,255,80,63,106,169,817,839
29,lak403d.map,458,206,92577,449,122,8,83,58061,281,30,176,175,168,-92,260,325,261
30,lak403d.map,458,206,38818,188,115,269,90,84557,410,108,47,97,-222,-7,229,1166,699
31,lak403d.map,458,206,38075,184,34,273,171,42684,207,163,250,42,-23,129,152,1757,2093
32,lak403d.map,458,206,78352,380,133,77,72,46652,226,109,231,96,154,-24,178,179,179
33,lak403d.map,458,206,52212,253,111,204,94,35647,173,196,284,9,80,85,165,1042,213
34,lak403d.map,458,206,2139,10,126,447,79,32621,158,132,299,73,-148,6,154,1122,282
35,lak403d.map,458,206,56982,276,79,181,126,75871,368,142,89,63,-92,63,155,217,477
36,lak403d.map,458,206,51059,247,28,210,177,3580,17,127,440,78,230,99,329,746,1315
37,lak403d.map,458,206,72163,350,142,107,63,52493,254,36,203,169,96,-106,202,203,437
38,lak403d.map,458,206,19446,94,123,363,82,82679,401,132,56,73,-307,9,316,670,319
39,lak403d.map,458,206,58843,285,72,172,133,40955,198,38,259,167,87,-34,121,123,519
40,lak403d.map,458,206,21080,102,137,355,68,37925,184,184,273,21,-82,47,129,2434,2365
41,lak403d.map,458,206,82464,400,141,57,64,42062,204,167,253,38,196,26,222,837,1791
42,lak403d.map,458,206,56976,276,85,181,120,64356,312,121,145,84,-36,36,72,74,289
43,lak403d.map,458,206,38256,185,59,272,146,76516,371,115,86,90,-186,56,242,5491,355
44,lak403d.map,458,206,79407,385,108,72,97,73623,357,124,100,81,28,16,44,45,45
45,lak403d.map,458,206,58982,286,139,171,66,78959,383,144,74,61,-97,5,102,160,474
46,lak403d.map,458,206,55128,267,79,190,126,47492,230,93,227,112,37,14,51,52,94
47,lak403d.map,458,206,15321,74,128,383,77,45399,220,126,237,79,-146,-2,148,296,280
48,lak403d.map,458,206,44171,214,118,243,87,84943,412,134,45,71,-198,16,214,215,215
49,lak403d.map,458,206,45862,222,75,235,130,58287,282,10,175,195,-60,-65,125,126,207
50,lak403d.map,458,206,58633,284,76,173,129,40655,197,132,260,73,87,56,143,491,436
51,lak403d.map,458,206,37776,183,127,274,78,84729,411,142,46,63,-228,15,243,889,244
52,lak403d.map,458,206,39341,190,4,267,201,59454,288,79,169,126,-98,75,173,500,174
53,lak403d.map,458,206,42281,205,154,252,51,42431,205,4,252,201,0,-150,150,3989,1653
54,lak403d.map,458,206,44000,213,83,244,122,48975,237,52,220,153,-24,-31,55,56,56
55,lak403d.map,458,206,41464,201,147,256,58,54156,262,21,195,184,-61,-126,187,809,923
56,lak403d.map,458,206,46652,226,109,231,96,47934,232,63,225,142,-6,-46,52,53,53
57,lak403d.map,458,206,55520,269,99,188,106,46027,223,116,234,89,46,17,63,76,64
58,lak403d.map,458,206,47963,232,34,225,171,44399,215,96,242,109,17,62,79,80,80
59,lak403d.map,458,206,45627,221,104,236,101,60454,293,109,164,96,-72,5,77,91,79
60,lak403d.map,458,206,82705,401,106,56,99,41182,199,17,258,188,202,-89,291,9974,7958
61,lak403d.map,458,206,10584,51,127,406,78,46007,223,136,234,69,-172,9,181,1109,862
62,lak403d.map,458,206,40952,198,41,259,164,48403,234,6,223,199,-36,-35,71,2785,824
63,lak403d.map,458,206,52929,256,12,201,193,44470,215,25,242,180,41,13,54,1808,1229
64,lak403d.map,458,206,44682,216,19,241,186,50415,244,54,213,151,-28,35,63,64,64
65,lak403d.map,458,206,87202,423,141,34,64,81453,395,122,62,83,28,-19,47,90,56
66,lak403d.map,458,206,57866,280,19,177,186,47467,230,118,227,87,50,99,149,174,150
67,lak403d.map,458,206,49178,238,55,219,150,54791,265,4,192,201,-27,-51,78,84,178
68,lak403d.map,458,206,60427,293,136,164,69,53651,260,114,197,91,33,-22,55,56,56
69,lak403d.map,458,206,37872,183,31,274,174,29124,141,127,316,78,42,96,138,1195,2005
70,lak403d.map,458,206,59693,289,46,168,159,46085,223,58,234,147,66,12,78,79,79
71,lak403d.map,458,206,39290,190,55,267,150,52182,253,141,204,64,-63,86,149,154,998
72,lak403d.map,458,206,60464,293,99,164,106,39331,190,14,267,191,103,-85,188,248,208
73,lak403d.map,458,206,37357,181,134,276,71,45463,220,62,237,143,-39,-72,111,138,346
74,lak403d.map,458,206,51163,248,130,209,75,79181,384,128,73,77,-136,-2,138,139,139
75,lak403d.map,458,206,50945,247,142,210,63,45260,219,59,238,146,28,-83,111,112,112
76,lak403d.map,458,206,48496,235,119,222,86,59819,290,126,167,79,-55,7,62,63,63
77,lak403d.map,458,206,47913,232,84,225,121,59925,290,20,167,185,-58,-64,122,123,143
78,lak403d.map,458,206,81236,394,133,63,72,46463,225,92,232,113,169,-41,210,211,211
79,lak403d.map,458,206,42050,204,179,253,26,54502,264,87,193,118,-60,-92,152,192,370
80,lak403d.map,458,206,14290,69,129,388,76,58626,284,83,173,122,-215,-46,261,370,278
81,lak403d.map,458,206,40466,196,115,261,90,47571,230,14,227,191,-34,-101,135,233,2074
82,lak403d.map,458,206,89680,435,135,22,70,51161,248,132,209,73,187,-3,190,191,346
83,lak403d.map,458,206,72378,351,133,106,72,37151,180,134,277,71,171,1,172,173,173
84,lak403d.map,458,206,53514,259,45,198,160,53490,259,69,198,136,0,24,24,25,25
85,lak403d.map,458,206,76897,373,146,84,59,48071,233,132,224,73,140,-14,154,155,706
86,lak403d.map,458,206,46658,226,103,231,102,50253,243,10,214,195,-17,-93,110,1103,177
87,lak403d.map,458,206,42153,204,76,253,129,72378,351,133,106,72,-147,57,204,205,433
88,lak403d.map,458,206,49995,242,62,215,143,45043,218,70,239,135,24,8,32,33,33
89,lak403d.map,458,206,88019,427,148,30,57,37511,182,186,275,19,245,38,283,1429,2530
90,lak403d.map,458,206,41764,202,53,255,152,56317,273,126,184,79,-71,73,144,149,335
91,lak403d.map,458,206,48506,235,109,222,96,45046,218,67,239,138,17,-42,59,61,88
92,lak403d.map,458,206,10377,50,128,407,77,78362,380,123,77,82,-330,-5,335,336,336
93,lak403d.map,458,206,43312,210,153,247,52,56946,276,115,181,90,-66,-38,104,108,106
94,lak403d.map,458,206,43857,212,20,245,185,53665,260,100,197,105,-48,80,128,129,129
95,lak403d.map,458,206,73625,357,122,100,83,57255,277,12,180,193,80,-110,190,385,191
96,lak403d.map,458,206,59450,288,83,169,122,36539,177,128,280,77,111,45,156,169,183
97,lak403d.map,458,206,84731,411,140,46,65,52860,256,81,201,124,155,-59,214,217,5163
98,lak403d.map,458,206,51000,247,87,210,118,60457,293,106,164,99,-46,19,65,66,66
99,lak403d.map,458,206,47757,231,34,226,171,43838,212,39,245,166,19,5,24,25,25
0,lak404d.map,67,514,14984,29,435,37,78,17633,34,356,32,157,-5,-79,84,186,1120
1,lak404d.map,67,514,23760,46,397,20,116,14868,28,37,38,476,18,-360,378,6999,5079
2,lak404d.map,67,514,20050,39,509,27,4,18014,35,489,31,24,4,-20,24,36,25
3,lak404d.map,67,514,17107,33,368,33,145,20212,39,347,27,166,-6,-21,27,28,28
4,lak404d.map,67,514,12543,24,306,42,207,17759,34,230,32,283,-10,-76,86,228,525
5,lak404d.map,67,514,17209,33,266,33,247,17334,33,141,33,372,0,-125,125,605,305
6,lak404d.map,67,514,5145,10,508,56,5,11780,22,41,44,472,-12,-467,479,7295,7819
7,lak404d.map,67,514,19777,38,268,28,245,21269,41,318,25,195,-3,50,53,350,701
8,lak404d.map,67,514,23438,45,205,21,308,16583,32,378,34,135,13,173,186,2348,3456
9,lak404d.map,67,514,10522,20,271,46,242,19535,38,510,28,3,-18,239,257,274,2608
10,lak404d.map,67,514,15672,30,261,36,252,13509,26,368,40,145,4,107,111,1057,1476
11,lak404d.map,67,514,18531,36,486,30,27,9927,19,352,47,161,17,-134,151,1166,907
12,lak404d.map,67,514,18267,35,236,31,277,23894,46,263,20,250,-11,27,38,39,39
13,lak404d.map,67,514,19211,37,320,29,193,31572,61,295,5,218,-24,-25,49,50,62
14,lak404d.map,67,514,19900,38,145,28,368,12055,23,280,43,233,15,135,150,327,158
15,lak404d.map,67,514,14858,28,47,38,466,24716,48,469,18,44,-20,422,442,6170,6944
16,lak404d.map,67,514,23904,46,253,20,260,19202,37,329,29,184,9,76,85,662,701
17,lak404d.map,67,514,24328,47,343,19,170,17514,34,475,32,38,13,132,145,490,146
18,lak404d.map,67,514,29273,56,24,10,489,19516,37,15,29,498,19,-9,28,370,561
19,lak404d.map,67,514,19628,38,417,28,96,19679,38,366,28,147,0,-51,51,52,52
20,lak404d.map,67,514,18914,36,103,30,410,27927,54,342,12,171,-18,239,257,3431,2113
21,lak404d.map,67,514,17954,34,35,32,478,26879,52,362,14,151,-18,327,345,5378,3311
22,lak404d.map,67,514,21850,42,251,24,262,22290,43,325,23,188,-1,74,75,641,641
23,lak404d.map,67,514,24224,47,447,19,66,20058,39,501,27,12,8,54,62,63,63
24,lak404d.map,67,514,21036,40,37,26,476,26884,52,357,14,156,-12,320,332,4997,1820
25,lak404d.map,67,514,20128,39,431,27,82,26534,51,193,15,320,-12,-238,250,4755,1862
26,lak404d.map,67,514,11062,21,245,45,268,21783,42,318,24,195,-21,73,94,111,167
27,lak404d.map,67,514,11638,22,183,44,330,21183,41,404,25,109,-19,221,240,1994,4612
28,lak404d.map,67,514,12040,23,295,43,218,20475,39,84,27,429,-16,-211,227,235,698
29,lak404d.map,67,514,4123,8,502,58,11,13813,26,64,40,449,-18,-438,456,7151,7787
30,lak404d.map,67,514,20506,39,53,27,460,14447,28,458,38,55,11,405,416,5940,4040
31,lak404d.map,67,514,10835,21,472,45,41,23853,46,304,20,209,-25,-168,193,208,1538
32,lak404d.map,67,514,12785,24,64,42,449,15886,30,47,36,466,-6,-17,23,24,24
33,lak404d.map,67,514,15222,29,197,37,316,25614,49,85,17,428,-20,-112,132,150,456
34,lak404d.map,67,514,20610,40,463,26,50,17898,34,91,32,422,6,-372,378,5406,2944
35,lak404d.map,67,514,23761,46,396,20,117,15741,30,192,36,321,16,-204,220,4353,2125
36,lak404d.map,67,514,27390,53,365,13,148,30879,60,474,6,39,-7,109,116,1012,872
37,lak404d.map,67,514,17953,34,36,32,477,24742,48,443,18,70,-14,407,421,6082,5111
38,lak404d.map,67,514,22160,43,455,23,58,28600,55,183,11,330,-12,-272,284,5372,2400
39,lak404d.map,67,514,29267,56,30,10,483,26439,51,288,15,225,5,258,263,2881,1546
40,lak404d.map,67,514,22401,43,214,23,299,17719,34,270,32,243,9,56,65,94,66
41,lak404d.map,67,514,29435,57,376,9,137,17038,33,437,33,76,24,61,85,893,89
42,lak404d.map,67,514,21904,42,197,24,316,24034,46,123,20,390,-4,-74,78,102,116
43,lak404d.map,67,514,22313,43,302,23,211,22083,42,18,24,495,1,-284,285,1151,3844
44,lak404d.map,67,514,15154,29,265,37,248,29005,56,292,10,221,-27,27,54,96,106
45,lak404d.map,67,514,9498,18,267,48,246,30802,59,37,7,476,-41,-230,271,360,1518
46,lak404d.map,67,514,26380,51,347,15,166,9181,17,70,49,443,34,-277,311,3677,4441
47,lak404d.map,67,514,17075,33,400,33,113,27285,53,470,13,43,-20,70,90,91,300
48,lak404d.map,67,514,31104,60,249,6,264,28016,54,253,12,260,6,4,10,11,11
49,lak404d.map,67,514,18817,36,200,30,313,11881,23,454,43,59,13,254,267,3787,4437
50,lak404d.map,67,514,11832,23,503,43,10,19788,38,257,28,256,-15,-246,261,4529,3435
51,lak404d.map,67,514,13488,26,389,40,124,31685,61,182,5,331,-35,-207,242,4782,2997
52,lak404d.map,67,514,19443,37,88,29,425,21476,41,111,25,402,-4,23,27,28,38
53,lak404d.map,67,514,11065,21,242,45,271,32021,62,360,4,153,-41,118,159,176,694
54,lak404d.map,67,514,31389,61,478,5,35,31566,61,301,5,212,0,-177,177,961,1782
55,lak404d.map,67,514,20950,40,123,26,390,28031,54,238,12,275,-14,115,129,130,130
56,lak404d.map,67,514,25842,50,371,16,142,24284,47,387,19,126,3,16,19,20,20
57,lak404d.map,67,514,15336,29,83,37,430,21454,41,133,25,380,-12,50,62,65,239
58,lak404d.map,67,514,17880,34,109,32,404,18926,36,91,30,422,-2,-18,20,61,34
59,lak404d.map,67,514,20769,40,304,26,209,17450,33,25,33,488,7,-279,286,5245,4652
60,lak404d.map,67,514,9374,18,391,48,122,32134,62,247,4,266,-44,-144,188,196,1720
61,lak404d.map,67,514,20644,40,429,26,84,11791,22,30,44,483,18,-399,417,5509,4799
62,lak404d.map,67,514,16825,32,136,34,377,22683,44,446,22,67,-12,310,322,3068,5211
63,lak404d.map,67,514,18621,36,396,30,117,22975,44,154,22,359,-8,-242,250,3779,2387
64,lak404d.map,67,514,14448,28,457,38,56,10326,20,467,46,46,8,10,18,19,19
65,lak404d.map,67,514,15576,30,357,36,156,20121,39,438,27,75,-9,81,90,93,164
66,lak404d.map,67,514,20649,40,424,26,89,17082,33,393,33,120,7,-31,38,60,39
67,lak404d.map,67,514,22884,44,245,22,268,12054,23,281,43,232,21,36,57,58,58
68,lak404d.map,67,514,20008,38,37,28,476,20685,40,388,26,125,-2,351,353,4165,2612
69,lak404d.map,67,514,14453,28,452,38,61,29261,56,36,10,477,-28,-416,444,6052,7038
70,lak404d.map,67,514,17741,34,248,32,265,20831,40,242,26,271,-6,-6,12,13,13
71,lak404d.map,67,514,14511,28,394,38,119,20983,40,90,26,423,-12,-304,316,3257,3837
72,lak404d.map,67,514,21417,41,170,25,343,21678,42,423,24,90,-1,253,254,2117,2860
73,lak404d.map,67,514,13058,25,305,41,208,10237,19,42,47,471,6,-263,269,2216,2312
74,lak404d.map,67,514,21732,42,369,24,144,13086,25,277,41,236,17,-92,109,664,118
75,lak404d.map,67,514,28754,55,29,11,484,14637,28,268,38,245,27,239,266,1152,408
76,lak404d.map,67,514,7988,15,235,51,278,28742,55,41,11,472,-40,-194,234,281,1514
77,lak404d.map,67,514,21091,41,496,25,17,26957,52,284,14,229,-11,-212,223,227,224
78,lak404d.map,67,514,17938,34,51,32,462,22347,43,268,23,245,-9,217,226,227,681
79,lak404d.map,67,514,23689,46,468,20,45,16723,32,238,34,275,14,-230,244,3413,1275
80,lak404d.map,67,514,8883,17,368,49,145,7197,14,512,52,1,3,144,147,1825,2212
81,lak404d.map,67,514,20222,39,337,27,176,22374,43,241,23,272,-4,-96,100,945,996
82,lak404d.map,67,514,13412,26,465,40,48,20478,39,81,27,432,-13,-384,397,4240,5173
83,lak404d.map,67,514,31299,60,54,6,459,17595,34,394,32,119,26,340,366,5007,4758
84,lak404d.map,67,514,18020,35,483,31,30,18622,36,395,30,118,-1,-88,89,248,176
85,lak404d.map,67,514,16705,32,256,34,257,21661,42,440,24,73,-10,184,194,667,2723
86,lak404d.map,67,514,13880,27,511,39,2,20237,39,322,27,191,-12,-189,201,218,1505
87,lak404d.map,67,514,11753,22,68,44,445,21119,41,468,25,45,-19,400,419,3873,6784
88,lak404d.map,67,514,19006,36,11,30,502,30030,58,295,8,218,-22,284,306,329,772
89,lak404d.map,67,514,26642,51,85,15,428,25734,50,479,16,34,1,394,395,4718,5993
90,lak404d.map,67,514,20061,39,498,27,15,21006,40,67,26,446,-1,-431,432,4790,3667
91,lak404d.map,67,514,30038,58,287,8,226,10607,20,186,46,327,38,-101,139,966,164
92,lak404d.map,67,514,17409,33,66,33,447,32871,63,24,3,489,-30,-42,72,305,139
93,lak404d.map,67,514,17948,34,41,32,472,20431,39,128,27,385,-5,87,92,93,203
94,lak404d.map,67,514,23330,45,313,21,200,24546,47,125,19,388,-2,-188,190,1564,2413
95,lak404d.map,67,514,28424,55,359,11,154,22742,44,387,22,126,11,28,39,40,40
96,lak404d.map,67,514,17370,33,105,33,408,27587,53,168,13,345,-20,63,83,1316,493
97,lak404d.map,67,514,13024,25,339,41,174,13071,25,292,41,221,0,-47,47,329,421
98,lak404d.map,67,514,14123,27,268,39,245,21947,42,154,24,359,-15,-114,129,133,275
99,lak404d.map,67,514,20616,40,457,26,56,25139,48,46,18,467,-8,-411,419,5306,4298
0,lak405d.map,1005,782,692873,886,760,118,21,436889,558,248,446,533,328,-512,840,12161,6995
1,lak405d.map,1005,782,690376,882,129,122,652,670974,858,763,146,18,24,634,658,15295,11633
2,lak405d.map,1005,782,119441,152,204,852,577,143531,183,356,821,425,-31,152,183,1763,1229
3,lak405d.map,1005,782,118674,151,189,853,592,432172,552,273,452,508,-401,84,485,11079,14577
4,lak405d.map,1005,782,111614,142,211,862,570,694942,888,255,116,526,-746,44,790,19835,25077
5,lak405d.map,1005,782,563505,720,316,284,465,53804,68,153,936,628,652,-163,815,21874,19324
6,lak405d.map,1005,782,684815,875,216,129,565,532799,681,524,323,257,194,308,502,6870,3628
7,lak405d.map,1005,782,49142,62,123,942,658,393247,502,98,502,683,-440,-25,465,20532,16225
8,lak405d.map,1005,782,145884,186,349,818,432,281141,359,378,645,403,-173,29,202,2040,3524
9,lak405d.map,1005,782,118696,151,167,853,614,684961,875,70,129,711,-724,-97,821,25534,27269
10,lak405d.map,1005,782,685697,876,116,128,665,629523,805,768,199,13,71,652,723,16967,15474
11,lak405d.map,1005,782,658960,842,265,162,516,681645,871,258,133,523,-29,-7,36,42,37
12,lak405d.map,1005,782,2161,2,184,1002,597,635811,813,736,191,45,-811,552,1363,24323,34159
13,lak405d.map,1005,782,422776,540,285,464,496,521945,667,430,337,351,-127,145,272,2370,1833
14,lak405d.map,1005,782,476810,609,209,395,572,523614,669,325,335,456,-60,116,176,2041,2909
15,lak405d.map,1005,782,558603,714,526,290,255,245164,313,383,691,398,401,-143,544,8046,10699
16,lak405d.map,1005,782,99067,126,246,878,535,28774,36,159,968,622,90,-87,177,2233,3741
17,lak405d.map,1005,782,642082,821,721,183,60,660557,844,232,160,549,-23,-489,512,10907,13183
18,lak405d.map,1005,782,76489,97,146,907,635,342137,437,378,567,403,-340,232,572,8252,9202
19,lak405d.map,1005,782,136528,174,321,830,460,706707,903,220,101,561,-729,-101,830,19577,19548
20,lak405d.map,1005,782,590657,755,534,249,247,685839,877,756,127,25,-122,222,344,1425,3600
21,lak405d.map,1005,782,725721,928,756,76,25,603158,771,545,233,236,157,-211,368,5327,1625
22,lak405d.map,1005,782,691856,884,213,120,568,113244,144,145,860,636,740,-68,808,28550,22024
23,lak405d.map,1005,782,670938,857,17,147,764,67087,85,164,919,617,772,147,919,29703,27853
24,lak405d.map,1005,782,375788,480,353,524,428,210797,269,342,735,439,211,-11,222,1120,2803
25,lak405d.map,1005,782,715289,914,240,90,541,637387,815,724,189,57,99,484,583,13446,11932
26,lak405d.map,1005,782,713720,912,245,92,536,29561,37,154,967,627,875,-91,966,29468,21790
27,lak405d.map,1005,782,128891,164,138,840,643,96692,123,275,881,506,41,137,178,527,196
28,lak405d.map,1005,782,10788,13,159,991,622,317903,406,370,598,411,-393,211,604,12231,11576
29,lak405d.map,1005,782,253760,324,389,680,392,680168,869,171,135,610,-545,-218,763,13234,10292
30,lak405d.map,1005,782,525841,672,444,332,337,689601,881,122,123,659,-209,-322,531,816,1036
31,lak405d.map,1005,782,242867,310,334,694,447,706709,903,218,101,563,-593,-116,709,14182,14543
32,lak405d.map,1005,782,214664,274,385,730,396,695225,889,754,115,27,-615,369,984,14742,19480
33,lak405d.map,1005,782,501724,641,319,363,462,241301,308,336,696,445,333,17,350,5971,6877
34,lak405d.map,1005,782,665521,851,742,153,39,691914,884,155,120,626,-33,-587,620,11609,17033
35,lak405d.map,1005,782,115520,147,215,857,566,118681,151,182,853,599,-4,-33,37,38,40
36,lak405d.map,1005,782,100615,128,262,876,519,4511,5,180,999,601,123,-82,205,4378,5148
37,lak405d.map,1005,782,550000,703,527,301,254,44445,56,128,948,653,647,-399,1046,24463,20842
38,lak405d.map,1005,782,254552,325,379,679,402,679341,868,216,136,565,-543,-163,706,9230,9086
39,lak405d.map,1005,782,5362,6,111,998,670,518862,663,385,341,396,-657,274,931,20097,22730
40,lak405d.map,1005,782,584393,747,542,257,239,631189,807,666,197,115,-60,124,184,1395,328
41,lak405d.map,1005,782,415753,531,270,473,511,442438,565,173,439,608,-34,-97,131,2979,1200
42,lak405d.map,1005,782,84178,107,277,897,504,716075,915,236,89,545,-808,-41,849,18173,20247
43,lak405d.map,1005,782,201360,257,395,747,386,439235,561,248,443,533,-304,-147,451,3573,4465
44,lak405d.map,1005,782,15492,19,147,985,634,669916,856,257,148,524,-837,110,947,22346,29571
45,lak405d.map,1005,782,9253,11,130,993,651,128117,163,130,841,651,-152,0,152,2083,2816
46,lak405d.map,1005,782,7624,9,195,995,586,50671,64,158,940,623,-55,-37,92,888,831
47,lak405d.map,1005,782,444000,567,175,437,606,497032,635,319,369,462,-68,144,212,2647,4488
48,lak405d.map,1005,782,142186,181,137,823,644,583589,746,564,258,217,-565,427,992,20822,24479
49,lak405d.map,1005,782,412787,527,108,477,673,428230,547,305,457,476,-20,197,217,2207,4483
50,lak405d.map,1005,782,577378,738,519,266,262,588275,752,570,252,211,-14,51,65,66,156
51,lak405d.map,1005,782,638952,817,723,187,58,13151,16,142,988,639,801,-581,1382,31139,24334
52,lak405d.map,1005,782,576817,737,298,267,483,267062,341,381,663,400,396,83,479,3338,6939
53,lak405d.map,1005,782,724945,927,750,77,31,373436,477,359,527,422,450,-391,841,14394,10961
54,lak405d.map,1005,782,74913,95,158,909,623,436211,557,144,447,637,-462,-14,476,20368,17068
55,lak405d.map,1005,782,488440,624,309,380,472,574253,734,516,270,265,-110,207,317,3147,1935
56,lak405d.map,1005,782,520346,665,465,339,316,314763,402,382,602,399,263,-83,346,4445,6859
57,lak405d.map,1005,782,642848,822,737,182,44,441650,564,179,440,602,258,-558,816,16205,8458
58,lak405d.map,1005,782,686493,877,102,127,679,210791,269,348,735,433,608,246,854,15556,12261
59,lak405d.map,1005,782,593008,758,529,246,252,674607,862,258,142,523,-104,-271,375,7695,9293
60,lak405d.map,1005,782,6959,8,78,996,703,764831,978,746,26,35,-970,668,1638,28000,33422
61,lak405d.map,1005,782,642088,821,715,183,66,575027,735,524,269,257,86,-191,277,936,2141
62,lak405d.map,1005,782,112384,143,223,861,558,698308,892,17,112,764,-749,-206,955,22634,25809
63,lak405d.map,1005,782,698857,893,250,111,531,687353,878,24,126,757,15,-226,241,3273,1939
64,lak405d.map,1005,782,10848,13,99,991,682,525018,671,485,333,296,-658,386,1044,18833,25851
65,lak405d.map,1005,782,58507,74,142,930,639,115534,147,201,857,580,-73,59,132,1248,308
66,lak405d.map,1005,782,595395,761,488,243,293,666037,851,226,153,555,-90,-262,352,4995,11464
67,lak405d.map,1005,782,717600,917,275,87,506,117166,149,133,855,648,768,-142,910,28904,23306
68,lak405d.map,1005,782,674907,863,740,141,41,665211,850,270,154,511,13,-470,483,14428,16113
69,lak405d.map,1005,782,92816,118,241,886,540,634293,811,690,193,91,-693,449,1142,18475,22179
70,lak405d.map,1005,782,600058,767,517,237,264,697508,891,35,113,746,-124,-482,606,5225,12928
71,lak405d.map,1005,782,596129,762,536,242,245,760918,973,749,31,32,-211,213,424,2989,5044
72,lak405d.map,1005,782,685588,876,225,128,556,41293,52,152,952,629,824,-73,897,29339,21850
73,lak405d.map,1005,782,599254,766,539,238,242,390655,499,344,505,437,267,-195,462,7903,5289
74,lak405d.map,1005,782,542964,694,525,310,256,200591,256,382,748,399,438,-143,581,13148,11223
75,lak405d.map,1005,782,450976,576,237,428,544,694179,887,236,117,545,-311,-1,312,4947,10386
76,lak405d.map,1005,782,250624,320,397,684,384,75703,96,150,908,631,224,-247,471,8231,4371
77,lak405d.map,1005,782,689456,881,267,123,514,722599,924,750,80,31,-43,483,526,16054,14430
78,lak405d.map,1005,782,687186,878,191,126,590,50700,64,129,940,652,814,-62,876,28653,22195
79,lak405d.map,1005,782,581977,744,612,260,169,697331,891,212,113,569,-147,-400,547,6218,12323
80,lak405d.map,1005,782,631181,807,674,197,107,592263,757,492,247,289,50,-182,232,893,2121
81,lak405d.map,1005,782,264715,338,382,666,399,667845,854,764,150,17,-516,382,898,13622,13892
82,lak405d.map,1005,782,679384,868,173,136,608,529840,677,355,327,426,191,182,373,4598,4046
83,lak405d.map,1005,782,465011,594,278,410,503,681140,871,763,133,18,-277,485,762,5932,7523
84,lak405d.map,1005,782,356219,455,372,549,409,678805,868,752,136,29,-413,380,793,9356,15813
85,lak405d.map,1005,782,69442,88,155,916,626,604758,773,509,231,272,-685,354,1039,23209,25808
86,lak405d.map,1005,782,585197,748,520,256,261,691110,883,177,121,604,-135,-343,478,5060,10171
87,lak405d.map,1005,782,414962,530,279,474,502,162271,207,384,797,397,323,105,428,5200,4328
88,lak405d.map,1005,782,707453,904,256,100,525,587430,751,633,253,148,153,377,530,9469,8598
89,lak405d.map,1005,782,537497,687,518,317,263,276453,353,374,651,407,334,-144,478,9487,9213
90,lak405d.map,1005,782,511108,653,319,351,462,681150,871,753,133,28,-218,434,652,4810,6660
91,lak405d.map,1005,782,706713,903,214,101,567,415709,531,314,473,467,372,100,472,9093,7853
92,lak405d.map,1005,782,251425,321,378,683,403,91222,116,271,888,510,205,-107,312,3378,3367
93,lak405d.map,1005,782,28021,35,130,969,651,669158,855,233,149,548,-820,103,923,21745,28681
94,lak405d.map,1005,782,78826,100,155,904,626,684291,875,740,129,41,-775,585,1360,26834,31605
95,lak405d.map,1005,782,653522,835,229,169,552,639421,817,254,187,527,18,25,43,57,267
96,lak405d.map,1005,782,528196,675,435,329,346,588303,752,542,252,239,-77,107,184,740,2662
97,lak405d.map,1005,782,107774,137,141,867,640,689591,881,132,123,649,-744,-9,753,22508,28442
98,lak405d.map,1005,782,264705,338,392,666,389,87310,111,273,893,508,227,-119,346,3297,2699
99,lak405d.map,1005,782,670728,857,227,147,554,680072,869,267,135,514,-12,40,52,53,53
0,lak503d.map,192,191,27043,141,78,50,112,26204,137,153,54,37,4,75,79,534,395
1,lak503d.map,192,191,22868,119,51,72,139,22270,116,76,75,114,3,25,28,13366,7216
2,lak503d.map,192,191,21616,113,157,78,33,9829,51,102,140,88,62,-55,117,11170,8161
3,lak503d.map,192,191,25425,133,168,58,22,26860,140,70,51,120,-7,-98,105,612,713
4,lak503d.map,192,191,21736,113,37,78,153,11199,58,69,133,121,55,32,87,89,126
5,lak503d.map,192,191,31051,162,81,29,109,5453,28,85,163,105,134,4,138,2407,2810
6,lak503d.map,192,191,35435,185,90,6,100,16411,85,14,106,176,100,-76,176,3129,545
7,lak503d.map,192,191,8572,44,22,147,168,15509,81,152,110,38,-37,130,167,9413,9451
8,lak503d.map,192,191,23512,123,171,68,19,13399,70,161,121,29,53,-10,63,539,991
9,lak503d.map,192,191,8330,43,73,148,117,28050,146,26,45,164,-103,-47,150,321,201
10,lak503d.map,192,191,32746,171,105,20,85,17092,89,97,102,93,82,-8,90,8127,5109
11,lak503d.map,192,191,6843,35,32,156,158,24557,128,81,63,109,-93,49,142,15778,10980
12,lak503d.map,192,191,20217,105,28,86,162,9023,47,144,144,46,58,116,174,10727,7540
13,lak503d.map,192,191,5961,31,150,160,40,6199,32,103,159,87,-1,-47,48,10676,10634
14,lak503d.map,192,191,16528,86,88,105,102,26785,140,145,51,45,-54,57,111,4149,4290
15,lak503d.map,192,191,29124,152,98,39,92,20285,106,151,85,39,46,53,99,1785,1128
16,lak503d.map,192,191,8059,42,153,149,37,33862,177,135,14,55,-135,-18,153,5853,3430
17,lak503d.map,192,191,9680,50,60,141,130,9687,50,53,141,137,0,-7,7,22,21
18,lak503d.map,192,191,19947,104,107,87,83,25078,131,133,60,57,-27,26,53,4803,5877
19,lak503d.map,192,191,16705,87,102,104,88,26313,137,44,54,146,-50,-58,108,5817,12489
20,lak503d.map,192,191,6788,35,87,156,103,2750,14,114,177,76,21,27,48,49,53
21,lak503d.map,192,191,13780,72,162,119,28,24590,128,48,63,142,-56,-114,170,6497,5323
22,lak503d.map,192,191,35972,188,126,3,64,8326,43,77,148,113,145,-49,194,3655,2804
23,lak503d.map,192,191,106,0,84,191,106,12955,67,32,124,158,-67,-52,119,1475,515
24,lak503d.map,192,191,641,3,122,188,68,28362,148,96,43,94,-145,-26,171,3866,5581
25,lak503d.map,192,191,35809,187,98,4,92,7917,41,104,150,86,146,6,152,3730,3318
26,lak503d.map,192,191,14402,75,113,116,77,24749,129,80,62,110,-54,-33,87,1632,1231
27,lak503d.map,192,191,12059,63,164,128,26,24877,130,143,61,47,-67,-21,88,2208,1199
28,lak503d.map,192,191,13443,70,117,121,73,9861,51,70,140,120,19,-47,66,9209,12243
29,lak503d.map,192,191,21589,113,184,78,6,26191,137,166,54,24,-24,-18,42,57,59
30,lak503d.map,192,191,23177,121,124,70,66,12545,65,60,126,130,56,-64,120,8746,14810
31,lak503d.map,192,191,25491,133,102,58,88,23934,125,131,66,59,8,29,37,5251,10144
32,lak503d.map,192,191,7941,41,80,150,110,21079,110,121,81,69,-69,41,110,14901,9734
33,lak503d.map,192,191,29337,153,76,38,114,16801,87,6,104,184,66,-70,136,2597,512
34,lak503d.map,192,191,13440,70,120,121,70,21623,113,150,78,40,-43,30,73,191,667
35,lak503d.map,192,191,24136,126,120,65,70,31019,162,113,29,77,-36,-7,43,5092,9836
36,lak503d.map,192,191,24658,129,171,62,19,27781,145,104,46,86,-16,-67,83,493,589
37,lak503d.map,192,191,13577,71,174,120,16,22949,120,161,71,29,-49,-13,62,937,747
38,lak503d.map,192,191,8648,45,137,146,53,23884,125,181,66,9,-80,44,124,1074,186
39,lak503d.map,192,191,28364,148,94,43,96,12749,66,47,125,143,82,-47,129,175,371
40,lak503d.map,192,191,34105,178,83,13,107,12277,64,137,127,53,114,54,168,3640,5206
41,lak503d.map,192,191,32346,169,123,22,67,21119,110,81,81,109,59,-42,101,8729,5492
42,lak503d.map,192,191,6618,34,66,157,124,12082,63,141,128,49,-29,75,104,9803,10161
43,lak503d.map,192,191,22353,117,184,74,6,13719,71,32,120,158,46,-152,198,4615,4417
44,lak503d.map,192,191,9698,50,42,141,148,12557,65,48,126,142,-15,6,21,195,106
45,lak503d.map,192,191,12544,65,61,126,129,10828,56,58,135,132,9,-3,12,13,13
46,lak503d.map,192,191,3176,16,70,175,120,23331,122,161,69,29,-106,91,197,7030,8791
47,lak503d.map,192,191,32157,168,121,23,69,19631,102,41,89,149,66,-80,146,280,177
48,lak503d.map,192,191,9224,48,134,143,56,11679,61,162,130,28,-13,28,41,903,171
49,lak503d.map,192,191,18947,99,152,92,38,20655,108,163,83,27,-9,11,20,21,28
50,lak503d.map,192,191,1204,6,132,185,58,26436,138,112,53,78,-132,-20,152,4635,8038
51,lak503d.map,192,191,10906,57,171,134,19,21211,111,180,80,10,-54,9,63,1121,779
52,lak503d.map,192,191,20664,108,154,83,36,27542,144,152,47,38,-36,-2,38,464,376
53,lak503d.map,192,191,32233,168,45,23,145,7203,37,54,154,136,131,9,140,1210,1718
54,lak503d.map,192,191,24161,126,95,65,95,24463,128,175,63,15,-2,80,82,3021,8429
55,lak503d.map,192,191,5413,28,125,163,65,20502,107,125,84,65,-79,0,79,14857,10804
56,lak503d.map,192,191,35045,183,98,8,92,21661,113,112,78,78,70,14,84,11465,5168
57,lak503d.map,192,191,3325,17,112,174,78,4485,23,98,168,92,-6,-14,20,21,21
58,lak503d.map,192,191,15563,81,98,110,92,22805,119,114,72,76,-38,16,54,1324,884
59,lak503d.map,192,191,10848,56,38,135,152,14466,75,49,116,141,-19,11,30,298,387
60,lak503d.map,192,191,10252,53,61,138,129,24734,129,95,62,95,-76,34,110,15710,8806
61,lak503d.map,192,191,3536,18,92,173,98,22495,117,42,74,148,-99,-50,149,297,241
62,lak503d.map,192,191,7164,37,93,154,97,27014,141,107,50,83,-104,14,118,3789,3195
63,lak503d.map,192,191,34672,181,89,10,101,9969,52,153,139,37,129,64,193,4581,5565
64,lak503d.map,192,191,11390,59,69,132,121,9030,47,137,144,53,12,68,80,10308,9148
65,lak503d.map,192,191,32933,172,109,19,81,13733,71,18,120,172,101,-91,192,327,306
66,lak503d.map,192,191,7620,39,19,152,171,6989,36,77,155,113,3,58,61,560,785
67,lak503d.map,192,191,23953,125,112,66,78,8755,45,30,146,160,80,-82,162,9318,15223
68,lak503d.map,192,191,12635,66,161,125,29,5270,27,77,164,113,39,-84,123,9597,9555
69,lak503d.map,192,191,9650,50,90,141,100,4277,22,115,169,75,28,25,53,68,54
70,lak503d.map,192,191,19114,100,176,91,14,5461,28,77,163,113,72,-99,171,9242,8468
71,lak503d.map,192,191,27057,141,64,50,126,17477,91,94,100,96,50,30,80,11935,5274
72,lak503d.map,192,191,33098,173,135,18,55,22935,120,175,71,15,53,40,93,985,1613
73,lak503d.map,192,191,10425,54,79,137,111,13542,70,18,121,172,-16,-61,77,458,404
74,lak503d.map,192,191,29153,152,69,39,121,24884,130,136,61,54,22,67,89,226,101
75,lak503d.map,192,191,5384,28,154,163,36,27213,142,99,49,91,-114,-55,169,5472,3054
76,lak503d.map,192,191,12208,63,15,128,175,21265,111,126,80,64,-48,111,159,14717,7605
77,lak503d.map,192,191,15039,78,49,113,141,13343,69,26,122,164,9,-23,32,116,113
78,lak503d.map,192,191,24650,129,179,62,11,3510,18,118,173,72,111,-61,172,10164,6084
79,lak503d.map,192,191,12851,67,136,124,54,6031,31,80,160,110,36,-56,92,9744,10372
80,lak503d.map,192,191,8680,45,105,146,85,8233,43,170,148,20,2,65,67,11975,10519
81,lak503d.map,192,191,29707,155,88,36,102,33863,177,134,14,56,-22,46,68,69,277
82,lak503d.map,192,191,28105,147,162,44,28,21820,114,144,77,46,33,-18,51,393,264
83,lak503d.map,192,191,10705,56,181,135,9,30660,160,90,31,100,-104,-91,195,4848,3747
84,lak503d.map,192,191,3746,19,73,172,117,19194,100,96,91,94,-81,23,104,13366,9401
85,lak503d.map,192,191,858,4,96,187,94,28591,149,58,42,132,-145,-38,183,5911,1368
86,lak503d.map,192,191,2613,13,60,178,130,21934,114,30,77,160,-101,-30,131,594,2145
87,lak503d.map,192,191,13333,69,36,122,154,8183,42,29,149,161,27,-7,34,122,78
88,lak503d.map,192,191,21187,110,13,81,177,16412,85,13,106,177,25,0,25,1077,903
89,lak503d.map,192,191,8569,44,25,147,165,2774,14,90,177,100,30,65,95,666,1681
90,lak503d.map,192,191,15896,83,147,108,43,8235,43,168,148,22,40,21,61,734,395
91,lak503d.map,192,191,13207,69,162,122,28,6567,34,117,157,73,35,-45,80,10687,9581
92,lak503d.map,192,191,16849,88,149,103,41,5041,26,115,165,75,62,-34,96,10869,9115
93,lak503d.map,192,191,17449,91,122,100,68,5956,31,155,160,35,60,33,93,460,1829
94,lak503d.map,192,191,26217,137,140,54,50,9319,48,39,143,151,89,-101,190,2419,3752
95,lak503d.map,192,191,25680,134,104,57,86,27769,145,116,46,74,-11,12,23,5057,10824
96,lak503d.map,192,191,21035,110,165,81,25,6037,31,74,160,116,79,-91,170,8722,8416
97,lak503d.map,192,191,33328,174,96,17,94,8838,46,138,145,52,128,42,170,3398,5553
98,lak503d.map,192,191,7875,41,146,150,44,14717,77,180,114,10,-36,34,70,468,656
99,lak503d.map,192,191,5189,27,158,164,32,4661,24,113,167,77,3,-45,48,10548,11124
0,lak504d.map,192,191,13710,71,41,120,149,26247,137,110,54,80,-66,69,135,3766,236
1,lak504d.map,192,191,28757,150,83,41,107,28535,149,114,42,76,1,31,32,33,33
2,lak504d.map,192,191,16729,87,78,104,112,32233,168,45,23,145,-81,-33,114,1543,1605
3,lak504d.map,192,191,26849,140,81,51,109,24478,128,160,63,30,12,79,91,409,592
4,lak504d.map,192,191,9090,47,77,144,113,9970,52,152,139,38,-5,75,80,1737,1246
5,lak504d.map,192,191,21306,111,85,80,105,21359,111,32,80,158,0,-53,53,1318,1212
6,lak504d.map,192,191,20716,108,102,83,88,16012,83,31,108,159,25,-71,96,2036,202
7,lak504d.map,192,191,22321,116,25,75,165,31199,163,124,28,66,-47,99,146,360,1569
8,lak504d.map,192,191,10575,55,120,136,70,26887,140,43,51,147,-85,-77,162,4108,6940
9,lak504d.map,192,191,23410,122,82,69,108,15684,82,168,109,22,40,86,126,1983,224
10,lak504d.map,192,191,23328,122,164,69,26,24391,127,56,64,134,-5,-108,113,1348,1085
11,lak504d.map,192,191,15363,80,107,111,83,32127,168,151,23,39,-88,44,132,2565,2430
12,lak504d.map,192,191,32233,168,45,23,145,20039,104,15,87,175,64,-30,94,929,855
13,lak504d.map,192,191,31968,167,119,24,71,22260,116,86,75,104,51,-33,84,2560,3249
14,lak504d.map,192,191,12282,64,132,127,58,21493,112,89,79,101,-48,-43,91,381,2539
15,lak504d.map,192,191,9976,52,146,139,44,23031,120,79,71,111,-68,-67,135,465,4180
16,lak504d.map,192,191,20357,106,79,85,111,28231,147,36,44,154,-41,-43,84,2395,2654
17,lak504d.map,192,191,13675,71,76,120,114,14111,73,22,118,168,-2,-54,56,377,810
18,lak504d.map,192,191,20872,109,137,82,53,31657,165,48,26,142,-56,-89,145,3677,1835
19,lak504d.map,192,191,24850,130,170,61,20,15898,83,145,108,45,47,-25,72,1213,1353
20,lak504d.map,192,191,22448,117,89,74,101,30447,159,112,32,78,-42,23,65,2653,2492
21,lak504d.map,192,191,25000,130,20,61,170,20878,109,131,82,59,21,111,132,1585,3181
22,lak504d.map,192,191,8674,45,111,146,79,6955,36,111,155,79,9,0,9,10,10
23,lak504d.map,192,191,34120,178,68,13,122,11325,59,134,132,56,119,66,185,5132,7237
24,lak504d.map,192,191,33360,174,64,17,126,24427,127,20,64,170,47,-44,91,1800,1044
25,lak504d.map,192,191,27451,143,52,48,138,22555,118,173,73,17,25,121,146,1121,1716
26,lak504d.map,192,191,24421,127,26,64,164,15799,82,53,109,137,45,27,72,134,168
27,lak504d.map,192,191,19456,101,25,90,165,27862,145,23,46,167,-44,-2,46,1148,642
28,lak504d.map,192,191,12617,66,179,125,11,13162,68,16,123,174,-2,-163,165,3959,4982
29,lak504d.map,192,191,17636,92,126,99,64,16868,88,130,103,60,4,4,8,9,9
30,lak504d.map,192,191,10021,52,101,139,89,14662,76,44,115,146,-24,-57,81,2889,7644
31,lak504d.map,192,191,27769,145,116,46,74,21494,112,88,79,102,33,-28,61,1745,2078
32,lak504d.map,192,191,16865,88,133,103,57,20073,105,172,86,18,-17,39,56,4390,4152
33,lak504d.map,192,191,21464,112,118,79,72,19474,101,7,90,183,11,-111,122,3276,1640
34,lak504d.map,192,191,8876,46,100,145,90,9574,50,166,141,24,-4,66,70,1972,1441
35,lak504d.map,192,191,23357,122,135,69,55,15269,79,10,112,180,43,-125,168,2560,3609
36,lak504d.map,192,191,15860,83,183,108,7,19783,103,80,88,110,-20,-103,123,1023,3763
37,lak504d.map,192,191,11259,58,9,133,181,6839,35,36,156,154,23,27,50,660,639
38,lak504d.map,192,191,17508,91,63,100,127,20421,106,15,85,175,-15,-48,63,636,728
39,lak504d.map,192,191,17456,91,115,100,75,9639,50,101,141,89,41,-14,55,4183,3725
40,lak504d.map,192,191,20912,109,97,82,93,23829,124,45,67,145,-15,-52,67,1844,1389
41,lak504d.map,192,191,7924,41,97,150,93,29358,153,55,38,135,-112,-42,154,5791,10135
42,lak504d.map,192,191,34480,180,90,11,100,5951,31,160,160,30,149,70,219,5442,10214
43,lak504d.map,192,191,849,4,105,187,85,15771,82,81,109,109,-78,-24,102,2601,5549
44,lak504d.map,192,191,23792,124,82,67,108,28596,149,53,42,137,-25,-29,54,2470,3613
45,lak504d.map,192,191,16690,87,117,104,73,16470,86,146,105,44,1,29,30,1289,2109
46,lak504d.map,192,191,8513,44,81,147,109,21535,112,47,79,143,-68,-34,102,5186,10449
47,lak504d.map,192,191,12582,65,23,126,167,11791,61,50,130,140,4,27,31,165,84
48,lak504d.map,192,191,11040,57,37,134,153,26884,140,46,51,144,-83,9,92,1208,349
49,lak504d.map,192,191,14379,75,136,116,54,13021,68,157,123,33,7,21,28,189,102
50,lak504d.map,192,191,27395,143,108,48,82,31780,166,116,25,74,-23,8,31,69,32
51,lak504d.map,192,191,24702,129,127,62,63,13606,71,145,120,45,58,18,76,82,263
52,lak504d.map,192,191,13836,72,106,119,84,33869,177,128,14,62,-105,22,127,4385,2808
53,lak504d.map,192,191,21928,114,36,77,154,4091,21,110,170,80,93,74,167,9266,5204
54,lak504d.map,192,191,14400,75,115,116,75,6279,32,23,159,167,43,-92,135,1294,1835
55,lak504d.map,192,191,13175,68,3,123,187,32575,170,85,21,105,-102,82,184,2652,1099
56,lak504d.map,192,191,13222,69,147,122,43,7863,41,158,150,32,28,11,39,365,805
57,lak504d.map,192,191,4618,24,156,167,34,7423,38,25,153,165,-14,-131,145,4740,6214
58,lak504d.map,192,191,21341,111,50,80,140,26567,139,172,52,18,-28,122,150,932,1957
59,lak504d.map,192,191,16848,88,150,103,40,16820,88,178,103,12,0,28,28,933,297
60,lak504d.map,192,191,26584,139,155,52,35,27213,142,99,49,91,-3,-56,59,119,148
61,lak504d.map,192,191,20067,105,178,86,12,27917,146,159,45,31,-41,-19,60,69,211
62,lak504d.map,192,191,13049,68,129,123,61,8439,44,155,147,35,24,26,50,700,776
63,lak504d.map,192,191,13168,68,10,123,180,7803,40,27,151,163,28,17,45,454,223
64,lak504d.map,192,191,29075,152,147,39,43,8166,42,46,149,144,110,-101,211,1329,2801
65,lak504d.map,192,191,27962,146,114,45,76,28151,147,116,44,74,-1,2,3,4,4
66,lak504d.map,192,191,13278,69,91,122,99,23014,120,96,71,94,-51,5,56,92,57
67,lak504d.map,192,191,15449,80,21,111,169,35413,185,112,6,78,-105,91,196,2255,2815
68,lak504d.map,192,191,3508,18,120,173,70,13948,73,185,118,5,-55,65,120,1684,2580
69,lak504d.map,192,191,7146,37,111,154,79,27822,145,63,46,127,-108,-48,156,3041,6022
70,lak504d.map,192,191,28732,150,108,41,82,27055,141,66,50,124,9,-42,51,88,52
71,lak504d.map,192,191,26278,137,79,54,111,15438,80,32,111,158,57,-47,104,1418,738
72,lak504d.map,192,191,23169,121,132,70,58,13147,68,31,123,159,53,-101,154,868,4022
73,lak504d.map,192,191,16035,83,8,108,182,19590,102,82,89,108,-19,74,93,435,1262
74,lak504d.map,192,191,7890,41,131,150,59,17862,93,91,98,99,-52,-40,92,1589,4795
75,lak504d.map,192,191,14950,78,138,113,52,15118,79,161,112,29,-1,23,24,25,34
76,lak504d.map,192,191,15568,81,93,110,97,8564,44,30,147,160,37,-63,100,696,1265
77,lak504d.map,192,191,31087,162,45,29,145,4743,24,31,167,159,138,-14,152,2247,1818
78,lak504d.map,192,191,23593,123,90,68,100,19302,101,179,90,11,22,89,111,4510,2695
79,lak504d.map,192,191,24440,127,7,64,183,15694,82,158,109,32,45,151,196,4686,5474
80,lak504d.map,192,191,22620,118,108,73,82,18375,96,151,95,39,22,43,65,259,66
81,lak504d.map,192,191,17877,93,76,98,114,23830,124,44,67,146,-31,-32,63,496,636
82,lak504d.map,192,191,15506,81,155,110,35,21842,114,122,77,68,-33,-33,66,115,151
83,lak504d.map,192,191,22698,118,30,73,160,10397,54,107,137,83,64,77,141,9437,5080
84,lak504d.map,192,191,16357,85,68,106,122,24439,127,8,64,182,-42,-60,102,756,213
85,lak504d.map,192,191,8313,43,90,148,100,14605,76,101,115,89,-33,11,44,2895,5071
86,lak504d.map,192,191,28224,147,43,44,147,7681,40,149,151,41,107,106,213,5928,4187
87,lak504d.map,192,191,14712,77,185,114,5,7806,40,24,151,166,37,-161,198,4821,6481
88,lak504d.map,192,191,15169,79,110,112,80,13418,70,142,121,48,9,32,41,1549,2252
89,lak504d.map,192,191,16697,87,110,104,80,18457,96,69,95,121,-9,-41,50,51,103
90,lak504d.map,192,191,22028,115,127,76,63,8167,42,45,149,145,73,-82,155,846,254
91,lak504d.map,192,191,29132,152,90,39,100,11631,60,19,131,171,92,-71,163,174,1279
92,lak504d.map,192,191,24042,125,23,66,167,8109,42,103,149,87,83,80,163,9657,5478
93,lak504d.map,192,191,12929,67,58,124,132,22236,116,110,75,80,-49,52,101,134,2255
94,lak504d.map,192,191,19849,103,14,88,176,28971,151,60,40,130,-48,46,94,851,680
95,lak504d.map,192,191,23816,124,58,67,132,34313,179,66,12,124,-55,8,63,443,530
96,lak504d.map,192,191,16995,88,3,103,187,6083,31,28,160,162,57,25,82,659,477
97,lak504d.map,192,191,27221,142,91,49,99,20862,109,147,82,43,33,56,89,159,701
98,lak504d.map,192,191,3504,18,124,173,66,25426,133,167,58,23,-115,43,158,2487,3770
99,lak504d.map,192,191,21312,111,79,80,111,24723,129,106,62,84,-18,27,45,61,46
0,lak505d.map,192,192,14904,77,71,114,120,28571,148,36,43,155,-71,-35,106,1238,834
1,lak505d.map,192,192,14022,73,185,118,6,20086,104,73,87,118,-31,-112,143,8188,5509
2,lak505d.map,192,192,1804,9,115,182,76,14903,77,72,114,119,-68,-43,111,3527,1956
3,lak505d.map,192,192,15768,82,167,109,24,25265,131,78,60,113,-49,-89,138,10333,4896
4,lak505d.map,192,192,18344,95,87,96,104,15571,81,172,110,19,14,85,99,4881,8258
5,lak505d.map,192,192,2208,11,95,180,96,18361,95,70,96,121,-84,-25,109,2309,1628
6,lak505d.map,192,192,19160,99,39,92,152,20968,109,151,82,40,-10,112,122,6884,5388
7,lak505d.map,192,192,21924,114,155,77,36,29814,155,137,36,54,-41,-18,59,60,60
8,lak505d.map,192,192,7974,41,89,150,102,21894,114,185,77,6,-73,96,169,392,408
9,lak505d.map,192,192,17420,90,51,101,140,29878,155,73,36,118,-65,22,87,11207,7341
10,lak505d.map,192,192,29528,153,39,38,152,11368,59,151,132,40,94,112,206,3738,5989
11,lak505d.map,192,192,22370,116,93,75,98,9535,49,64,142,127,67,-29,96,1849,742
12,lak505d.map,192,192,36570,190,101,1,90,15378,80,173,111,18,110,72,182,231,260
13,lak505d.map,192,192,13586,70,45,121,146,32746,170,85,21,106,-100,40,140,11210,5865
14,lak505d.map,192,192,21329,111,174,80,17,27221,141,42,50,149,-30,-132,162,9998,7328
15,lak505d.map,192,192,23857,124,142,67,49,13467,70,164,121,27,54,22,76,77,77
16,lak505d.map,192,192,19449,101,134,90,57,20179,105,172,86,19,-4,38,42,5542,11967
17,lak505d.map,192,192,30040,156,103,35,88,16372,85,139,106,52,71,36,107,980,136
18,lak505d.map,192,192,4496,23,111,168,80,20312,105,39,86,152,-82,-72,154,235,249
19,lak505d.map,192,192,32105,167,150,24,41,6294,32,41,159,150,135,-109,244,3495,5320
20,lak505d.map,192,192,13193,68,54,123,137,22399,116,64,75,127,-48,10,58,1471,515
21,lak505d.map,192,192,24817,129,142,62,49,15183,79,176,112,15,50,34,84,85,85
22,lak505d.map,192,192,35040,182,95,9,96,26831,139,48,52,143,43,-47,90,9382,11281
23,lak505d.map,192,192,4921,25,70,166,121,5095,26,88,165,103,-1,18,19,20,20
24,lak505d.map,192,192,7178,37,117,154,74,7719,40,152,151,39,-3,35,38,290,515
25,lak505d.map,192,192,26442,137,53,54,138,29639,154,120,37,71,-17,67,84,9574,9053
26,lak505d.map,192,192,2746,14,133,177,58,3341,17,114,174,77,-3,-19,22,23,23
27,lak505d.map,192,192,27720,144,119,47,72,22257,115,14,76,177,29,-105,134,7970,9724
28,lak505d.map,192,192,23756,123,51,68,140,21012,109,107,82,84,14,56,70,984,2215
29,lak505d.map,192,192,1860,9,59,182,132,11917,62,178,129,13,-53,119,172,3702,658
30,lak505d.map,192,192,13480,70,151,121,40,13992,72,23,119,168,-2,-128,130,2691,3767
31,lak505d.map,192,192,14882,77,93,114,98,10034,52,141,139,50,25,48,73,3353,6465
32,lak505d.map,192,192,11501,59,18,132,173,2406,12,89,179,102,47,71,118,721,3041
33,lak505d.map,192,192,36561,190,110,1,81,23863,124,136,67,55,66,26,92,290,822
34,lak505d.map,192,192,29041,151,142,40,49,6455,33,72,158,119,118,-70,188,1183,1441
35,lak505d.map,192,192,2597,13,90,178,101,25910,134,9,57,182,-121,-81,202,746,526
36,lak505d.map,192,192,26168,136,135,55,56,11624,60,87,131,104,76,-48,124,12587,7366
37,lak505d.map,192,192,11467,59,52,132,139,3940,20,91,171,100,39,39,78,173,190
38,lak505d.map,192,192,11931,62,164,129,27,14356,74,43,117,148,-12,-121,133,1551,3847
39,lak505d.map,192,192,16250,84,69,107,122,22653,117,2,74,189,-33,-67,100,135,398
40,lak505d.map,192,192,5712,29,47,162,144,8700,45,131,146,60,-16,84,100,802,1553
41,lak505d.map,192,192,20212,105,139,86,52,9828,51,155,140,36,54,16,70,578,296
42,lak505d.map,192,192,21980,114,99,77,92,6222,32,113,159,78,82,14,96,3709,4841
43,lak505d.map,192,192,25330,131,13,60,178,29036,151,147,40,44,-20,134,154,8498,7998
44,lak505d.map,192,192,14713,76,70,115,121,17682,92,173,99,18,-16,103,119,5087,6684
45,lak505d.map,192,192,19025,99,174,92,17,18710,97,105,94,86,2,-69,71,11561,5361
46,lak505d.map,192,192,9852,51,131,140,60,12893,67,162,124,29,-16,31,47,480,116
47,lak505d.map,192,192,17107,89,172,102,19,3927,20,104,171,87,69,-68,137,356,477
48,lak505d.map,192,192,23752,123,55,68,136,9306,48,101,143,90,75,46,121,353,1019
49,lak505d.map,192,192,23057,120,174,71,17,23563,122,52,69,139,-2,-122,124,9002,7343
50,lak505d.map,192,192,22606,117,49,74,142,19807,103,160,88,31,14,111,125,7144,7266
51,lak505d.map,192,192,10304,53,63,138,128,16921,88,166,103,25,-35,103,138,550,1181
52,lak505d.map,192,192,22458,116,5,75,186,15030,78,137,113,54,38,132,170,6300,3119
53,lak505d.map,192,192,34468,179,91,12,100,31831,165,40,26,151,14,-51,65,9773,11335
54,lak505d.map,192,192,9504,49,95,142,96,36002,187,93,4,98,-138,-2,140,5091,3400
55,lak505d.map,192,192,22443,116,20,75,171,27373,142,82,49,109,-26,62,88,11901,7901
56,lak505d.map,192,192,22842,118,5,73,186,33334,173,73,18,118,-55,68,123,11225,8089
57,lak505d.map,192,192,19018,99,181,92,10,35419,184,100,7,91,-85,-81,166,209,232
58,lak505d.map,192,192,3546,18,101,173,90,11575,60,136,131,55,-42,35,77,232,146
59,lak505d.map,192,192,34453,179,106,12,85,20039,104,120,87,71,75,14,89,11510,10664
60,lak505d.map,192,192,7224,37,71,154,120,20070,104,89,87,102,-67,18,85,1270,1865
61,lak505d.map,192,192,35800,186,103,5,88,11651,60,60,131,131,126,-43,169,4965,9989
62,lak505d.map,192,192,7795,40,76,151,115,18663,97,152,94,39,-57,76,133,282,284
63,lak505d.map,192,192,15689,81,54,110,137,29782,155,169,36,22,-74,115,189,6625,6660
64,lak505d.map,192,192,16912,88,175,103,16,25065,130,86,61,105,-42,-89,131,10747,5052
65,lak505d.map,192,192,29473,153,94,38,97,24973,130,178,61,13,23,84,107,234,111
66,lak505d.map,192,192,19027,99,172,92,19,26935,140,136,51,55,-41,-36,77,78,95
67,lak505d.map,192,192,33873,176,110,15,81,20835,108,92,83,99,68,-18,86,11087,11671
68,lak505d.map,192,192,24050,125,141,66,50,5822,30,129,161,62,95,-12,107,1557,450
69,lak505d.map,192,192,33848,176,135,15,56,17796,92,59,99,132,84,-76,160,8430,11754
70,lak505d.map,192,192,33341,173,66,18,125,34486,179,73,12,118,-6,7,13,14,14
71,lak505d.map,192,192,14241,74,158,117,33,29978,156,165,35,26,-82,7,89,153,90
72,lak505d.map,192,192,26937,140,134,51,57,10126,52,49,139,142,88,-85,173,2215,5284
73,lak505d.map,192,192,21874,113,13,78,178,8116,42,139,149,52,71,126,197,2251,833
74,lak505d.map,192,192,16603,86,100,105,91,23612,122,3,69,188,-36,-97,133,1305,1440
75,lak505d.map,192,192,22160,115,111,76,80,16001,83,126,108,65,32,15,47,65,538
76,lak505d.map,192,192,31194,162,101,29,90,17671,92,184,99,7,70,83,153,303,183
77,lak505d.map,192,192,25776,134,143,57,48,15448,80,103,111,88,54,-40,94,11880,6065
78,lak505d.map,192,192,23793,123,14,68,177,14733,76,50,115,141,47,36,83,287,335
79,lak505d.map,192,192,23290,121,133,70,58,29595,154,164,37,27,-33,31,64,65,65
80,lak505d.map,192,192,12145,63,142,128,49,20634,107,101,84,90,-44,-41,85,8902,4203
81,lak505d.map,192,192,34890,181,53,10,138,28879,150,112,41,79,31,59,90,91,91
82,lak505d.map,192,192,28187,146,36,45,155,14524,75,67,116,124,71,31,102,813,1174
83,lak505d.map,192,192,14641,76,142,115,49,5603,29,156,162,35,47,14,61,204,506
84,lak505d.map,192,192,10059,52,116,139,75,6027,31,116,160,75,21,0,21,22,22
85,lak505d.map,192,192,25096,130,55,61,136,22825,118,22,73,169,12,-33,45,311,326
86,lak505d.map,192,192,29992,156,151,35,40,15977,83,150,108,41,73,-1,74,231,1292
87,lak505d.map,192,192,29641,154,118,37,73,11727,61,176,130,15,93,58,151,154,241
88,lak505d.map,192,192,4072,21,151,170,40,16073,83,54,108,137,-62,-97,159,1035,1903
89,lak505d.map,192,192,666,3,101,188,90,14540,75,51,116,140,-72,-50,122,335,293
90,lak505d.map,192,192,19153,99,46,92,145,13350,69,89,122,102,30,43,73,281,74
91,lak505d.map,192,192,28281,147,134,44,57,20391,106,152,85,39,41,18,59,60,60
92,lak505d.map,192,192,27096,141,167,50,24,32182,167,73,24,118,-26,-94,120,568,910
93,lak505d.map,192,192,32168,167,87,24,104,19494,101,89,90,102,66,2,68,10874,11205
94,lak505d.map,192,192,9523,49,76,142,115,16100,83,27,108,164,-34,-49,83,90,234
95,lak505d.map,192,192,25264,131,79,60,112,25021,130,130,61,61,1,51,52,8084,10512
96,lak505d.map,192,192,31333,163,154,28,37,10302,53,65,138,126,110,-89,199,2168,2061
97,lak505d.map,192,192,5608,29,151,162,40,6771,35,140,156,51,-6,-11,17,18,18
98,lak505d.map,192,192,28530,148,77,43,114,17500,91,163,100,28,57,86,143,439,148
99,lak505d.map,192,192,12722,66,141,125,50,24756,128,11,63,180,-62,-130,192,2854,4719
0,lak506d.map,191,192,2747,14,132,176,59,31022,161,81,29,110,-147,-51,198,7898,9410
1,lak506d.map,191,192,2784,14,95,176,96,9860,51,123,139,68,-37,28,65,234,67
2,lak506d.map,191,192,26753,139,126,51,65,11196,58,131,132,60,81,5,86,7738,9064
3,lak506d.map,191,192,28075,146,148,44,43,25774,134,145,56,46,12,-3,15,16,16
4,lak506d.map,191,192,14420,75,171,115,20,10333,53,34,137,157,22,-137,159,3864,3031
5,lak506d.map,191,192,20011,104,148,86,43,36006,187,89,3,102,-83,-59,142,1970,392
6,lak506d.map,191,192,33922,176,61,14,130,22650,117,5,73,186,59,-56,115,1252,1522
7,lak506d.map,191,192,5536,28,31,162,160,28534,148,73,42,118,-120,42,162,2146,1796
8,lak506d.map,191,192,26794,139,85,51,106,14579,75,12,115,179,64,-73,137,175,1227
9,lak506d.map,191,192,15984,83,143,107,48,26813,139,66,51,125,-56,-77,133,7852,8433
10,lak506d.map,191,192,12469,64,10,126,181,14223,74,176,116,15,-10,166,176,3779,4269
11,lak506d.map,191,192,7067,36,36,154,155,7069,36,34,154,157,0,-2,2,3,3
12,lak506d.map,191,192,24250,126,133,64,58,18195,94,44,96,147,32,-89,121,564,1196
13,lak506d.map,191,192,5692,29,67,161,124,7917,41,146,149,45,-12,79,91,1665,448
14,lak506d.map,191,192,23816,124,183,66,8,10699,55,52,135,139,69,-131,200,6448,9347
15,lak506d.map,191,192,11458,59,61,131,130,30442,158,85,32,106,-99,24,123,3233,4712
16,lak506d.map,191,192,8616,44,23,146,168,21259,110,52,80,139,-66,29,95,551,946
17,lak506d.map,191,192,21653,112,42,78,149,29454,153,113,37,78,-41,71,112,134,193
18,lak506d.map,191,192,9252,48,155,142,36,21260,110,51,80,140,-62,-104,166,7748,7204
19,lak506d.map,191,192,11274,58,53,132,138,4735,24,64,166,127,34,11,45,3447,3152
20,lak506d.map,191,192,20884,108,43,82,148,20462,106,81,84,110,2,38,40,4659,2970
21,lak506d.map,191,192,22113,115,158,75,33,6172,32,163,158,28,83,5,88,7907,10008
22,lak506d.map,191,192,11464,59,55,131,136,15951,83,176,107,15,-24,121,145,1419,1884
23,lak506d.map,191,192,24706,128,61,62,130,35623,185,88,5,103,-57,27,84,653,99
24,lak506d.map,191,192,29025,151,158,39,33,27375,142,80,48,111,9,-78,87,336,417
25,lak506d.map,191,192,13936,72,79,118,112,13515,70,116,120,75,2,37,39,135,129
26,lak506d.map,191,192,27515,143,132,47,59,12508,65,163,125,28,78,31,109,8805,8899
27,lak506d.map,191,192,16040,83,87,107,104,33530,174,69,16,122,-91,-18,109,7191,6606
28,lak506d.map,191,192,15390,80,161,110,30,13231,68,16,122,175,12,-145,157,4391,3685
29,lak506d.map,191,192,2392,12,103,178,88,13033,67,22,123,169,-55,-81,136,5164,4582
30,lak506d.map,191,192,16090,83,37,107,154,24435,127,140,63,51,-44,103,147,1388,733
31,lak506d.map,191,192,21408,111,95,79,96,2796,14,83,176,108,97,-12,109,2322,2490
32,lak506d.map,191,192,32939,171,84,19,107,21541,112,154,78,37,59,70,129,313,1213
33,lak506d.map,191,192,3933,20,98,170,93,13030,67,25,123,166,-47,-73,120,6776,5010
34,lak506d.map,191,192,10432,54,127,136,64,5850,30,101,160,90,24,-26,50,51,52
35,lak506d.map,191,192,16907,88,180,102,11,27735,144,104,46,87,-56,-76,132,7904,8639
36,lak506d.map,191,192,24335,126,48,64,143,6487,33,40,157,151,93,-8,101,1568,1480
37,lak506d.map,191,192,11817,61,86,129,105,24829,129,130,61,61,-68,44,112,9738,9599
38,lak506d.map,191,192,9283,48,124,142,67,12334,64,145,126,46,-16,21,37,262,49
39,lak506d.map,191,192,20898,108,29,82,162,3190,16,73,174,118,92,44,136,7667,8226
40,lak506d.map,191,192,19624,102,151,88,40,13991,72,24,118,167,30,-127,157,1184,4453
41,lak506d.map,191,192,34822,181,121,9,70,20742,108,185,82,6,73,64,137,478,1353
42,lak506d.map,191,192,31569,164,110,26,81,8694,45,137,145,54,119,27,146,8138,7930
43,lak506d.map,191,192,11696,60,15,130,176,11724,61,179,129,12,-1,164,165,4139,4127
44,lak506d.map,191,192,16401,85,110,105,81,30982,161,121,29,70,-76,11,87,7859,6694
45,lak506d.map,191,192,19507,101,76,89,115,25795,134,124,56,67,-33,48,81,8870,6676
46,lak506d.map,191,192,31411,163,76,27,115,6423,33,104,157,87,130,28,158,8655,9050
47,lak506d.map,191,192,25961,135,150,55,41,23178,120,53,70,138,15,-97,112,581,492
48,lak506d.map,191,192,9961,51,22,139,169,21470,111,33,79,158,-60,11,71,1173,1000
49,lak506d.map,191,192,27898,145,133,45,58,36359,189,120,1,71,-44,-13,57,406,588
50,lak506d.map,191,192,25400,132,135,58,56,6679,34,40,156,151,98,-95,193,3466,5435
51,lak506d.map,191,192,4176,21,47,169,144,3000,15,71,175,120,6,24,30,4058,3484
52,lak506d.map,191,192,20260,105,91,85,100,16438,85,73,105,118,20,-18,38,39,59
53,lak506d.map,191,192,9644,50,147,140,44,20895,108,32,82,159,-58,-115,173,8399,6530
54,lak506d.map,191,192,21541,112,154,78,37,1983,10,128,180,63,102,-26,128,9265,10026
55,lak506d.map,191,192,35071,182,64,8,127,30615,159,104,31,87,23,40,63,1153,427
56,lak506d.map,191,192,31761,165,110,25,81,8986,46,37,144,154,119,-73,192,2742,2894
57,lak506d.map,191,192,25292,131,51,59,140,847,4,112,186,79,127,61,188,9434,7708
58,lak506d.map,191,192,33671,175,120,15,71,16535,86,168,104,23,89,48,137,8565,8004
59,lak506d.map,191,192,24782,129,177,61,14,1071,5,80,185,111,124,-97,221,9181,11349
60,lak506d.map,191,192,3376,17,79,173,112,16178,84,141,106,50,-67,62,129,273,252
61,lak506d.map,191,192,19086,99,113,91,78,15390,80,161,110,30,19,48,67,707,663
62,lak506d.map,191,192,12457,64,22,126,169,21159,110,152,80,39,-46,130,176,5109,2813
63,lak506d.map,191,192,9296,48,111,142,80,5915,30,36,160,155,18,-75,93,3463,2666
64,lak506d.map,191,192,6803,35,108,155,83,17965,93,82,97,109,-58,-26,84,1486,1611
65,lak506d.map,191,192,1859,9,60,181,131,11691,60,20,130,171,-51,-40,91,4851,5554
66,lak506d.map,191,192,26411,137,84,53,107,28684,149,115,41,76,-12,31,43,44,94
67,lak506d.map,191,192,1852,9,67,181,124,27766,144,73,46,118,-135,6,141,7873,10345
68,lak506d.map,191,192,19314,100,77,90,114,15842,82,93,108,98,18,16,34,35,35
69,lak506d.map,191,192,7467,38,20,152,171,27879,145,152,45,39,-107,132,239,3893,2743
70,lak506d.map,191,192,27360,142,95,48,96,15715,81,28,109,163,61,-67,128,166,223
71,lak506d.map,191,192,20654,107,81,83,110,6470,33,57,157,134,74,-24,98,111,147
72,lak506d.map,191,192,9689,50,102,140,89,29274,152,101,38,90,-102,-1,103,7909,8676
73,lak506d.map,191,192,10494,54,65,136,126,27679,144,160,46,31,-90,95,185,6643,6366
74,lak506d.map,191,192,31752,165,119,25,72,5151,26,32,164,159,139,-87,226,2647,3303
75,lak506d.map,191,192,17066,88,21,102,170,24415,127,160,63,31,-39,139,178,3201,1373
76,lak506d.map,191,192,21498,111,5,79,186,29084,151,99,39,92,-40,94,134,297,992
77,lak506d.map,191,192,30562,159,157,31,34,34836,181,107,9,84,-22,-50,72,1332,721
78,lak506d.map,191,192,23571,122,44,68,147,9774,50,17,140,174,72,-27,99,145,290
79,lak506d.map,191,192,13171,68,76,122,115,22044,114,35,76,156,-46,-41,87,3605,3259
80,lak506d.map,191,192,10441,54,118,136,73,2431,12,64,178,127,42,-54,96,320,153
81,lak506d.map,191,192,28127,146,96,44,95,27759,144,80,46,111,2,-16,18,19,19
82,lak506d.map,191,192,23404,121,19,69,172,28302,147,113,43,78,-26,94,120,145,990
83,lak506d.map,191,192,13421,69,18,121,173,20886,108,41,82,150,-39,23,62,433,194
84,lak506d.map,191,192,20250,105,101,85,90,9197,47,18,143,173,58,-83,141,1533,2687
85,lak506d.map,191,192,25664,133,63,57,128,5862,30,89,160,102,103,26,129,9396,7846
86,lak506d.map,191,192,27123,141,140,49,51,14367,74,32,116,159,67,-108,175,1858,1002
87,lak506d.map,191,192,12272,63,15,127,176,24201,126,182,64,9,-63,167,230,5736,1460
88,lak506d.map,191,192,6611,34,108,156,83,16595,86,108,104,83,-52,0,52,787,679
89,lak506d.map,191,192,4376,22,39,168,152,5094,26,89,164,102,-4,50,54,3726,3491
90,lak506d.map,191,192,8010,41,53,149,138,31213,162,82,28,109,-121,29,150,3002,2956
91,lak506d.map,191,192,28107,146,116,44,75,29836,155,115,35,76,-9,-1,10,39,28
92,lak506d.map,191,192,15944,83,183,107,8,24323,126,60,64,131,-43,-123,166,7810,8485
93,lak506d.map,191,192,21277,110,34,80,157,26055,135,56,55,135,-25,22,47,60,49
94,lak506d.map,191,192,34861,181,82,9,109,21205,110,106,80,85,71,24,95,6715,7306
95,lak506d.map,191,192,13067,68,180,122,11,8109,42,146,148,45,26,-34,60,899,1035
96,lak506d.map,191,192,34499,179,60,11,131,16093,83,34,107,157,96,-26,122,590,1619
97,lak506d.map,191,192,14190,73,17,117,174,11694,60,17,130,174,13,0,13,14,14
98,lak506d.map,191,192,31571,164,108,26,83,20765,108,162,82,29,56,54,110,115,140
99,lak506d.map,191,192,15533,80,18,110,173,27503,143,144,47,47,-63,126,189,1150,607
0,lak507d.map,81,80,4536,56,23,24,56,5643,70,36,10,43,-14,13,27,28,28
1,lak507d.map,81,80,1966,24,33,56,46,3886,48,33,32,46,-24,0,24,25,25
2,lak507d.map,81,80,5074,63,45,17,34,1134,14,65,66,14,49,20,69,70,70
3,lak507d.map,81,80,5081,63,38,17,41,3303,41,56,39,23,22,18,40,41,41
4,lak507d.map,81,80,4527,56,32,24,47,4735,59,64,21,15,-3,32,35,36,36
5,lak507d.map,81,80,772,9,27,71,52,4246,53,73,27,6,-44,46,90,156,104
6,lak507d.map,81,80,5340,66,19,14,60,1895,23,24,57,55,43,5,48,49,49
7,lak507d.map,81,80,3176,39,23,41,56,3217,40,62,40,17,-1,39,40,41,41
8,lak507d.map,81,80,3030,37,9,43,70,4215,52,24,28,55,-15,15,30,37,254
9,lak507d.map,81,80,4754,59,45,21,34,3420,42,19,38,60,17,-26,43,44,44
10,lak507d.map,81,80,1636,20,43,60,36,4119,51,40,29,39,-31,-3,34,35,35
11,lak507d.map,81,80,3257,40,22,40,57,5471,68,48,12,31,-28,26,54,55,55
12,lak507d.map,81,80,4906,61,53,19,26,853,10,26,70,53,51,-27,78,79,79
13,lak507d.map,81,80,1307,16,52,64,27,4487,56,72,24,7,-40,20,60,118,61
14,lak507d.map,81,80,1240,15,39,65,40,674,8,45,72,34,7,6,13,14,14
15,lak507d.map,81,80,3045,38,74,42,5,4615,57,24,23,55,-19,-50,69,70,70
16,lak507d.map,81,80,3147,39,52,41,27,5083,63,36,17,43,-24,-16,40,41,41
17,lak507d.map,81,80,1213,15,66,65,13,5254,65,25,15,54,-50,-41,91,92,92
18,lak507d.map,81,80,4578,57,61,23,18,2814,35,65,45,14,22,4,26,27,27
19,lak507d.map,81,80,5945,74,54,6,25,4371,54,28,26,51,20,-26,46,47,47
20,lak507d.map,81,80,3976,49,23,31,56,3453,43,66,37,13,6,43,49,50,50
21,lak507d.map,81,80,3144,39,55,41,24,1349,16,10,64,69,23,-45,68,69,69
22,lak507d.map,81,80,2312,28,7,52,72,2012,25,67,55,12,3,60,63,64,64
23,lak507d.map,81,80,816,10,63,70,16,4786,59,13,21,66,-49,-50,99,181,100
24,lak507d.map,81,80,3145,39,54,41,25,5501,68,18,12,61,-29,-36,65,66,66
25,lak507d.map,81,80,5558,69,41,11,38,2543,31,16,49,63,38,-25,63,64,64
26,lak507d.map,81,80,5072,63,47,17,32,3819,47,20,33,59,16,-27,43,44,44
27,lak507d.map,81,80,2296,28,23,52,56,4284,53,35,27,44,-25,12,37,38,38
28,lak507d.map,81,80,1330,16,29,64,50,1325,16,34,64,45,0,5,5,6,6
29,lak507d.map,81,80,6280,78,39,2,40,4114,51,45,29,34,27,6,33,34,34
30,lak507d.map,81,80,1016,12,23,68,56,3528,44,71,36,8,-32,48,80,133,81
31,lak507d.map,81,80,4667,58,52,22,27,5412,67,27,13,52,-9,-25,34,35,35
32,lak507d.map,81,80,5020,62,19,18,60,6030,75,49,5,30,-13,30,43,44,44
33,lak507d.map,81,80,3825,47,14,33,65,5301,66,58,14,21,-19,44,63,64,64
34,lak507d.map,81,80,4147,51,12,29,67,1422,17,17,63,62,34,5,39,40,124
35,lak507d.map,81,80,1479,18,40,62,39,5663,70,16,10,63,-52,-24,76,77,77
36,lak507d.map,81,80,4377,54,22,26,57,1172,14,27,66,52,40,5,45,46,46
37,lak507d.map,81,80,1933,24,66,56,13,4863,60,16,20,63,-36,-50,86,87,87
38,lak507d.map,81,80,5713,71,46,9,33,4623,57,16,23,63,14,-30,44,45,45
39,lak507d.map,81,80,4033,50,46,30,33,2019,25,60,55,19,25,14,39,40,40
40,lak507d.map,81,80,2787,34,12,46,67,1957,24,42,56,37,10,30,40,41,45
41,lak507d.map,81,80,4456,55,23,25,56,4264,53,55,27,24,2,32,34,35,35
42,lak507d.map,81,80,1864,23,55,57,24,614,7,25,73,54,16,-30,46,81,47
43,lak507d.map,81,80,3706,46,53,34,26,5468,68,51,12,28,-22,-2,24,25,25
44,lak507d.map,81,80,4742,59,57,21,22,4791,59,8,21,71,0,-49,49,50,50
45,lak507d.map,81,80,1924,24,75,56,4,2909,36,50,44,29,-12,-25,37,38,38
46,lak507d.map,81,80,3875,48,44,32,35,3397,42,42,38,37,6,-2,8,9,9
47,lak507d.map,81,80,1020,12,19,68,60,3407,42,32,38,47,-30,13,43,44,44
48,lak507d.map,81,80,4232,52,7,28,72,3575,44,24,36,55,8,17,25,29,26
49,lak507d.map,81,80,2312,28,7,52,72,1789,22,50,58,29,6,43,49,50,50
50,lak507d.map,81,80,5077,63,42,17,37,5951,74,48,6,31,-11,6,17,18,18
51,lak507d.map,81,80,6193,77,46,3,33,5503,68,16,12,63,9,-30,39,40,40
52,lak507d.map,81,80,4248,53,71,27,8,4057,50,22,30,57,3,-49,52,53,53
53,lak507d.map,81,80,2777,34,22,46,57,2762,34,37,46,42,0,15,15,16,16
54,lak507d.map,81,80,1497,18,22,62,57,1183,14,16,66,63,4,-6,10,11,11
55,lak507d.map,81,80,1624,20,55,60,24,2425,30,54,50,25,-10,-1,11,12,12
56,lak507d.map,81,80,2344,29,55,51,24,5571,69,28,11,51,-40,-27,67,68,68
57,lak507d.map,81,80,3216,40,63,40,16,3070,38,49,42,30,2,-14,16,17,17
58,lak507d.map,81,80,2370,29,29,51,50,115,1,44,79,35,28,15,43,49,44
59,lak507d.map,81,80,1536,19,63,61,16,4356,54,43,26,36,-35,-20,55,56,56
60,lak507d.map,81,80,1906,23,13,57,66,3359,41,0,39,79,-18,-13,31,79,33
61,lak507d.map,81,80,4504,56,55,24,24,1765,22,74,58,5,34,19,53,54,54
62,lak507d.map,81,80,1624,20,55,60,24,5573,69,26,11,53,-49,-29,78,79,79
63,lak507d.map,81,80,6437,80,42,0,37,5879,73,40,7,39,7,-2,9,10,10
64,lak507d.map,81,80,4665,58,54,22,25,2596,32,43,48,36,26,-11,37,38,38
65,lak507d.map,81,80,3842,48,77,32,2,2972,37,67,43,12,11,-10,21,22,22
66,lak507d.map,81,80,3761,47,78,33,1,4191,52,48,28,31,-5,-30,35,36,36
67,lak507d.map,81,80,4843,60,36,20,43,620,7,19,73,60,53,-17,70,76,71
68,lak507d.map,81,80,4543,56,16,24,63,4463,55,16,25,63,1,0,1,2,2
69,lak507d.map,81,80,3852,48,67,32,12,1829,22,10,58,69,26,-57,83,84,92
70,lak507d.map,81,80,4602,57,37,23,42,5307,66,52,14,27,-9,15,24,25,25
71,lak507d.map,81,80,3470,43,49,37,30,847,10,32,70,47,33,-17,50,51,51
72,lak507d.map,81,80,585,7,54,73,25,4377,54,22,26,57,-47,-32,79,80,148
73,lak507d.map,81,80,4445,55,34,25,45,4029,50,50,30,29,5,16,21,22,22
74,lak507d.map,81,80,1565,19,34,61,45,4541,56,18,24,61,-37,-16,53,54,54
75,lak507d.map,81,80,1080,13,39,67,40,2654,33,65,47,14,-20,26,46,47,47
76,lak507d.map,81,80,4090,51,69,29,10,4694,58,25,22,54,-7,-44,51,52,52
77,lak507d.map,81,80,1988,24,11,56,68,5396,67,43,13,36,-43,32,75,76,76
78,lak507d.map,81,80,5313,66,46,14,33,3646,45,33,35,46,21,-13,34,35,35
79,lak507d.map,81,80,4926,61,33,19,46,4359,54,40,26,39,7,7,14,15,15
80,lak507d.map,81,80,1348,16,11,64,68,2173,27,66,53,13,-11,55,66,67,67
81,lak507d.map,81,80,4657,58,62,22,17,4846,60,33,20,46,-2,-29,31,32,32
82,lak507d.map,81,80,4048,50,31,30,48,3354,41,5,39,74,9,-26,35,533,100
83,lak507d.map,81,80,5147,64,52,16,27,5623,70,56,10,23,-6,4,10,11,11
84,lak507d.map,81,80,4581,57,58,23,21,5263,65,16,15,63,-8,-42,50,51,51
85,lak507d.map,81,80,1984,24,15,56,64,4139,51,20,29,59,-27,5,32,33,33
86,lak507d.map,81,80,3338,41,21,39,58,4771,59,28,21,51,-18,7,25,26,26
87,lak507d.map,81,80,2288,28,31,52,48,3642,45,37,35,42,-17,6,23,24,24
88,lak507d.map,81,80,5793,72,46,8,33,3220,40,59,40,20,32,13,45,46,46
89,lak507d.map,81,80,3088,38,31,42,48,1587,19,12,61,67,19,-19,38,39,39
90,lak507d.map,81,80,4288,53,31,27,48,2895,36,64,44,15,17,33,50,51,51
91,lak507d.map,81,80,4353,54,46,26,33,2842,35,37,45,42,19,-9,28,29,29
92,lak507d.map,81,80,1219,15,60,65,19,2503,31,56,49,23,-16,-4,20,21,21
93,lak507d.map,81,80,3963,49,36,31,43,1254,15,25,65,54,34,-11,45,46,46
94,lak507d.map,81,80,905,11,54,69,25,2380,29,19,51,60,-18,-35,53,54,54
95,lak507d.map,81,80,6040,75,39,5,40,4422,55,57,25,22,20,18,38,39,39
96,lak507d.map,81,80,2420,30,59,50,20,1935,24,64,56,15,6,5,11,12,12
97,lak507d.map,81,80,2522,31,37,49,42,3204,40,75,40,4,-9,38,47,48,48
98,lak507d.map,81,80,3290,41,69,39,10,1098,13,21,67,58,28,-48,76,77,114
99,lak507d.map,81,80,1960,24,39,56,40,2810,35,69,45,10,-11,30,41,53,42
0,lak510d.map,56,171,2014,11,37,44,133,3703,21,58,34,112,-10,21,31,115,73
1,lak510d.map,56,171,1285,7,82,48,88,4574,26,42,29,128,-19,-40,59,225,60
2,lak510d.map,56,171,1091,6,105,49,65,6975,40,35,15,135,-34,-70,104,286,221
3,lak510d.map,56,171,2924,17,153,38,17,4445,25,0,30,170,-8,-153,161,162,451
4,lak510d.map,56,171,3682,21,79,34,91,7510,43,13,12,157,-22,-66,88,89,174
5,lak510d.map,56,171,6792,39,47,16,123,9497,55,78,0,92,-16,31,47,48,109
6,lak510d.map,56,171,6341,37,156,18,14,8439,49,110,6,60,-12,-46,58,72,62
7,lak510d.map,56,171,9514,55,61,0,109,8967,52,95,3,75,3,34,37,38,38
8,lak510d.map,56,171,4225,24,49,31,121,7631,44,63,11,107,-20,14,34,35,35
9,lak510d.map,56,171,3880,22,52,33,118,6372,37,125,18,45,-15,73,88,89,89
10,lak510d.map,56,171,6032,35,123,20,47,5021,29,108,26,62,6,-15,21,22,22
11,lak510d.map,56,171,4004,23,99,32,71,3484,20,106,35,64,3,7,10,11,11
12,lak510d.map,56,171,5233,30,67,25,103,9279,54,125,1,45,-24,58,82,83,83
13,lak510d.map,56,171,9361,54,43,1,127,1060,6,136,49,34,48,93,141,208,544
14,lak510d.map,56,171,1307,7,60,48,110,8054,47,153,8,17,-40,93,133,134,134
15,lak510d.map,56,171,6336,37,161,18,9,5465,31,6,24,164,6,-155,161,962,461
16,lak510d.map,56,171,6168,36,158,19,12,7603,44,91,11,79,-8,-67,75,140,98
17,lak510d.map,56,171,7192,42,160,13,10,5280,30,20,25,150,12,-140,152,966,426
18,lak510d.map,56,171,5520,32,122,23,48,8534,49,15,6,155,-17,-107,124,1435,713
19,lak510d.map,56,171,6233,36,93,19,77,1668,9,41,46,129,27,-52,79,1179,95
20,lak510d.map,56,171,7564,44,130,11,40,5181,30,119,25,51,14,-11,25,26,44
21,lak510d.map,56,171,7209,42,143,13,27,2557,14,7,41,163,28,-136,164,841,171
22,lak510d.map,56,171,3597,21,164,34,6,23,0,147,55,23,21,-17,38,63,48
23,lak510d.map,56,171,8537,49,12,6,158,2004,11,47,44,123,38,35,73,2173,228
24,lak510d.map,56,171,6210,36,116,19,54,3830,22,102,33,68,14,-14,28,29,29
25,lak510d.map,56,171,1420,8,118,47,52,1548,9,161,46,9,-1,43,44,151,61
26,lak510d.map,56,171,4529,26,87,29,83,6343,37,154,18,16,-11,67,78,79,79
27,lak510d.map,56,171,2699,15,36,40,134,6639,38,29,17,141,-23,-7,30,31,31
28,lak510d.map,56,171,5747,33,66,22,104,2165,12,57,43,113,21,-9,30,31,32
29,lak510d.map,56,171,288,1,53,54,117,5923,34,61,21,109,-33,8,41,42,42
30,lak510d.map,56,171,6418,37,79,18,91,7580,44,114,11,56,-7,35,42,385,353
31,lak510d.map,56,171,7731,45,134,10,36,645,3,38,52,132,42,-96,138,1645,165
32,lak510d.map,56,171,5753,33,60,22,110,49,0,121,55,49,33,61,94,237,107
33,lak510d.map,56,171,3008,17,69,38,101,8664,50,56,5,114,-33,-13,46,136,50
34,lak510d.map,56,171,8074,47,133,8,37,5535,32,107,23,63,15,-26,41,42,42
35,lak510d.map,56,171,1416,8,122,47,48,8644,50,76,5,94,-42,-46,88,1378,494
36,lak510d.map,56,171,769,4,85,51,85,26,0,144,55,26,4,59,63,129,64
37,lak510d.map,56,171,2546,14,18,41,152,6445,37,52,18,118,-23,34,57,1628,289
38,lak510d.map,56,171,6475,37,22,18,148,8671,50,49,5,121,-13,27,40,458,185
39,lak510d.map,56,171,7387,43,136,12,34,3510,20,80,35,90,23,-56,79,80,80
40,lak510d.map,56,171,2336,13,57,42,113,7140,41,41,14,129,-28,-16,44,522,400
41,lak510d.map,56,171,3200,18,48,37,122,6345,37,152,18,18,-19,104,123,145,2265
42,lak510d.map,56,171,5444,31,27,24,143,5165,30,135,25,35,1,108,109,125,200
43,lak510d.map,56,171,2035,11,16,44,154,1695,9,14,46,156,2,-2,4,5,5
44,lak510d.map,56,171,827,4,27,51,143,9260,54,144,1,26,-50,117,167,288,1689
45,lak510d.map,56,171,3949,23,154,32,16,6390,37,107,18,63,-14,-47,61,62,143
46,lak510d.map,56,171,4521,26,95,29,75,5420,31,51,24,119,-5,-44,49,50,50
47,lak510d.map,56,171,2874,16,32,39,138,4475,26,141,29,29,-10,109,119,126,714
48,lak510d.map,56,171,6884,40,126,15,44,292,1,49,54,121,39,-77,116,195,117
49,lak510d.map,56,171,6357,37,140,18,30,5773,33,40,22,130,4,-100,104,871,152
50,lak510d.map,56,171,1147,6,49,49,121,7174,41,7,14,163,-35,-42,77,220,1714
51,lak510d.map,56,171,2573,15,162,40,8,1094,6,102,49,68,9,-60,69,92,71
52,lak510d.map,56,171,8306,48,72,7,98,3727,21,34,34,136,27,-38,65,139,67
53,lak510d.map,56,171,4568,26,48,29,122,1673,9,36,46,134,17,-12,29,33,46
54,lak510d.map,56,171,5730,33,83,22,87,8630,50,90,5,80,-17,7,24,359,352
55,lak510d.map,56,171,6856,40,154,15,16,4781,27,6,28,164,13,-148,161,162,162
56,lak510d.map,56,171,3617,21,144,34,26,5743,33,70,22,100,-12,-74,86,87,87
57,lak510d.map,56,171,1523,8,15,47,155,734,4,120,51,50,4,105,109,320,728
58,lak510d.map,56,171,7731,45,134,10,36,1829,10,51,45,119,35,-83,118,119,119
59,lak510d.map,56,171,4289,25,156,30,14,993,5,32,50,138,20,-124,144,1833,164
60,lak510d.map,56,171,1758,10,122,45,48,3743,21,18,34,152,-11,-104,115,901,512
61,lak510d.map,56,171,8426,49,123,6,47,4350,25,95,30,75,24,-28,52,53,53
62,lak510d.map,56,171,2938,17,139,38,31,2139,12,83,43,87,5,-56,61,62,62
63,lak510d.map,56,171,9209,53,24,2,146,8503,49,46,6,124,4,22,26,111,33
64,lak510d.map,56,171,705,4,149,51,21,7126,41,55,14,115,-37,-94,131,310,137
65,lak510d.map,56,171,9517,55,58,0,112,2887,16,19,39,151,39,-39,78,319,283
66,lak510d.map,56,171,3162,18,86,37,84,1165,6,31,49,139,12,-55,67,671,520
67,lak510d.map,56,171,1250,7,117,48,53,2903,16,3,39,167,-9,-114,123,1110,771
68,lak510d.map,56,171,8928,52,134,3,36,591,3,92,52,78,49,-42,91,126,92
69,lak510d.map,56,171,3053,17,24,38,146,3343,19,76,36,94,-2,52,54,258,307
70,lak510d.map,56,171,7955,46,81,9,89,3087,18,161,37,9,28,80,108,306,658
71,lak510d.map,56,171,7378,43,145,12,25,455,2,57,53,113,41,-88,129,218,139
72,lak510d.map,56,171,1464,8,74,47,96,1993,11,58,44,112,-3,-16,19,20,20
73,lak510d.map,56,171,8230,48,148,7,22,6487,37,10,18,160,11,-138,149,1858,1961
74,lak510d.map,56,171,5152,30,148,25,22,7564,44,130,11,40,-14,-18,32,60,33
75,lak510d.map,56,171,7944,46,92,9,78,8220,48,158,7,12,-2,66,68,484,183
76,lak510d.map,56,171,7970,46,66,9,104,3141,18,107,37,63,28,41,69,70,154
77,lak510d.map,56,171,1376,8,162,47,8,980,5,45,50,125,3,-117,120,140,874
78,lak510d.map,56,171,4440,25,5,30,165,4210,24,64,31,106,1,59,60,61,61
79,lak510d.map,56,171,6699,39,140,16,30,1774,10,106,45,64,29,-34,63,64,64
80,lak510d.map,56,171,4085,23,18,32,152,4063,23,40,32,130,0,22,22,23,23
81,lak510d.map,56,171,7193,42,159,13,11,6523,38,145,17,25,4,-14,18,19,19
82,lak510d.map,56,171,5602,32,40,23,130,3883,22,49,33,121,10,9,19,22,20
83,lak510d.map,56,171,8536,49,13,6,157,3850,22,82,33,88,27,69,96,153,97
84,lak510d.map,56,171,1347,7,20,48,150,5846,34,138,21,32,-27,118,145,164,1365
85,lak510d.map,56,171,2164,12,58,43,112,268,1,73,54,97,11,15,26,27,27
86,lak510d.map,56,171,3514,20,76,35,94,2507,14,57,41,113,6,-19,25,38,26
87,lak510d.map,56,171,4922,28,36,27,134,7571,44,123,11,47,-16,87,103,104,104
88,lak510d.map,56,171,2577,15,158,40,12,7947,46,89,9,81,-31,-69,100,781,159
89,lak510d.map,56,171,8120,47,87,8,83,3116,18,132,37,38,29,45,74,101,795
90,lak510d.map,56,171,5632,32,10,23,160,7876,46,160,9,10,-14,150,164,780,1509
91,lak510d.map,56,171,3764,22,168,33,2,9021,52,41,3,129,-30,-127,157,3231,485
92,lak510d.map,56,171,803,4,51,51,119,1596,9,113,46,57,-5,62,67,68,68
93,lak510d.map,56,171,8986,52,76,3,94,8671,50,49,5,121,2,-27,29,30,30
94,lak510d.map,56,171,8741,51,150,4,20,3333,19,86,36,84,32,-64,96,99,97
95,lak510d.map,56,171,5441,31,30,24,140,5687,33,126,22,44,-2,96,98,154,405
96,lak510d.map,56,171,2945,17,132,38,38,7828,45,37,10,133,-28,-95,123,124,171
97,lak510d.map,56,171,9162,53,71,2,99,1301,7,66,48,104,46,-5,51,52,52
98,lak510d.map,56,171,3150,18,98,37,72,111,0,59,55,111,18,-39,57,62,360
99,lak510d.map,56,171,4809,28,149,27,21,7212,42,140,13,30,-14,-9,23,24,24
0,lak511d.map,506,202,15505,76,48,429,153,85754,424,95,81,106,-348,47,395,11068,15665
1,lak511d.map,506,202,47569,235,102,270,99,85590,423,57,82,144,-188,-45,233,6533,3680
2,lak511d.map,506,202,5962,29,97,476,104,97621,483,146,22,55,-454,49,503,11068,15665
3,lak511d.map,506,202,62994,311,29,194,172,71660,354,49,151,152,-43,20,63,283,131
4,lak511d.map,506,202,27705,137,170,368,31,99885,494,104,11,97,-357,-66,423,11068,15665
5,lak511d.map,506,202,99429,492,156,13,45,26711,132,154,373,47,360,-2,362,15665,11068
6,lak511d.map,506,202,64497,319,142,186,59,9029,44,60,461,141,275,-82,357,395,11068
7,lak511d.map,506,202,28986,143,101,362,100,63147,312,78,193,123,-169,-23,192,11068,15665
8,lak511d.map,506,202,44138,218,99,287,102,67410,333,57,172,144,-115,-42,157,1431,411
9,lak511d.map,506,202,32860,162,65,343,136,98455,487,120,18,81,-325,55,380,11068,15665
10,lak511d.map,506,202,32843,162,82,343,119,15709,77,46,428,155,85,-36,121,1371,859
11,lak511d.map,506,202,52613,260,108,245,93,53318,263,9,242,192,-3,-99,102,103,103
12,lak511d.map,506,202,101256,501,147,4,54,43177,213,50,292,151,288,-97,385,1148,3712
13,lak511d.map,506,202,99410,492,175,13,26,29327,145,164,360,37,347,-11,358,15665,11068
14,lak511d.map,506,202,17321,85,50,420,151,93226,461,97,44,104,-376,47,423,11068,15665
15,lak511d.map,506,202,6758,33,109,472,92,41775,206,38,299,163,-173,-71,244,11068,15665
16,lak511d.map,506,202,13275,65,56,440,145,12668,62,57,443,144,3,1,4,5,5
17,lak511d.map,506,202,52665,260,56,245,145,61938,306,75,199,126,-46,19,65,225,77
18,lak511d.map,506,202,15073,74,76,431,125,10435,51,68,454,133,23,-8,31,379,311
19,lak511d.map,506,202,87809,434,60,71,141,11262,55,49,450,152,379,-11,390,15665,11068
20,lak511d.map,506,202,75065,371,78,134,123,27978,138,99,367,102,233,21,254,15665,11068
21,lak511d.map,506,202,97288,481,75,24,126,32167,159,152,346,49,322,77,399,15665,11068
22,lak511d.map,506,202,93860,464,69,41,132,65310,323,137,182,64,141,68,209,15665,395
23,lak511d.map,506,202,72828,360,93,145,108,14511,71,32,434,169,289,-61,350,15665,11068
24,lak511d.map,506,202,62978,311,45,194,156,47006,232,59,273,142,79,14,93,94,269
25,lak511d.map,506,202,31376,155,135,350,66,86191,426,62,79,139,-271,-73,344,11068,15665
26,lak511d.map,506,202,63744,315,87,190,114,6971,34,98,471,103,281,11,292,15665,11068
27,lak511d.map,506,202,28340,140,141,365,60,63381,313,46,192,155,-173,-95,268,11068,15665
28,lak511d.map,506,202,22955,113,72,392,129,3950,19,89,486,112,94,17,111,1062,337
29,lak511d.map,506,202,22181,109,38,396,163,870,4,139,501,62,105,101,206,11068,1463
30,lak511d.map,506,202,4785,23,62,482,139,28522,141,161,364,40,-118,99,217,5135,2186
31,lak511d.map,506,202,31208,154,101,351,100,4739,23,108,482,93,131,7,138,1805,2908
32,lak511d.map,506,202,82335,407,80,98,121,34999,173,148,332,53,234,68,302,15665,11068
33,lak511d.map,506,202,2725,13,102,492,99,52022,257,93,248,108,-244,-9,253,11068,15665
34,lak511d.map,506,202,94848,469,91,36,110,99671,493,116,12,85,-24,25,49,62,162
35,lak511d.map,506,202,71038,351,65,154,136,6118,30,143,475,58,321,78,399,15665,1463
36,lak511d.map,506,202,101036,500,165,5,36,30799,152,106,353,95,348,-59,407,15665,11068
37,lak511d.map,506,202,41995,207,20,298,181,53694,265,37,240,164,-58,17,75,569,511
38,lak511d.map,506,202,29211,144,78,361,123,28316,140,165,365,36,4,87,91,2098,2360
39,lak511d.map,506,202,34248,169,91,336,110,86181,426,72,79,129,-257,-19,276,11068,15665
40,lak511d.map,506,202,7977,39,102,466,99,97071,480,90,25,111,-441,-12,453,11068,15665
41,lak511d.map,506,202,28177,139,102,366,99,100475,497,120,8,81,-358,18,376,11068,15665
42,lak511d.map,506,202,17898,88,79,417,122,53045,262,80,243,121,-174,1,175,11068,15665
43,lak511d.map,506,202,96640,478,117,27,84,61723,305,88,200,113,173,-29,202,6237,4075
44,lak511d.map,506,202,62186,307,29,198,172,31811,157,104,348,97,150,75,225,15665,11068
45,lak511d.map,506,202,24184,119,55,386,146,7204,35,67,470,134,84,12,96,2429,3108
46,lak511d.map,506,202,12264,60,57,445,144,99681,493,106,12,95,-433,49,482,11068,15665
47,lak511d.map,506,202,34172,169,167,336,34,56095,277,60,228,141,-108,-107,215,11068,15665
48,lak511d.map,506,202,48579,240,102,265,99,52711,260,10,245,191,-20,-92,112,123,456
49,lak511d.map,506,202,63897,316,136,189,65,96650,478,107,27,94,-162,-29,191,395,15665
50,lak511d.map,506,202,25296,125,155,380,46,64700,320,141,185,60,-195,-14,209,11068,395
51,lak511d.map,506,202,43580,215,51,290,150,81724,404,85,101,116,-189,34,223,1419,261
52,lak511d.map,506,202,56056,277,99,228,102,52660,260,61,245,140,17,-38,55,56,56
53,lak511d.map,506,202,99652,493,135,12,66,33598,166,135,339,66,327,0,327,15665,11068
54,lak511d.map,506,202,61717,305,94,200,107,28751,142,134,363,67,163,40,203,15665,11068
55,lak511d.map,506,202,100462,497,133,8,68,91007,450,94,55,107,47,-39,86,606,247
56,lak511d.map,506,202,63680,315,151,190,50,98817,489,162,16,39,-174,11,185,395,15665
57,lak511d.map,506,202,101650,503,157,2,44,26691,132,174,373,27,371,17,388,15665,11068
58,lak511d.map,506,202,101657,503,150,2,51,93436,462,89,43,112,41,-61,102,712,150
59,lak511d.map,506,202,90028,445,63,60,138,86805,429,54,76,147,16,-9,25,26,26
60,lak511d.map,506,202,86988,430,73,75,128,42917,212,108,293,93,218,35,253,3739,6429
61,lak511d.map,506,202,19725,97,70,408,131,2734,13,93,492,108,84,23,107,789,384
62,lak511d.map,506,202,42315,209,104,296,97,93243,461,80,44,121,-252,-24,276,6652,5109
63,lak511d.map,506,202,9441,46,52,459,149,97285,481,78,24,123,-435,26,461,11068,15665
64,lak511d.map,506,202,80714,399,85,106,116,85971,425,80,80,121,-26,-5,31,84,32
65,lak511d.map,506,202,93816,464,113,41,88,2662,13,165,492,36,451,52,503,15665,1463
66,lak511d.map,506,202,15682,77,73,428,128,89628,443,59,62,142,-366,-14,380,11068,15665
67,lak511d.map,506,202,101081,500,120,5,81,93766,464,163,41,38,36,43,79,80,80
68,lak511d.map,506,202,38038,188,139,317,62,36823,182,142,323,59,6,3,9,10,10
69,lak511d.map,506,202,58779,290,2,215,199,15293,75,58,430,143,215,56,271,15665,11068
70,lak511d.map,506,202,57113,282,52,223,149,40098,198,99,307,102,84,47,131,209,143
71,lak511d.map,506,202,100221,496,172,9,29,11262,55,49,450,152,441,-123,564,15665,11068
72,lak511d.map,506,202,33068,163,59,342,142,34231,169,108,336,93,-6,49,55,56,56
73,lak511d.map,506,202,15112,74,37,431,164,53695,265,36,240,165,-191,-1,192,11068,15665
74,lak511d.map,506,202,22172,109,47,396,154,28180,139,99,366,102,-30,52,82,495,530
75,lak511d.map,506,202,69635,344,54,161,147,43596,215,35,290,166,129,-19,148,149,149
76,lak511d.map,506,202,31617,156,96,349,105,17742,87,33,418,168,69,-63,132,3314,1795
77,lak511d.map,506,202,43817,216,16,289,185,43941,217,94,288,107,-1,78,79,80,80
78,lak511d.map,506,202,6152,30,109,475,92,65105,322,140,183,61,-292,31,323,11068,395
79,lak511d.map,506,202,28896,143,191,362,10,69831,345,60,160,141,-202,-131,333,11068,15665
80,lak511d.map,506,202,43961,217,74,288,127,32807,162,118,343,83,55,44,99,15665,11068
81,lak511d.map,506,202,29329,145,162,360,39,259,1,144,504,57,144,-18,162,11068,1463
82,lak511d.map,506,202,34234,169,105,336,96,29494,146,199,359,2,23,94,117,878,1562
83,lak511d.map,506,202,37050,183,117,322,84,52427,259,92,246,109,-76,-25,101,11068,15665
84,lak511d.map,506,202,69401,343,86,162,115,94213,466,120,39,81,-123,34,157,2830,657
85,lak511d.map,506,202,25083,124,166,381,35,14077,69,62,436,139,55,-104,159,2291,5817
86,lak511d.map,506,202,14302,70,39,435,162,30654,151,49,354,152,-81,10,91,2049,1850
87,lak511d.map,506,202,59528,294,61,211,140,42935,212,90,293,111,82,29,111,125,454
88,lak511d.map,506,202,6192,30,69,475,132,62383,308,34,197,167,-278,-35,313,11068,15665
89,lak511d.map,506,202,99280,491,103,14,98,62973,311,50,194,151,180,-53,233,280,985
90,lak511d.map,506,202,63116,312,109,193,92,73271,362,54,143,147,-50,-55,105,106,106
91,lak511d.map,506,202,25564,126,89,379,112,7741,38,136,467,65,88,47,135,11068,1463
92,lak511d.map,506,202,76074,376,79,129,122,43222,213,5,292,196,163,-74,237,258,1398
93,lak511d.map,506,202,98218,486,155,19,46,9798,48,99,457,102,438,-56,494,15665,11068
94,lak511d.map,506,202,51048,252,57,253,144,6125,30,136,475,65,222,79,301,15665,1463
95,lak511d.map,506,202,54086,267,49,238,152,62887,311,136,194,65,-44,87,131,15665,395
96,lak511d.map,506,202,3281,16,152,489,49,42557,210,64,295,137,-194,-88,282,1463,15665
97,lak511d.map,506,202,93460,462,65,43,136,58878,291,105,214,96,171,40,211,5135,3731
98,lak511d.map,506,202,39088,193,99,312,102,44235,218,2,287,199,-25,-97,122,144,291
99,lak511d.map,506,202,45347,224,102,281,99,4581,22,64,483,137,202,-38,240,15665,11068
0,lak512d.map,652,289,19492,67,159,584,129,56478,195,165,456,123,-128,6,134,1530,25476
1,lak512d.map,652,289,82544,285,109,366,179,152783,528,97,123,191,-243,-12,255,5588,8430
2,lak512d.map,652,289,19244,66,118,585,170,21365,73,20,578,268,-7,-98,105,1530,1453
3,lak512d.map,652,289,161168,557,93,94,195,65388,226,214,425,74,331,121,452,16179,10255
4,lak512d.map,652,289,152523,527,68,124,220,118132,408,68,243,220,119,0,119,1584,4509
5,lak512d.map,652,289,186881,646,101,5,187,130279,450,59,201,229,196,-42,238,239,1145
6,lak512d.map,652,289,107016,370,202,281,86,159746,552,70,99,218,-182,-132,314,1551,25476
7,lak512d.map,652,289,17614,60,14,591,274,28958,100,230,551,58,-40,216,256,1453,25476
8,lak512d.map,652,289,156835,542,91,109,197,50966,176,186,475,102,366,95,461,9227,10864
9,lak512d.map,652,289,65663,227,228,424,60,132015,456,57,195,231,-229,-171,400,8513,11541
10,lak512d.map,652,289,19200,66,162,585,126,115874,400,14,251,274,-334,-148,482,1530,25476
11,lak512d.map,652,289,51248,177,193,474,95,102294,353,11,298,277,-176,-182,358,838,756
12,lak512d.map,652,289,49763,172,233,479,55,10431,36,261,615,27,136,28,164,1074,4657
13,lak512d.map,652,289,122764,424,60,227,228,34126,118,264,533,24,306,204,510,3987,12096
14,lak512d.map,652,289,20774,71,33,580,255,122471,423,64,228,224,-352,31,383,1453,25476
15,lak512d.map,652,289,35029,121,228,530,60,40285,139,174,512,114,-18,-54,72,79,77
16,lak512d.map,652,289,29072,100,116,551,172,187769,649,80,2,208,-549,-36,585,1530,25476
17,lak512d.map,652,289,104793,362,113,289,175,49563,171,144,480,144,191,31,222,5060,3172
18,lak512d.map,652,289,156531,541,106,110,182,140358,485,95,166,193,56,-11,67,68,68
19,lak512d.map,652,289,123054,425,59,226,229,184015,636,77,15,211,-211,18,229,2857,1237
20,lak512d.map,652,289,117826,407,85,244,203,99661,344,43,307,245,63,-42,105,2085,2173
21,lak512d.map,652,289,16524,57,237,594,51,55311,191,176,460,112,-134,-61,195,2526,276
22,lak512d.map,652,289,10985,38,285,613,3,103655,358,95,293,193,-320,-190,510,2516,695
23,lak512d.map,652,289,85440,295,103,356,185,104230,360,98,291,190,-65,-5,70,323,462
24,lak512d.map,652,289,49253,170,165,481,123,138615,479,104,172,184,-309,-61,370,11312,14097
25,lak512d.map,652,289,172155,595,88,56,200,11606,40,242,611,46,555,154,709,10858,17918
26,lak512d.map,652,289,24905,86,237,565,51,124787,431,60,220,228,-345,-177,522,13001,4145
27,lak512d.map,652,289,48973,169,156,482,132,185749,642,77,9,211,-473,-79,552,15282,16635
28,lak512d.map,652,289,118473,409,16,242,272,42562,147,209,504,79,262,193,455,1919,6467
29,lak512d.map,652,289,127962,442,64,209,224,117876,407,35,244,253,35,-29,64,396,118
30,lak512d.map,652,289,105171,363,24,288,264,57878,200,210,451,78,163,186,349,614,781
31,lak512d.map,652,289,61640,213,205,438,83,125071,432,65,219,223,-219,-140,359,8727,9674
32,lak512d.map,652,289,179363,620,105,31,183,147895,511,72,140,216,109,-33,142,143,934
33,lak512d.map,652,289,114716,396,16,255,272,82543,285,110,366,178,111,94,205,587,2700
34,lak512d.map,652,289,88904,307,107,344,181,103445,357,16,294,272,-50,-91,141,194,401
35,lak512d.map,652,289,19417,67,234,584,54,63151,218,139,433,149,-151,-95,246,1592,403
36,lak512d.map,652,289,185448,641,89,10,199,177931,615,92,36,196,26,3,29,30,30
37,lak512d.map,652,289,43210,149,139,502,149,116090,401,87,250,201,-252,-52,304,11229,11925
38,lak512d.map,652,289,142376,492,100,159,188,180838,625,75,26,213,-133,-25,158,1413,163
39,lak512d.map,652,289,94969,328,111,323,177,88620,306,102,345,186,22,-9,31,32,32
40,lak512d.map,652,289,156532,541,105,110,183,20389,70,129,581,159,471,24,495,25476,1530
41,lak512d.map,652,289,56474,195,169,456,119,154804,535,99,116,189,-340,-70,410,10106,8855
42,lak512d.map,652,289,93817,324,107,327,181,34498,119,181,532,107,205,74,279,3079,1632
43,lak512d.map,652,289,66257,229,212,422,76,43789,151,138,500,150,78,-74,152,282,238
44,lak512d.map,652,289,119296,412,60,239,228,132849,459,90,192,198,-47,30,77,78,134
45,lak512d.map,652,289,181109,626,93,25,195,157711,545,82,106,206,81,-11,92,93,93
46,lak512d.map,652,289,172752,597,69,54,219,157699,545,94,106,194,52,25,77,87,680
47,lak512d.map,652,289,25772,89,237,562,51,99615,344,89,307,199,-255,-148,403,2094,588
48,lak512d.map,652,289,121864,421,93,230,195,46007,159,232,492,56,262,139,401,10903,11132
49,lak512d.map,652,289,96434,333,91,318,197,18532,64,252,587,36,269,161,430,635,2210
50,lak512d.map,652,289,97034,335,69,316,219,112236,388,184,263,104,-53,115,168,25476,1551
51,lak512d.map,652,289,176501,610,77,41,211,44574,154,220,497,68,456,143,599,10656,15545
52,lak512d.map,652,289,143816,497,105,154,183,67961,235,242,416,46,262,137,399,14476,10935
53,lak512d.map,652,289,162899,563,96,88,192,144711,500,77,151,211,63,-19,82,83,83
54,lak512d.map,652,289,10704,37,277,614,11,59060,204,184,447,104,-167,-93,260,707,327
55,lak512d.map,652,289,18777,64,7,587,281,41471,143,144,508,144,-79,137,216,1453,25476
56,lak512d.map,652,289,117593,406,29,245,259,148430,513,115,138,173,-107,86,193,493,204
57,lak512d.map,652,289,161436,558,114,93,174,11615,40,233,611,55,518,119,637,15901,15905
58,lak512d.map,652,289,46625,161,192,490,96,13020,45,273,606,15,116,81,197,420,483
59,lak512d.map,652,289,176776,611,91,40,197,76765,265,108,386,180,346,17,363,10315,5582
60,lak512d.map,652,289,4081,14,253,637,35,62570,216,142,435,146,-202,-111,313,1861,467
61,lak512d.map,652,289,106741,369,188,282,100,114527,396,205,255,83,-27,17,44,79,50
62,lak512d.map,652,289,113380,392,196,259,92,75605,261,112,390,176,131,-84,215,1551,25476
63,lak512d.map,652,289,153056,529,113,122,175,81382,281,115,370,173,248,2,250,8440,5921
64,lak512d.map,652,289,182857,632,79,19,209,19333,66,29,585,259,566,-50,616,25476,1453
65,lak512d.map,652,289,49755,172,241,479,47,181699,628,81,23,207,-456,-160,616,15171,17538
66,lak512d.map,652,289,70953,245,140,406,148,99986,345,7,306,281,-100,-133,233,515,529
67,lak512d.map,652,289,127362,440,86,211,202,149620,517,81,134,207,-77,-5,82,287,577
68,lak512d.map,652,289,42566,147,205,504,83,90358,312,98,339,190,-165,-107,272,1393,391
69,lak512d.map,652,289,156562,541,75,110,213,82538,285,115,366,173,256,40,296,8868,8268
70,lak512d.map,652,289,63730,220,138,431,150,19836,68,104,583,184,152,-34,186,25476,1530
71,lak512d.map,652,289,179654,621,103,30,185,116711,403,44,248,244,218,-59,277,278,1575
72,lak512d.map,652,289,49234,170,184,481,104,13350,46,232,605,56,124,48,172,1770,494
73,lak512d.map,652,289,165795,573,90,78,198,18516,64,268,587,20,509,178,687,10679,15303
74,lak512d.map,652,289,74153,256,119,395,169,101679,351,48,300,240,-95,-71,166,1726,338
75,lak512d.map,652,289,120456,416,56,235,232,164040,567,111,84,177,-151,55,206,573,214
76,lak512d.map,652,289,26578,91,9,560,279,144965,501,112,150,176,-410,103,513,1453,25476
77,lak512d.map,652,289,93256,322,90,329,198,105614,365,159,286,129,-43,69,112,25476,1551
78,lak512d.map,652,289,18360,63,135,588,153,14771,51,256,600,32,12,121,133,1530,25476
79,lak512d.map,652,289,20952,72,144,579,144,23955,82,31,569,257,-10,-113,123,1530,1453
80,lak512d.map,652,289,28082,97,239,554,49,35354,122,192,529,96,-25,-47,72,95,120
81,lak512d.map,652,289,43134,149,215,502,73,145007,501,70,150,218,-352,-145,497,14206,8318
82,lak512d.map,652,289,1755,6,267,645,21,115846,400,42,251,246,-394,-225,619,14310,2857
83,lak512d.map,652,289,20970,72,126,579,162,97607,337,74,314,214,-265,-52,317,1530,25476
84,lak512d.map,652,289,139787,483,88,168,200,17500,60,128,591,160,423,40,463,25476,1530
85,lak512d.map,652,289,98179,339,80,312,208,65375,226,227,425,61,113,147,260,4803,1549
86,lak512d.map,652,289,23688,81,9,570,279,21580,74,94,577,194,7,85,92,1453,1530
87,lak512d.map,652,289,149896,518,94,133,194,181102,626,100,25,188,-108,6,114,470,327
88,lak512d.map,652,289,12139,42,287,609,1,118973,411,94,240,194,-369,-193,562,15145,4812
89,lak512d.map,652,289,37602,130,256,521,32,147566,510,112,141,176,-380,-144,524,14152,16508
90,lak512d.map,652,289,142385,492,91,159,197,113946,394,208,257,80,98,117,215,25476,1551
91,lak512d.map,652,289,69520,240,128,411,160,126779,438,91,213,197,-198,-37,235,5991,5209
92,lak512d.map,652,289,17089,59,250,592,38,34163,118,227,533,61,-59,-23,82,232,83
93,lak512d.map,652,289,62218,215,205,436,83,173037,598,73,53,215,-383,-132,515,14781,15876
94,lak512d.map,652,289,123921,428,59,223,229,157146,543,69,108,219,-115,10,125,1743,1751
95,lak512d.map,652,289,97624,337,57,314,231,93818,324,106,327,182,13,49,62,191,302
96,lak512d.map,652,289,65098,225,215,426,73,103309,357,152,294,136,-132,-63,195,25476,1551
97,lak512d.map,652,289,84861,293,104,358,184,44591,154,203,497,85,139,99,238,357,1181
98,lak512d.map,652,289,8985,31,262,620,26,34427,119,252,532,36,-88,-10,98,1879,702
99,lak512d.map,652,289,21050,72,46,579,242,29237,101,240,550,48,-29,194,223,1453,25476
0,lak513d.map,623,363,154324,425,313,197,49,32084,88,222,534,140,337,-91,428,16009,20761
1,lak513d.map,623,363,146188,402,100,220,262,60125,165,132,457,230,237,32,269,2594,20761
2,lak513d.map,623,363,18477,50,35,572,327,117343,323,268,299,94,-273,233,506,1565,20761
3,lak513d.map,623,363,143491,395,256,227,106,24197,66,123,556,239,329,-133,462,16009,637
4,lak513d.map,623,363,61210,168,136,454,226,43702,120,220,502,142,48,84,132,2135,332
5,lak513d.map,623,363,200472,552,266,70,96,147998,407,105,215,257,145,-161,306,16009,2594
6,lak513d.map,623,363,38619,106,221,516,141,51399,141,146,481,216,-35,-75,110,1150,1098
7,lak513d.map,623,363,17746,48,40,574,322,19214,52,24,570,338,-4,-16,20,21,21
8,lak513d.map,623,363,102471,282,257,340,105,111919,308,247,314,115,-26,-10,36,37,37
9,lak513d.map,623,363,13195,36,235,586,127,17719,48,67,574,295,-12,-168,180,20761,1565
10,lak513d.map,623,363,201154,554,310,68,52,76647,211,308,411,54,343,-2,345,16009,20761
11,lak513d.map,623,363,78522,216,248,406,114,168099,463,332,159,30,-247,84,331,20761,16009
12,lak513d.map,623,363,103537,285,280,337,82,50709,139,110,483,252,146,-170,316,781,846
13,lak513d.map,623,363,178282,491,313,131,49,18134,49,15,573,347,442,-298,740,16009,1565
14,lak513d.map,623,363,188533,519,226,103,136,61927,170,145,452,217,349,-81,430,16009,20761
15,lak513d.map,623,363,147451,406,289,216,73,55374,152,164,470,198,254,-125,379,16009,20761
16,lak513d.map,623,363,54696,150,116,472,246,149632,412,286,210,76,-262,170,432,20761,16009
17,lak513d.map,623,363,196436,541,309,81,53,111894,308,272,314,90,233,-37,270,16009,20761
18,lak513d.map,623,363,152857,421,328,201,34,17010,46,50,576,312,375,-278,653,16009,1565
19,lak513d.map,623,363,95938,264,256,358,106,192478,530,274,92,88,-266,18,284,20761,16009
20,lak513d.map,623,363,58907,162,261,460,101,61191,168,155,454,207,-6,-106,112,869,628
21,lak513d.map,623,363,98113,270,259,352,103,188083,518,313,104,49,-248,54,302,20761,16009
22,lak513d.map,623,363,59395,163,136,459,226,144902,399,297,223,65,-236,161,397,20761,16009
23,lak513d.map,623,363,147825,407,278,215,84,154079,424,195,198,167,-17,-83,100,1882,1177
24,lak513d.map,623,363,8840,24,234,598,128,153590,423,321,199,41,-399,87,486,20761,16009
25,lak513d.map,623,363,143665,395,82,227,280,186631,514,313,108,49,-119,231,350,2594,16009
26,lak513d.map,623,363,67729,186,151,436,211,49607,136,123,486,239,50,-28,78,80,79
27,lak513d.map,623,363,147432,406,308,216,54,191101,526,199,96,163,-120,-109,229,2879,3118
28,lak513d.map,623,363,89123,245,174,377,188,176959,487,184,135,178,-242,10,252,20761,16009
29,lak513d.map,623,363,94232,259,147,363,215,86926,239,193,383,169,20,46,66,200,70
30,lak513d.map,623,363,157330,433,211,189,151,199007,548,279,74,83,-115,68,183,1300,3195
31,lak513d.map,623,363,185168,510,324,112,38,97014,267,269,355,93,243,-55,298,16009,20761
32,lak513d.map,623,363,138195,380,107,242,255,71614,197,259,425,103,183,152,335,2594,20761
33,lak513d.map,623,363,175150,482,178,140,184,103311,284,143,338,219,198,-35,233,16009,20761
34,lak513d.map,623,363,29550,81,215,541,147,855,2,233,620,129,79,18,97,101,635
35,lak513d.map,623,363,155404,428,322,194,40,182373,502,215,120,147,-74,-107,181,1494,1201
36,lak513d.map,623,363,218758,602,130,20,232,162439,447,184,175,178,155,54,209,1434,16009
37,lak513d.map,623,363,97124,267,159,355,203,78917,217,216,405,146,50,57,107,203,143
38,lak513d.map,623,363,103165,284,289,338,73,143470,395,277,227,85,-111,-12,123,20761,16009
39,lak513d.map,623,363,179109,493,212,129,150,187334,516,336,106,26,-23,124,147,2078,4842
40,lak513d.map,623,363,113340,312,278,310,84,161341,444,193,178,169,-132,-85,217,20761,16009
41,lak513d.map,623,363,91321,251,154,371,208,69012,190,320,432,42,61,166,227,2900,1409
42,lak513d.map,623,363,157604,434,300,188,62,184095,507,308,115,54,-73,8,81,1053,1628
43,lak513d.map,623,363,89192,245,105,377,257,149300,411,255,211,107,-166,150,316,20761,16009
44,lak513d.map,623,363,53622,147,101,475,261,35342,97,231,525,131,50,130,180,1006,1241
45,lak513d.map,623,363,80321,221,264,401,98,204444,563,287,59,75,-342,23,365,20761,16009
46,lak513d.map,623,363,106082,292,276,330,86,97756,269,253,353,109,23,-23,46,47,47
47,lak513d.map,623,363,140370,386,110,236,252,153244,422,304,200,58,-36,194,230,2594,16009
48,lak513d.map,623,363,137818,379,121,243,241,28085,77,228,545,134,302,107,409,2594,20761
49,lak513d.map,623,363,212944,586,136,36,226,186279,513,302,109,60,73,166,239,1434,16009
50,lak513d.map,623,363,28821,79,218,543,144,152879,421,306,201,56,-342,88,430,20761,16009
51,lak513d.map,623,363,14128,38,28,584,334,15867,43,104,579,258,-5,76,81,1565,637
52,lak513d.map,623,363,174289,480,313,142,49,189185,521,300,101,62,-41,-13,54,55,57
53,lak513d.map,623,363,190690,525,247,97,115,96765,266,155,356,207,259,-92,351,16009,20761
54,lak513d.map,623,363,54987,151,188,471,174,186989,515,318,107,44,-364,130,494,20761,16009
55,lak513d.map,623,363,55784,153,117,469,245,25042,68,4,554,358,85,-113,198,20761,1565
56,lak513d.map,623,363,182016,501,209,121,153,32442,89,227,533,135,412,18,430,16009,20761
57,lak513d.map,623,363,155035,427,328,195,34,198612,547,311,75,51,-120,-17,137,1179,945
58,lak513d.map,623,363,36442,100,220,522,142,163875,451,200,171,162,-351,-20,371,20761,16009
59,lak513d.map,623,363,178637,492,321,130,41,48863,134,141,488,221,358,-180,538,16009,20761
60,lak513d.map,623,363,141689,390,243,232,119,57226,157,127,465,235,233,-116,349,16009,20761
61,lak513d.map,623,363,71898,198,338,424,24,79287,218,209,404,153,-20,-129,149,1702,1563
62,lak513d.map,623,363,9597,26,203,596,159,25549,70,223,552,139,-44,20,64,468,232
63,lak513d.map,623,363,63393,174,131,448,231,68409,188,197,434,165,-14,66,80,1621,835
64,lak513d.map,623,363,41900,115,207,507,155,95709,263,122,359,240,-148,-85,233,2526,5225
65,lak513d.map,623,363,218408,601,117,21,245,179139,493,182,129,180,108,65,173,1434,16009
66,lak513d.map,623,363,196186,540,196,82,166,210022,578,154,44,208,-38,-42,80,16009,1434
67,lak513d.map,623,363,58288,160,154,462,208,150065,413,216,209,146,-253,62,315,20761,16009
68,lak513d.map,623,363,69341,191,354,431,8,203389,560,253,62,109,-369,-101,470,20761,16009
69,lak513d.map,623,363,188185,518,211,104,151,185266,510,226,112,136,8,15,23,32,132
70,lak513d.map,623,363,149266,411,289,211,73,34260,94,224,528,138,317,-65,382,16009,20761
71,lak513d.map,623,363,62459,172,339,450,23,189939,523,272,99,90,-351,-67,418,20761,16009
72,lak513d.map,623,363,171857,473,204,149,158,89836,247,187,375,175,226,-17,243,16009,20761
73,lak513d.map,623,363,54201,149,248,473,114,126967,349,82,273,280,-200,-166,366,20761,2594
74,lak513d.map,623,363,60429,166,191,456,171,146799,404,215,218,147,-238,24,262,20761,16009
75,lak513d.map,623,363,151482,417,251,205,111,160983,443,188,179,174,-26,-63,89,1844,503
76,lak513d.map,623,363,217308,598,128,24,234,16630,45,67,577,295,553,-61,614,1434,1565
77,lak513d.map,623,363,193176,532,302,90,60,138222,380,80,242,282,152,-222,374,16009,2594
78,lak513d.map,623,363,150808,415,199,207,163,8457,23,254,599,108,392,55,447,16009,20761
79,lak513d.map,623,363,143620,395,127,227,235,87317,240,165,382,197,155,38,193,2594,20761
80,lak513d.map,623,363,168609,464,185,158,177,80387,221,198,401,164,243,13,256,16009,20761
81,lak513d.map,623,363,95336,262,132,360,230,81837,225,200,397,162,37,68,105,599,133
82,lak513d.map,623,363,204501,563,230,59,132,8494,23,217,599,145,540,-13,553,16009,20761
83,lak513d.map,623,363,98235,270,137,352,225,192923,531,192,91,170,-261,55,316,20761,16009
84,lak513d.map,623,363,13557,37,236,585,126,38261,105,216,517,146,-68,-20,88,199,91
85,lak513d.map,623,363,52844,145,153,477,209,183373,505,304,117,58,-360,151,511,20761,16009
86,lak513d.map,623,363,63577,175,310,447,52,76367,210,225,412,137,-35,-85,120,160,312
87,lak513d.map,623,363,192075,529,314,93,48,50342,138,114,484,248,391,-200,591,16009,20761
88,lak513d.map,623,363,201896,556,294,66,68,63027,173,134,449,228,383,-160,543,16009,20761
89,lak513d.map,623,363,194603,536,327,86,35,170419,469,190,153,172,67,-137,204,7621,5614
90,lak513d.map,623,363,171011,471,324,151,38,194004,534,200,88,162,-63,-124,187,3778,1717
91,lak513d.map,623,363,144385,397,88,225,274,68651,189,318,433,44,208,230,438,2594,20761
92,lak513d.map,623,363,51067,140,115,482,247,95174,262,294,360,68,-122,179,301,1051,753
93,lak513d.map,623,363,63571,175,316,447,46,101839,280,163,342,199,-105,-153,258,347,945
94,lak513d.map,623,363,107179,295,268,327,94,9940,27,223,595,139,268,-45,313,877,3026
95,lak513d.map,623,363,182244,502,344,120,18,176574,486,206,136,156,16,-138,154,5802,3112
96,lak513d.map,623,363,183705,506,335,116,27,67963,187,280,435,82,319,-55,374,16009,20761
97,lak513d.map,623,363,110466,304,248,318,114,124788,343,83,279,279,-39,-165,204,20761,2594
98,lak513d.map,623,363,21776,59,3,563,359,74222,204,192,418,170,-145,189,334,1565,20761
99,lak513d.map,623,363,183459,505,218,117,144,161597,445,300,177,62,60,82,142,1664,1387
0,lak514d.map,330,374,68992,184,197,145,176,67870,181,197,148,176,3,0,3,4,4
1,lak514d.map,330,374,69566,186,371,143,2,105439,281,28,48,345,-95,-343,438,4149,4715
2,lak514d.map,330,374,93625,250,248,79,125,107542,287,169,42,204,-37,-79,116,3802,987
3,lak514d.map,330,374,68996,184,193,145,180,38612,103,283,226,90,81,90,171,3802,3204
4,lak514d.map,330,374,103556,276,41,53,332,107327,286,10,43,363,-10,-31,41,42,42
5,lak514d.map,330,374,74939,200,234,129,139,98462,263,273,66,100,-63,39,102,109,107
6,lak514d.map,330,374,68113,182,328,147,45,100195,267,36,62,337,-85,-292,377,4149,4715
7,lak514d.map,330,374,66714,178,231,151,142,25724,68,81,261,292,110,-150,260,3802,4477
8,lak514d.map,330,374,96985,259,254,70,119,42380,113,255,216,118,146,1,147,3802,3204
9,lak514d.map,330,374,108656,290,177,39,196,81577,218,328,111,45,72,151,223,987,4149
10,lak514d.map,330,374,36384,97,267,232,106,113284,302,37,27,336,-205,-230,435,3204,4715
11,lak514d.map,330,374,18298,48,27,281,346,113519,303,176,26,197,-255,149,404,4477,987
12,lak514d.map,330,374,105669,282,172,47,201,32429,86,108,243,265,196,-64,260,987,4477
13,lak514d.map,330,374,70313,188,372,141,1,31141,83,274,246,99,105,-98,203,4149,3204
14,lak514d.map,330,374,53876,144,353,185,20,111068,296,9,33,364,-152,-344,496,4149,4715
15,lak514d.map,330,374,106961,285,2,44,371,88310,236,327,93,46,49,325,374,4715,4149
16,lak514d.map,330,374,14572,38,13,291,360,53116,142,365,187,8,-104,352,456,4477,4149
17,lak514d.map,330,374,24952,66,105,263,268,109546,292,35,37,338,-226,-70,296,4477,4715
18,lak514d.map,330,374,25722,68,83,261,290,32029,85,134,244,239,-17,51,68,69,416
19,lak514d.map,330,374,102067,272,34,57,339,38998,104,271,225,102,168,237,405,4715,3204
20,lak514d.map,330,374,69593,186,344,143,29,34171,91,236,238,137,95,-108,203,4149,3204
21,lak514d.map,330,374,31144,83,271,246,102,20914,55,29,274,344,28,-242,270,3204,4477
22,lak514d.map,330,374,6324,16,33,313,340,19765,52,56,277,317,-36,23,59,207,528
23,lak514d.map,330,374,19036,50,37,279,336,76727,205,316,124,57,-155,279,434,4477,4149
24,lak514d.map,330,374,15306,40,27,289,346,109510,292,71,37,302,-252,44,296,4477,4715
25,lak514d.map,330,374,84677,226,220,103,153,77919,208,246,121,127,18,26,44,70,61
26,lak514d.map,330,374,106913,285,50,44,323,102429,273,46,56,327,12,-4,16,17,17
27,lak514d.map,330,374,1104,2,17,327,356,81258,217,273,112,100,-215,256,471,4477,3802
28,lak514d.map,330,374,115132,307,59,22,314,61726,165,357,164,16,142,298,440,4715,4149
29,lak514d.map,330,374,62878,168,327,161,46,103567,276,30,53,343,-108,-297,405,4149,4715
30,lak514d.map,330,374,30766,82,275,247,98,36407,97,244,232,129,-15,-31,46,57,128
31,lak514d.map,330,374,111030,296,47,33,326,82383,220,270,109,103,76,223,299,4715,3802
32,lak514d.map,330,374,110296,294,33,35,340,97352,260,261,69,112,34,228,262,4715,3802
33,lak514d.map,330,374,59098,158,367,171,6,25717,68,88,261,285,90,-279,369,4149,4477
34,lak514d.map,330,374,86497,231,270,98,103,119259,318,46,11,327,-87,-224,311,3802,4715
35,lak514d.map,330,374,35624,95,279,234,94,116649,311,38,18,335,-216,-241,457,3204,4715
36,lak514d.map,330,374,114771,306,46,23,327,60614,162,347,167,26,144,301,445,4715,4149
37,lak514d.map,330,374,23150,61,37,268,336,82398,220,255,109,118,-159,218,377,4477,3802
38,lak514d.map,330,374,102809,274,40,55,333,108396,289,63,40,310,-15,23,38,39,39
39,lak514d.map,330,374,66585,178,360,151,13,101714,271,13,58,360,-93,-347,440,4149,4715
40,lak514d.map,330,374,121508,324,41,5,332,113517,303,178,26,195,21,137,158,4715,987
41,lak514d.map,330,374,112506,300,67,29,306,4466,11,21,318,352,289,-46,335,4715,4477
42,lak514d.map,330,374,91760,245,243,84,130,78676,210,237,119,136,35,-6,41,263,712
43,lak514d.map,330,374,97930,261,57,68,316,109542,292,39,37,334,-31,-18,49,50,50
44,lak514d.map,330,374,32843,87,68,242,305,73334,196,343,133,30,-109,275,384,4477,4149
45,lak514d.map,330,374,110280,294,49,35,324,35218,94,311,235,62,200,262,462,4715,3204
46,lak514d.map,330,374,85434,228,211,101,162,57275,153,320,176,53,75,109,184,3802,4149
47,lak514d.map,330,374,106177,283,38,46,335,37164,99,235,230,138,184,197,381,4715,3204
48,lak514d.map,330,374,101700,271,27,58,346,103173,275,50,54,323,-4,23,27,28,28
49,lak514d.map,330,374,37152,99,247,230,126,24276,64,33,265,340,35,-214,249,3204,4477
50,lak514d.map,330,374,101706,271,21,58,352,42029,112,232,217,141,159,211,370,4715,3204
51,lak514d.map,330,374,119249,318,56,11,317,34291,91,116,238,257,227,60,287,4715,4477
52,lak514d.map,330,374,34334,91,73,238,300,107295,286,42,43,331,-195,-31,226,4477,4715
53,lak514d.map,330,374,52762,141,345,188,28,25692,68,113,261,260,73,-232,305,4149,4477
54,lak514d.map,330,374,114370,305,73,24,300,112906,301,41,28,332,4,-32,36,37,37
55,lak514d.map,330,374,97594,260,19,69,354,111270,297,181,32,192,-37,162,199,4715,987
56,lak514d.map,330,374,11952,31,15,298,358,81558,218,347,111,26,-187,332,519,4477,4149
57,lak514d.map,330,374,77544,207,247,122,126,46429,124,320,205,53,83,73,156,3802,3204
58,lak514d.map,330,374,67712,181,355,148,18,37883,101,264,228,109,80,-91,171,4149,3204
59,lak514d.map,330,374,112568,300,5,29,368,118498,316,59,13,314,-16,54,70,71,71
60,lak514d.map,330,374,73853,197,198,132,175,108798,290,35,39,338,-93,-163,256,3802,4715
61,lak514d.map,330,374,25726,68,79,261,294,33750,90,283,239,90,-22,204,226,4477,3204
62,lak514d.map,330,374,70323,188,362,141,11,31278,83,137,246,236,105,-225,330,4149,4477
63,lak514d.map,330,374,89169,238,216,91,157,57630,154,339,175,34,84,123,207,3802,4149
64,lak514d.map,330,374,9329,24,20,305,353,31715,84,74,245,299,-60,54,114,245,272
65,lak514d.map,330,374,6722,17,9,312,364,95333,254,36,75,337,-237,27,264,4477,4715
66,lak514d.map,330,374,86803,232,338,97,35,95116,254,253,75,120,-22,-85,107,4149,3802
67,lak514d.map,330,374,69713,186,224,143,149,88428,236,209,93,164,-50,-15,65,816,959
68,lak514d.map,330,374,116628,311,59,18,314,76805,205,238,124,135,106,179,285,4715,3802
69,lak514d.map,330,374,105810,282,31,47,342,60239,161,348,168,25,121,317,438,4715,4149
70,lak514d.map,330,374,19393,51,54,278,319,26046,69,133,260,240,-18,79,97,913,850
71,lak514d.map,330,374,71107,190,326,139,47,32093,85,70,244,303,105,-256,361,4149,4477
72,lak514d.map,330,374,103152,275,71,54,302,103900,277,71,52,302,-2,0,2,3,3
73,lak514d.map,330,374,116305,310,8,19,365,29102,77,69,252,304,233,61,294,4715,4477
74,lak514d.map,330,374,83910,224,239,105,134,26103,69,76,260,297,155,-163,318,3802,4477
75,lak514d.map,330,374,29465,78,80,251,293,88302,236,335,93,38,-158,255,413,4477,4149
76,lak514d.map,330,374,105297,281,170,48,203,68823,184,366,145,7,97,196,293,987,4149
77,lak514d.map,330,374,113531,303,164,26,209,38935,104,334,225,39,199,170,369,987,3204
78,lak514d.map,330,374,78553,210,360,119,13,111427,297,24,32,349,-87,-336,423,4149,4715
79,lak514d.map,330,374,33932,90,101,239,272,115541,308,24,21,349,-218,-77,295,4477,4715
80,lak514d.map,330,374,33161,88,124,241,249,84251,225,272,104,101,-137,148,285,4477,3802
81,lak514d.map,330,374,96229,257,262,72,111,97223,259,16,70,357,-2,-246,248,3802,4715
82,lak514d.map,330,374,84546,226,351,103,22,60591,162,370,167,3,64,19,83,2359,2486
83,lak514d.map,330,374,65100,174,349,155,24,84573,226,324,103,49,-52,-25,77,700,820
84,lak514d.map,330,374,80065,214,344,115,29,110692,295,11,34,362,-81,-333,414,4149,4715
85,lak514d.map,330,374,79704,213,331,116,42,34922,93,233,236,140,120,-98,218,4149,3204
86,lak514d.map,330,374,43058,115,325,214,48,4469,11,18,318,355,104,-307,411,3204,4477
87,lak514d.map,330,374,102413,273,62,56,311,56519,151,328,178,45,122,266,388,4715,4149
88,lak514d.map,330,374,101301,270,52,59,321,38575,103,320,226,53,167,268,435,4715,3204
89,lak514d.map,330,374,107192,286,145,43,228,71460,191,347,138,26,95,202,297,987,4149
90,lak514d.map,330,374,40060,107,331,222,42,86071,230,322,99,51,-123,-9,132,3204,4149
91,lak514d.map,330,374,36345,97,306,232,67,76308,204,361,125,12,-107,55,162,3204,4149
92,lak514d.map,330,374,30234,80,59,249,314,100589,268,16,61,357,-188,-43,231,4477,4715
93,lak514d.map,330,374,106162,283,53,46,320,38204,102,317,227,56,181,264,445,4715,3204
94,lak514d.map,330,374,117412,313,23,16,350,59861,160,352,169,21,153,329,482,4715,4149
95,lak514d.map,330,374,116891,312,170,17,203,71094,190,339,139,34,122,169,291,987,4149
96,lak514d.map,330,374,64721,173,354,156,19,41246,110,267,219,106,63,-87,150,4149,3204
97,lak514d.map,330,374,32241,86,296,243,77,43437,116,320,213,53,-30,24,54,119,118
98,lak514d.map,330,374,38232,102,289,227,84,40125,107,266,222,107,-5,-23,28,29,29
99,lak514d.map,330,374,86817,232,324,97,49,23509,62,52,267,321,170,-272,442,4149,4477
0,lak515d.map,61,58,1139,19,20,41,37,1551,26,14,34,43,-7,-6,13,14,14
1,lak515d.map,61,58,2353,40,24,20,33,434,7,29,53,28,33,5,38,39,39
2,lak515d.map,61,58,1482,25,25,35,32,1819,31,36,29,21,-6,11,17,18,18
3,lak515d.map,61,58,2001,34,28,26,29,1756,30,41,30,16,4,13,17,18,18
4,lak515d.map,61,58,1313,22,20,38,37,2636,45,31,15,26,-23,11,34,35,35
5,lak515d.map,61,58,2597,44,12,16,45,1903,32,10,28,47,12,-2,14,15,15
6,lak515d.map,61,58,1107,19,52,41,5,2838,48,3,12,54,-29,-49,78,87,79
7,lak515d.map,61,58,648,11,47,49,10,2510,43,41,17,16,-32,-6,38,48,39
8,lak515d.map,61,58,2274,39,45,21,12,2562,44,47,16,10,-5,2,7,8,8
9,lak515d.map,61,58,2521,43,30,17,27,1293,22,40,38,17,21,10,31,32,32
10,lak515d.map,61,58,426,7,37,53,20,2709,46,16,14,41,-39,-21,60,61,61
11,lak515d.map,61,58,3124,53,7,7,50,2533,43,18,17,39,10,11,21,22,22
12,lak515d.map,61,58,1929,33,42,27,15,1116,19,43,41,14,14,1,15,16,16
13,lak515d.map,61,58,2240,38,21,22,36,1466,25,41,35,16,13,20,33,34,34
14,lak515d.map,61,58,939,16,46,44,11,1045,18,56,42,1,-2,10,12,13,13
15,lak515d.map,61,58,2283,39,36,21,21,2622,45,45,15,12,-6,9,15,16,16
16,lak515d.map,61,58,1931,33,40,27,17,1487,25,20,35,37,8,-20,28,29,29
17,lak515d.map,61,58,987,17,56,43,1,2775,47,8,13,49,-30,-48,78,87,79
18,lak515d.map,61,58,1291,22,42,38,15,773,13,38,47,19,9,-4,13,39,26
19,lak515d.map,61,58,1249,21,26,39,31,318,5,29,55,28,16,3,19,20,20
20,lak515d.map,61,58,1538,26,27,34,30,1845,31,10,29,47,-5,-17,22,23,23
21,lak515d.map,61,58,1068,18,33,42,24,2301,39,18,21,39,-21,-15,36,40,37
22,lak515d.map,61,58,2579,44,30,16,27,533,9,46,51,11,35,16,51,70,52
23,lak515d.map,61,58,3048,52,25,8,32,1294,22,39,38,18,30,14,44,45,45
24,lak515d.map,61,58,648,11,47,49,10,877,15,50,45,7,-4,3,7,8,8
25,lak515d.map,61,58,2099,36,46,24,11,1663,28,18,32,39,8,-28,36,37,37
26,lak515d.map,61,58,996,17,47,43,10,820,14,49,46,8,3,2,5,6,6
27,lak515d.map,61,58,1115,19,44,41,13,2132,36,13,24,44,-17,-31,48,49,49
28,lak515d.map,61,58,2273,39,46,21,11,950,16,35,44,22,23,-11,34,42,35
29,lak515d.map,61,58,3416,58,5,2,52,3068,52,5,8,52,6,0,6,7,7
30,lak515d.map,61,58,1942,33,29,27,28,319,5,28,55,29,28,-1,29,30,30
31,lak515d.map,61,58,1400,24,49,36,8,2577,44,32,16,25,-20,-17,37,38,38
32,lak515d.map,61,58,2520,43,31,17,26,2471,42,22,18,35,1,-9,10,11,11
33,lak515d.map,61,58,1137,19,22,41,35,1133,19,26,41,31,0,4,4,5,5
34,lak515d.map,61,58,2834,48,7,12,50,2594,44,15,16,42,4,8,12,13,13
35,lak515d.map,61,58,2693,46,32,14,25,2526,43,25,17,32,3,-7,10,11,11
36,lak515d.map,61,58,477,8,44,52,13,2991,51,24,9,33,-43,-20,63,65,109
37,lak515d.map,61,58,475,8,46,52,11,2663,45,4,15,53,-37,-42,79,89,128
38,lak515d.map,61,58,814,14,55,46,2,1950,33,21,27,36,-19,-34,53,54,113
39,lak515d.map,61,58,251,4,38,56,19,2780,47,3,13,54,-43,-35,78,87,93
40,lak515d.map,61,58,1550,26,15,34,42,2591,44,18,16,39,-18,3,21,22,22
41,lak515d.map,61,58,2445,42,48,18,9,1599,27,24,33,33,15,-24,39,40,40
42,lak515d.map,61,58,1864,32,49,28,8,1827,31,28,29,29,1,-21,22,23,23
43,lak515d.map,61,58,2353,40,24,20,33,2060,35,27,25,30,5,3,8,9,9
44,lak515d.map,61,58,324,5,23,55,34,1663,28,18,32,39,-23,-5,28,32,29
45,lak515d.map,61,58,2891,49,8,11,49,1931,33,40,27,17,16,32,48,49,49
46,lak515d.map,61,58,418,7,45,53,12,3011,51,4,9,53,-44,-41,85,94,86
47,lak515d.map,61,58,1069,18,32,42,25,1342,23,49,37,8,-5,17,22,23,23
48,lak515d.map,61,58,721,12,32,48,25,1987,34,42,26,15,-22,10,32,43,36
49,lak515d.map,61,58,2408,41,27,19,30,2651,45,16,15,41,-4,-11,15,16,16
50,lak515d.map,61,58,880,15,47,45,10,2125,36,20,24,37,-21,-27,48,49,84
51,lak515d.map,61,58,2370,40,7,20,50,2510,43,41,17,16,-3,34,37,38,38
52,lak515d.map,61,58,2130,36,15,24,42,1195,20,22,40,35,16,7,23,24,24
53,lak515d.map,61,58,3185,54,4,6,53,3231,55,16,5,41,-1,12,13,14,14
54,lak515d.map,61,58,717,12,36,48,21,1478,25,29,35,28,-13,-7,20,21,21
55,lak515d.map,61,58,2714,46,11,14,46,2647,45,20,15,37,1,9,10,11,11
56,lak515d.map,61,58,872,15,55,45,2,1355,23,36,37,21,-8,-19,27,28,32
57,lak515d.map,61,58,1649,28,32,32,25,788,13,23,47,34,15,-9,24,25,25
58,lak515d.map,61,58,2472,42,21,18,36,194,3,37,57,20,39,16,55,75,56
59,lak515d.map,61,58,2940,50,17,10,40,1877,32,36,28,21,18,19,37,38,38
60,lak515d.map,61,58,1531,26,34,34,23,1765,30,32,30,25,-4,-2,6,7,7
61,lak515d.map,61,58,1177,20,40,40,17,1470,25,37,35,20,-5,-3,8,9,9
62,lak515d.map,61,58,1184,20,33,40,24,2455,42,38,18,19,-22,5,27,44,28
63,lak515d.map,61,58,2586,44,23,16,34,1531,26,34,34,23,18,11,29,30,30
64,lak515d.map,61,58,1000,17,43,43,14,429,7,34,53,23,10,-9,19,24,54
65,lak515d.map,61,58,2013,34,16,26,41,2462,42,31,18,26,-8,15,23,24,24
66,lak515d.map,61,58,1412,24,37,36,20,1430,24,19,36,38,0,-18,18,19,19
67,lak515d.map,61,58,2947,50,10,10,47,2765,47,18,13,39,3,8,11,12,12
68,lak515d.map,61,58,2049,35,38,25,19,2003,34,26,26,31,1,-12,13,14,14
69,lak515d.map,61,58,1648,28,33,32,24,1436,24,13,36,44,4,-20,24,25,25
70,lak515d.map,61,58,1721,29,18,31,39,951,16,34,44,23,13,16,29,30,33
71,lak515d.map,61,58,1545,26,20,34,37,647,11,48,49,9,15,28,43,44,44
72,lak515d.map,61,58,2170,37,33,23,24,2244,38,17,22,40,-1,-16,17,18,18
73,lak515d.map,61,58,721,12,32,48,25,2471,42,22,18,35,-30,-10,40,41,41
74,lak515d.map,61,58,2656,45,11,15,46,1831,31,24,29,33,14,13,27,28,28
75,lak515d.map,61,58,2051,35,36,25,21,2236,38,25,22,32,-3,-11,14,15,15
76,lak515d.map,61,58,2248,38,13,22,44,1426,24,23,36,34,14,10,24,25,25
77,lak515d.map,61,58,2571,44,38,16,19,775,13,36,47,21,31,-2,33,34,54
78,lak515d.map,61,58,1227,21,48,39,9,846,14,23,46,34,7,-25,32,52,33
79,lak515d.map,61,58,3048,52,25,8,32,2940,50,17,10,40,2,-8,10,15,11
80,lak515d.map,61,58,2387,41,48,19,9,1995,34,34,26,23,7,-14,21,22,22
81,lak515d.map,61,58,3059,52,14,8,43,989,17,54,43,3,35,40,75,76,76
82,lak515d.map,61,58,1810,31,45,29,12,485,8,36,52,21,23,-9,32,46,33
83,lak515d.map,61,58,308,5,39,55,18,1316,22,17,38,40,-17,-22,39,45,48
84,lak515d.map,61,58,2401,41,34,19,23,1174,20,43,40,14,21,9,30,31,31
85,lak515d.map,61,58,1060,18,41,42,16,1166,20,51,40,6,-2,10,12,13,13
86,lak515d.map,61,58,1644,28,37,32,20,1726,29,13,31,44,-1,-24,25,26,26
87,lak515d.map,61,58,3169,54,20,6,37,766,13,45,47,12,41,25,66,67,67
88,lak515d.map,61,58,545,9,34,51,23,2395,41,40,19,17,-32,6,38,107,39
89,lak515d.map,61,58,1081,18,20,42,37,2604,44,5,16,52,-26,-15,41,50,42
90,lak515d.map,61,58,2632,45,35,15,22,1178,20,39,40,18,25,4,29,30,30
91,lak515d.map,61,58,364,6,41,54,16,1309,22,24,38,33,-16,-17,33,34,34
92,lak515d.map,61,58,2584,44,25,16,32,2941,50,16,10,41,-6,-9,15,16,16
93,lak515d.map,61,58,2531,43,20,17,37,2343,40,34,20,23,3,14,17,18,18
94,lak515d.map,61,58,2104,36,41,24,16,1991,34,38,26,19,2,-3,5,6,6
95,lak515d.map,61,58,1608,27,15,33,42,1233,21,42,39,15,6,27,33,36,34
96,lak515d.map,61,58,2605,44,4,16,53,1758,30,39,30,18,14,35,49,50,53
97,lak515d.map,61,58,2216,38,45,22,12,362,6,43,54,14,32,-2,34,35,35
98,lak515d.map,61,58,2132,36,13,24,44,717,12,36,48,21,24,23,47,48,48
99,lak515d.map,61,58,2194,37,9,23,48,1477,25,30,35,27,12,21,33,34,40
0,lak519d.map,143,166,1792,10,33,132,132,15687,94,82,48,83,-84,49,133,134,134
1,lak519d.map,143,166,17202,103,61,39,104,8678,52,119,90,46,51,58,109,154,110
2,lak519d.map,143,166,20045,120,40,22,125,12247,73,36,69,129,47,-4,51,133,63
3,lak519d.map,143,166,17306,104,123,38,42,15004,90,101,52,64,14,-22,36,103,490
4,lak519d.map,143,166,6434,38,39,104,126,19455,117,132,25,33,-79,93,172,7908,351
5,lak519d.map,143,166,16055,96,46,46,119,19391,116,30,26,135,-20,-16,36,37,52
6,lak519d.map,143,166,14558,87,49,55,116,8879,53,84,89,81,34,35,69,107,170
7,lak519d.map,143,166,19761,119,158,23,7,19221,115,34,27,131,4,-124,128,1363,3473
8,lak519d.map,143,166,23321,140,84,2,81,23315,140,90,2,75,0,6,6,7,7
9,lak519d.map,143,166,20881,125,34,17,131,5060,30,85,112,80,95,51,146,154,473
10,lak519d.map,143,166,17892,107,35,35,130,14598,87,9,55,156,20,-26,46,47,48
11,lak519d.map,143,166,19347,116,74,26,91,7606,45,29,97,136,71,-45,116,123,651
12,lak519d.map,143,166,10961,66,160,76,5,10069,60,56,82,109,6,-104,110,278,1365
13,lak519d.map,143,166,17068,102,29,40,136,13660,82,117,60,48,20,88,108,301,130
14,lak519d.map,143,166,9537,57,90,85,75,6090,36,51,106,114,21,-39,60,61,61
15,lak519d.map,143,166,17377,104,52,38,113,17219,103,44,39,121,1,-8,9,10,10
16,lak519d.map,143,166,9697,58,96,84,69,13734,82,43,60,122,-24,-53,77,78,78
17,lak519d.map,143,166,12515,75,100,67,65,18605,112,152,30,13,-37,52,89,189,96
18,lak519d.map,143,166,17369,104,60,38,105,16614,100,151,42,14,4,91,95,1809,909
19,lak519d.map,143,166,4619,27,28,115,137,8043,48,90,94,75,-21,62,83,84,351
20,lak519d.map,143,166,7596,45,39,97,126,18359,110,66,32,99,-65,27,92,201,93
21,lak519d.map,143,166,17368,104,61,38,104,10072,60,53,82,112,44,-8,52,53,53
22,lak519d.map,143,166,19955,120,130,22,35,9470,57,157,85,8,63,27,90,1817,2118
23,lak519d.map,143,166,1353,8,140,134,25,14118,85,157,57,8,-77,17,94,15356,80
24,lak519d.map,143,166,15920,95,15,47,150,8066,48,67,94,98,47,52,99,323,2533
25,lak519d.map,143,166,2685,16,136,126,29,3966,23,17,119,148,-7,-119,126,185,612
26,lak519d.map,143,166,11020,66,101,76,64,17191,103,72,39,93,-37,-29,66,83,67
27,lak519d.map,143,166,11762,70,23,72,142,12882,77,65,65,100,-7,42,49,150,118
28,lak519d.map,143,166,13881,83,62,59,103,16441,99,158,43,7,-16,96,112,911,803
29,lak519d.map,143,166,942,5,53,137,112,1599,9,60,133,105,-4,7,11,12,12
30,lak519d.map,143,166,13490,81,121,61,44,18180,109,79,33,86,-28,-42,70,71,71
31,lak519d.map,143,166,14810,89,129,53,36,13301,80,144,62,21,9,15,24,15356,80
32,lak519d.map,143,166,20208,121,43,21,122,18249,109,10,33,155,12,-33,45,46,46
33,lak519d.map,143,166,20715,124,34,18,131,22167,133,76,9,89,-9,42,51,123,52
34,lak519d.map,143,166,11685,70,100,72,65,13535,81,76,61,89,-11,-24,35,36,36
35,lak519d.map,143,166,6396,38,77,104,88,13663,82,114,60,51,-44,37,81,82,125
36,lak519d.map,143,166,6699,40,106,102,59,23470,141,101,1,64,-101,-5,106,4771,1464
37,lak519d.map,143,166,6933,41,38,101,127,14797,89,142,53,23,-48,104,152,509,171
38,lak519d.map,143,166,18011,108,82,34,83,3902,23,81,119,84,85,-1,86,87,87
39,lak519d.map,143,166,4427,26,54,116,111,13437,80,8,62,157,-54,-46,100,257,289
40,lak519d.map,143,166,16350,98,83,44,82,15671,94,98,48,67,4,15,19,20,20
41,lak519d.map,143,166,13672,82,105,60,60,15264,91,7,51,158,-9,-98,107,2096,732
42,lak519d.map,143,166,9949,59,10,83,155,1527,9,132,133,33,50,122,172,347,392
43,lak519d.map,143,166,14882,89,57,53,108,16622,100,143,42,22,-11,86,97,987,271
44,lak519d.map,143,166,3805,22,12,120,153,2375,14,114,128,51,8,102,110,111,111
45,lak519d.map,143,166,2216,13,107,129,58,20901,125,14,17,151,-112,-93,205,1736,377
46,lak519d.map,143,166,14593,87,14,55,151,11579,69,40,73,125,18,26,44,98,450
47,lak519d.map,143,166,23472,141,99,1,66,6363,38,110,104,55,103,11,114,1412,4670
48,lak519d.map,143,166,3520,21,131,121,34,16491,99,108,43,57,-78,-23,101,102,102
49,lak519d.map,143,166,22496,135,79,7,86,19406,116,15,26,150,19,-64,83,84,321
50,lak519d.map,143,166,20901,125,14,17,151,21023,126,58,16,107,-1,44,45,46,46
51,lak519d.map,143,166,3448,20,37,122,128,16134,97,133,45,32,-77,96,173,590,175
52,lak519d.map,143,166,3612,21,39,121,126,13549,81,62,61,103,-60,23,83,84,84
53,lak519d.map,143,166,12177,73,106,69,59,22199,133,44,9,121,-60,-62,122,123,145
54,lak519d.map,143,166,14809,89,130,53,35,938,5,57,137,108,84,-73,157,158,712
55,lak519d.map,143,166,3417,20,68,122,97,23158,139,81,3,84,-119,13,132,2354,688
56,lak519d.map,143,166,19368,116,53,26,112,14029,84,80,58,85,32,27,59,119,60
57,lak519d.map,143,166,16658,100,107,42,58,6686,40,119,102,46,60,12,72,73,73
58,lak519d.map,143,166,19603,118,150,24,15,20070,120,15,22,150,-2,-135,137,1148,3548
59,lak519d.map,143,166,1355,8,138,134,27,5182,31,129,111,36,-23,-9,32,41,33
60,lak519d.map,143,166,12292,74,157,68,8,18375,110,50,32,115,-36,-107,143,19,15356
61,lak519d.map,143,166,19724,118,29,24,136,16150,97,117,45,48,21,88,109,128,110
62,lak519d.map,143,166,1274,7,53,135,112,16282,98,151,44,14,-91,98,189,1180,195
63,lak519d.map,143,166,13014,78,99,64,66,9246,55,49,87,116,23,-50,73,121,74
64,lak519d.map,143,166,6056,36,85,106,80,17128,103,135,39,30,-67,50,117,436,212
65,lak519d.map,143,166,5533,33,110,109,55,8910,53,53,89,112,-20,-57,77,82,472
66,lak519d.map,143,166,3617,21,34,121,131,20380,122,37,20,128,-101,3,104,614,339
67,lak519d.map,143,166,10886,65,69,77,96,8687,52,110,90,55,13,41,54,59,55
68,lak519d.map,143,166,20334,122,83,20,82,12031,72,86,70,79,50,3,53,646,2189
69,lak519d.map,143,166,12835,77,112,65,53,15299,92,138,50,27,-15,26,41,86,43
70,lak519d.map,143,166,21868,131,43,11,122,16365,98,68,44,97,33,25,58,59,59
71,lak519d.map,143,166,2381,14,108,128,57,18102,109,157,33,8,-95,49,144,1478,3022
72,lak519d.map,143,166,6961,41,10,101,155,4569,27,78,115,87,14,68,82,310,83
73,lak519d.map,143,166,17880,107,47,35,118,6426,38,47,104,118,69,0,69,137,131
74,lak519d.map,143,166,22003,132,74,10,91,21443,129,136,13,29,3,62,65,576,223
75,lak519d.map,143,166,19985,120,100,22,65,19487,117,100,25,65,3,0,3,4,4
76,lak519d.map,143,166,18985,114,104,28,61,8002,48,131,94,34,66,27,93,1802,5583
77,lak519d.map,143,166,17498,105,97,37,68,10693,64,96,78,69,41,-1,42,43,43
78,lak519d.map,143,166,12840,77,107,65,58,19818,119,101,23,64,-42,-6,48,3666,1189
79,lak519d.map,143,166,8961,53,2,89,163,17773,107,154,35,11,-54,152,206,383,384
80,lak519d.map,143,166,2912,17,75,125,90,23319,140,86,2,79,-123,11,134,3140,1253
81,lak519d.map,143,166,21945,132,132,10,33,2386,14,103,128,62,118,-29,147,4417,5461
82,lak519d.map,143,166,2118,12,39,130,126,10255,61,36,81,129,-49,-3,52,53,53
83,lak519d.map,143,166,8324,50,141,92,24,9966,60,159,82,6,-10,18,28,29,29
84,lak519d.map,143,166,15009,90,96,52,69,5890,35,85,107,80,55,-11,66,67,67
85,lak519d.map,143,166,13163,79,116,63,49,17271,104,158,38,7,-25,42,67,166,82
86,lak519d.map,143,166,18648,112,109,30,56,6571,39,68,103,97,73,-41,114,453,3932
87,lak519d.map,143,166,7739,46,62,96,103,3615,21,36,121,129,25,-26,51,52,52
88,lak519d.map,143,166,10680,64,109,78,56,8980,54,149,88,16,10,40,50,242,66
89,lak519d.map,143,166,2973,17,14,125,151,5526,33,117,109,48,-16,103,119,120,120
90,lak519d.map,143,166,23136,139,103,3,62,21632,130,113,12,52,9,10,19,20,20
91,lak519d.map,143,166,5554,33,89,109,76,14885,89,54,53,111,-56,-35,91,323,92
92,lak519d.map,143,166,18131,109,128,33,37,20533,123,50,19,115,-14,-78,92,552,3515
93,lak519d.map,143,166,7241,43,62,99,103,11054,66,67,76,98,-23,5,28,29,29
94,lak519d.map,143,166,14298,86,143,56,22,6891,41,80,101,85,45,-63,108,127,471
95,lak519d.map,143,166,4780,28,33,114,132,18359,110,66,32,99,-82,33,115,257,197
96,lak519d.map,143,166,14178,85,97,57,68,15612,94,157,48,8,-9,60,69,123,89
97,lak519d.map,143,166,10384,62,73,80,92,15051,90,54,52,111,-28,-19,47,76,48
98,lak519d.map,143,166,18868,113,55,29,110,14596,87,11,55,154,26,-44,70,322,72
99,lak519d.map,143,166,22998,138,75,4,90,18614,112,143,30,22,26,68,94,1270,161
0,lak526d.map,72,49,1640,33,25,38,23,410,8,30,63,18,25,5,30,52,100
1,lak526d.map,72,49,1936,39,23,32,25,169,3,26,68,22,36,3,39,108,47
2,lak526d.map,72,49,3196,65,37,6,11,2677,54,17,17,31,11,-20,31,32,32
3,lak526d.map,72,49,2819,57,22,14,26,1891,38,19,33,29,19,-3,22,23,23
4,lak526d.map,72,49,2921,59,18,12,30,563,11,24,60,24,48,6,54,55,62
5,lak526d.map,72,49,856,17,25,54,23,3423,69,6,2,42,-52,-19,71,75,72
6,lak526d.map,72,49,2265,46,37,25,11,215,4,29,67,19,42,-8,50,279,401
7,lak526d.map,72,49,3354,68,26,3,22,611,12,25,59,23,56,-1,57,117,183
8,lak526d.map,72,49,2280,46,22,25,26,3147,64,37,7,11,-18,15,33,35,62
9,lak526d.map,72,49,2412,49,37,22,11,2967,60,21,11,27,-11,-16,27,28,36
10,lak526d.map,72,49,2613,53,32,18,16,903,18,27,53,21,35,-5,40,114,185
11,lak526d.map,72,49,2953,60,35,11,13,3377,68,3,3,45,-8,-32,40,104,215
12,lak526d.map,72,49,1889,38,21,33,27,708,14,26,57,22,24,5,29,30,32
13,lak526d.map,72,49,1493,30,25,41,23,654,13,31,58,17,17,6,23,32,73
14,lak526d.map,72,49,266,5,27,66,21,3346,68,34,3,14,-63,7,70,350,293
15,lak526d.map,72,49,1986,40,22,31,26,407,8,33,63,15,32,11,43,44,48
16,lak526d.map,72,49,1841,37,20,34,28,2618,53,27,18,21,-16,7,23,54,24
17,lak526d.map,72,49,2218,45,35,26,13,2628,53,17,18,31,-8,-18,26,28,62
18,lak526d.map,72,49,2411,49,38,22,10,1837,37,24,34,24,12,-14,26,144,160
19,lak526d.map,72,49,2974,60,14,11,34,3391,69,38,2,10,-9,24,33,34,66
20,lak526d.map,72,49,2354,48,46,23,2,1883,38,27,33,21,10,-19,29,237,181
21,lak526d.map,72,49,2563,52,33,19,15,3199,65,34,6,14,-13,1,14,22,17
22,lak526d.map,72,49,456,9,33,62,15,2950,60,38,11,10,-51,5,56,298,363
23,lak526d.map,72,49,3080,62,6,9,42,2332,47,19,24,29,15,13,28,29,29
24,lak526d.map,72,49,3113,63,22,8,26,3323,67,8,4,40,-4,-14,18,19,19
25,lak526d.map,72,49,3169,64,15,7,33,3331,67,0,4,48,-3,-15,18,19,19
26,lak526d.map,72,49,2353,48,47,23,1,2234,45,19,26,29,3,-28,31,154,96
27,lak526d.map,72,49,2802,57,39,14,9,2966,60,22,11,26,-3,-17,20,56,47
28,lak526d.map,72,49,3296,67,35,4,13,2085,42,21,29,27,25,-14,39,55,48
29,lak526d.map,72,49,3016,61,21,10,27,1591,32,25,39,23,29,4,33,34,34
30,lak526d.map,72,49,808,16,24,55,24,2922,59,17,12,31,-43,-7,50,54,51
31,lak526d.map,72,49,2619,53,26,18,22,1004,20,24,51,24,33,-2,35,44,113
32,lak526d.map,72,49,1051,21,26,50,22,2622,53,23,18,25,-32,-3,35,65,45
33,lak526d.map,72,49,507,10,31,61,17,2767,56,25,15,23,-46,-6,52,209,108
34,lak526d.map,72,49,2808,57,33,14,15,3341,68,39,3,9,-11,6,17,18,18
35,lak526d.map,72,49,2705,55,38,16,10,2620,53,25,18,23,2,-13,15,16,16
36,lak526d.map,72,49,3168,64,16,7,32,2752,56,40,15,8,8,24,32,110,89
37,lak526d.map,72,49,2867,58,23,13,25,1398,28,22,43,26,30,-1,31,32,51
38,lak526d.map,72,49,904,18,26,53,22,1787,36,25,35,23,-18,-1,19,27,29
39,lak526d.map,72,49,1933,39,26,32,22,3111,63,24,8,24,-24,-2,26,43,67
40,lak526d.map,72,49,2817,57,24,14,24,3074,62,12,9,36,-5,-12,17,18,18
41,lak526d.map,72,49,1200,24,24,47,24,2365,48,35,23,13,-24,11,35,257,127
42,lak526d.map,72,49,2725,55,18,16,30,3390,69,39,2,9,-14,21,35,36,36
43,lak526d.map,72,49,217,4,27,67,21,3125,63,10,8,38,-59,-17,76,86,77
44,lak526d.map,72,49,3341,68,39,3,9,1542,31,25,40,23,37,-14,51,320,127
45,lak526d.map,72,49,2476,50,22,21,26,3031,61,6,10,42,-11,-16,27,28,28
46,lak526d.map,72,49,1348,27,23,44,25,3341,68,39,3,9,-41,16,57,135,269
47,lak526d.map,72,49,1888,38,22,33,26,1491,30,27,41,21,8,5,13,14,14
48,lak526d.map,72,49,460,9,29,62,19,119,2,27,69,21,7,-2,9,10,10
49,lak526d.map,72,49,2915,59,24,12,24,2364,48,36,23,12,11,12,23,24,25
50,lak526d.map,72,49,2851,58,39,13,9,3166,64,18,7,30,-6,-21,27,88,116
51,lak526d.map,72,49,2218,45,35,26,13,2462,50,36,21,12,-5,1,6,7,7
52,lak526d.map,72,49,3424,69,5,2,43,905,18,25,53,23,51,20,71,72,75
53,lak526d.map,72,49,2265,46,37,25,11,2805,57,36,14,12,-11,-1,12,13,13
54,lak526d.map,72,49,1641,33,24,38,24,510,10,28,61,20,23,4,27,28,28
55,lak526d.map,72,49,560,11,27,60,21,703,14,31,57,17,-3,4,7,8,8
56,lak526d.map,72,49,510,10,28,61,20,3375,68,5,3,43,-58,-23,81,89,82
57,lak526d.map,72,49,3390,69,39,2,9,2263,46,39,25,9,23,0,23,24,24
58,lak526d.map,72,49,3177,64,7,7,41,3330,67,1,4,47,-3,-6,9,10,10
59,lak526d.map,72,49,2922,59,17,12,31,2974,60,14,11,34,-1,-3,4,5,5
60,lak526d.map,72,49,756,15,27,56,21,1791,36,21,35,27,-21,-6,27,29,28
61,lak526d.map,72,49,1837,37,24,34,24,1887,38,23,33,25,-1,-1,2,3,3
62,lak526d.map,72,49,2427,49,22,22,26,3278,66,4,5,44,-17,-18,35,36,36
63,lak526d.map,72,49,2757,56,35,15,13,854,17,27,54,21,39,-8,47,183,200
64,lak526d.map,72,49,1784,36,28,35,20,507,10,31,61,17,26,3,29,74,127
65,lak526d.map,72,49,2314,47,37,24,11,2478,50,20,21,28,-3,-17,20,55,59
66,lak526d.map,72,49,3326,67,5,4,43,1639,33,26,38,22,34,21,55,56,59
67,lak526d.map,72,49,2257,46,45,25,3,2410,49,39,22,9,-3,-6,9,10,10
68,lak526d.map,72,49,2208,45,45,26,3,361,7,30,64,18,38,-15,53,290,410
69,lak526d.map,72,49,3401,69,28,2,20,2332,47,19,24,29,22,-9,31,32,46
70,lak526d.map,72,49,2876,58,14,13,34,2804,57,37,14,11,1,23,24,67,42
71,lak526d.map,72,49,2257,46,45,25,3,3249,66,33,5,15,-20,-12,32,48,33
72,lak526d.map,72,49,2259,46,43,25,5,2263,46,39,25,9,0,-4,4,5,5
73,lak526d.map,72,49,3243,66,39,5,9,702,14,32,57,16,52,-7,59,395,265
74,lak526d.map,72,49,506,10,32,61,16,2973,60,15,11,33,-50,-17,67,75,68
75,lak526d.map,72,49,3121,63,14,8,34,2157,44,47,27,1,19,33,52,93,54
76,lak526d.map,72,49,1448,29,21,42,27,2558,52,38,19,10,-23,17,40,156,83
77,lak526d.map,72,49,3376,68,4,3,44,1396,28,24,43,24,40,20,60,61,64
78,lak526d.map,72,49,1200,24,24,47,24,1738,35,25,36,23,-11,1,12,14,13
79,lak526d.map,72,49,3074,62,12,9,36,3324,67,7,4,41,-5,-5,10,11,11
80,lak526d.map,72,49,1300,26,22,45,26,854,17,27,54,21,9,5,14,15,15
81,lak526d.map,72,49,1497,30,21,41,27,3257,66,25,5,23,-36,4,40,85,41
82,lak526d.map,72,49,2978,60,10,11,38,1495,30,23,41,25,30,13,43,44,47
83,lak526d.map,72,49,3002,61,35,10,13,462,9,27,62,21,52,-8,60,217,280
84,lak526d.map,72,49,363,7,28,64,20,1103,22,23,49,25,-15,-5,20,25,21
85,lak526d.map,72,49,1050,21,27,50,21,2775,56,17,15,31,-35,-10,45,49,46
86,lak526d.map,72,49,3298,67,33,4,15,2133,43,22,28,26,24,-11,35,38,73
87,lak526d.map,72,49,2305,47,46,24,2,3097,63,38,8,10,-16,-8,24,25,25
88,lak526d.map,72,49,2978,60,10,11,38,461,9,28,62,20,51,18,69,70,77
89,lak526d.map,72,49,1200,24,24,47,24,1446,29,23,42,25,-5,-1,6,7,7
90,lak526d.map,72,49,2755,56,37,15,11,3444,70,34,1,14,-14,-3,17,21,18
91,lak526d.map,72,49,1050,21,27,50,21,3126,63,9,8,39,-42,-18,60,64,61
92,lak526d.map,72,49,2720,55,23,16,25,3220,65,13,6,35,-10,-10,20,21,21
93,lak526d.map,72,49,456,9,33,62,15,2355,48,45,23,3,-39,12,51,407,307
94,lak526d.map,72,49,3064,62,22,9,26,3221,65,12,6,36,-3,-10,13,14,14
95,lak526d.map,72,49,1961,40,47,31,1,2035,41,22,30,26,-1,-25,26,164,219
96,lak526d.map,72,49,2757,56,35,15,13,1965,40,43,31,5,16,8,24,25,25
97,lak526d.map,72,49,1202,24,22,47,26,2870,58,20,13,28,-34,-2,36,37,37
98,lak526d.map,72,49,3296,67,35,4,13,1691,34,23,37,25,33,-12,45,144,90
99,lak526d.map,72,49,555,11,32,60,16,1933,39,26,32,22,-28,-6,34,108,80
0,lgt101d.map,22,39,50,1,27,20,11,154,3,1,18,37,-2,-26,28,29,61
1,lgt101d.map,22,39,758,19,21,2,17,87,2,29,19,9,17,8,25,127,135
2,lgt101d.map,22,39,536,13,9,8,29,446,11,21,10,17,2,12,14,20,15
3,lgt101d.map,22,39,228,5,5,16,33,134,3,21,18,17,2,16,18,19,19
4,lgt101d.map,22,39,356,9,33,12,5,607,15,16,6,22,-6,-17,23,24,37
5,lgt101d.map,22,39,722,18,18,3,20,277,7,34,14,4,11,16,27,28,30
6,lgt101d.map,22,39,147,3,8,18,30,221,5,12,16,26,-2,4,6,7,7
7,lgt101d.map,22,39,277,7,34,14,4,630,16,32,5,6,-9,-2,11,222,100
8,lgt101d.map,22,39,48,1,29,20,9,187,4,7,17,31,-3,-22,25,26,46
9,lgt101d.map,22,39,588,15,35,6,3,759,19,20,2,18,-4,-15,19,20,27
10,lgt101d.map,22,39,152,3,3,18,35,222,5,11,16,27,-2,8,10,11,11
11,lgt101d.map,22,39,704,18,36,3,2,153,3,2,18,36,15,-34,49,66,258
12,lgt101d.map,22,39,685,17,16,4,22,214,5,19,16,19,12,3,15,16,16
13,lgt101d.map,22,39,482,12,24,9,14,628,16,34,5,4,-4,10,14,155,85
14,lgt101d.map,22,39,721,18,19,3,19,338,8,12,13,26,10,-7,17,18,20
15,lgt101d.map,22,39,138,3,17,18,21,747,19,32,2,6,-16,15,31,139,55
16,lgt101d.map,22,39,91,2,25,19,13,179,4,15,17,23,-2,-10,12,13,16
17,lgt101d.map,22,39,537,13,8,8,30,684,17,17,4,21,-4,9,13,14,14
18,lgt101d.map,22,39,82,2,34,19,4,173,4,21,17,17,-2,-13,15,29,24
19,lgt101d.map,22,39,296,7,15,14,23,254,6,18,15,20,1,3,4,5,5
20,lgt101d.map,22,39,152,3,3,18,35,66,1,11,20,27,2,8,10,11,11
21,lgt101d.map,22,39,848,21,9,0,29,828,21,29,0,9,0,20,20,33,42
22,lgt101d.map,22,39,706,18,34,3,4,756,19,23,2,15,-1,-11,12,13,14
23,lgt101d.map,22,39,270,6,2,15,36,407,10,21,11,17,-4,19,23,66,32
24,lgt101d.map,22,39,393,10,35,11,3,118,3,37,18,1,7,2,9,10,10
25,lgt101d.map,22,39,104,2,12,19,26,438,11,29,10,9,-9,17,26,38,31
26,lgt101d.map,22,39,787,20,31,1,7,708,18,32,3,6,2,1,3,4,4
27,lgt101d.map,22,39,137,3,18,18,20,788,20,30,1,8,-17,12,29,148,72
28,lgt101d.map,22,39,797,20,21,1,17,494,12,12,9,26,8,-9,17,18,24
29,lgt101d.map,22,39,297,7,14,14,24,450,11,17,10,21,-4,3,7,9,8
30,lgt101d.map,22,39,186,4,8,17,30,726,18,14,3,24,-14,6,20,21,21
31,lgt101d.map,22,39,337,8,13,13,25,289,7,22,14,16,1,9,10,16,15
32,lgt101d.map,22,39,528,13,17,8,21,537,13,8,8,30,0,-9,9,10,10
33,lgt101d.map,22,39,336,8,14,13,24,227,5,6,16,32,3,-8,11,12,12
34,lgt101d.map,22,39,525,13,20,8,18,31,0,7,21,31,13,-13,26,28,46
35,lgt101d.map,22,39,296,7,15,14,23,318,8,32,13,6,-1,17,18,23,32
36,lgt101d.map,22,39,176,4,18,17,20,613,15,10,6,28,-11,-8,19,38,20
37,lgt101d.map,22,39,51,1,26,20,12,796,20,22,1,16,-19,-4,23,104,63
38,lgt101d.map,22,39,613,15,10,6,28,725,18,15,3,23,-3,5,8,9,13
39,lgt101d.map,22,39,440,11,27,10,11,236,6,36,15,2,5,9,14,15,31
40,lgt101d.map,22,39,289,7,22,14,16,750,19,29,2,9,-12,7,19,103,62
41,lgt101d.map,22,39,404,10,24,11,14,199,5,34,16,4,5,10,15,20,16
42,lgt101d.map,22,39,489,12,17,9,21,82,2,34,19,4,10,17,27,48,31
43,lgt101d.map,22,39,666,17,35,4,3,373,9,16,12,22,8,-19,27,45,92
44,lgt101d.map,22,39,324,8,26,13,12,766,19,13,2,25,-11,-13,24,28,38
45,lgt101d.map,22,39,264,6,8,15,30,257,6,15,15,23,0,7,7,8,8
46,lgt101d.map,22,39,570,14,14,7,24,647,16,15,5,23,-2,1,3,4,4
47,lgt101d.map,22,39,213,5,20,16,18,141,3,14,18,24,2,-6,8,9,9
48,lgt101d.map,22,39,570,14,14,7,24,652,16,10,5,28,-2,-4,6,10,10
49,lgt101d.map,22,39,789,20,29,1,9,159,4,35,17,3,16,6,22,114,186
50,lgt101d.map,22,39,218,5,15,16,23,290,7,21,14,17,-2,6,8,9,9
51,lgt101d.map,22,39,765,19,14,2,24,231,5,2,16,36,14,-12,26,27,27
52,lgt101d.map,22,39,413,10,15,11,23,405,10,23,11,15,0,8,8,17,18
53,lgt101d.map,22,39,394,10,34,11,4,302,7,9,14,29,3,-25,28,46,45
54,lgt101d.map,22,39,576,14,8,7,30,530,13,15,8,23,1,7,8,9,9
55,lgt101d.map,22,39,442,11,25,10,13,63,1,14,20,24,10,-11,21,29,24
56,lgt101d.map,22,39,490,12,16,9,22,51,1,26,20,12,11,10,21,24,22
57,lgt101d.map,22,39,56,1,21,20,17,225,5,8,16,30,-4,-13,17,18,36
58,lgt101d.map,22,39,160,4,34,17,4,289,7,22,14,16,-3,-12,15,16,26
59,lgt101d.map,22,39,722,18,18,3,20,302,7,9,14,29,11,-9,20,21,23
60,lgt101d.map,22,39,805,20,13,1,25,629,16,33,5,5,4,20,24,44,46
61,lgt101d.map,22,39,488,12,18,9,20,9,0,29,21,9,12,11,23,24,46
62,lgt101d.map,22,39,301,7,10,14,28,133,3,22,18,16,4,12,16,17,17
63,lgt101d.map,22,39,114,2,2,19,36,30,0,8,21,30,2,6,8,9,9
64,lgt101d.map,22,39,28,0,10,21,28,717,18,23,3,15,-18,13,31,86,32
65,lgt101d.map,22,39,352,9,37,12,1,566,14,18,7,20,-5,-19,24,25,34
66,lgt101d.map,22,39,56,1,21,20,17,628,16,34,5,4,-15,13,28,259,101
67,lgt101d.map,22,39,29,0,9,21,29,213,5,20,16,18,-5,11,16,17,18
68,lgt101d.map,22,39,314,8,36,13,2,764,19,15,2,23,-11,-21,32,34,42
69,lgt101d.map,22,39,80,2,36,19,2,458,11,9,10,29,-9,-27,36,118,116
70,lgt101d.map,22,39,30,0,8,21,30,831,21,26,0,12,-21,18,39,116,40
71,lgt101d.map,22,39,315,8,35,13,3,667,17,34,4,4,-9,-1,10,201,100
72,lgt101d.map,22,39,9,0,29,21,9,483,12,23,9,15,-12,-6,18,19,19
73,lgt101d.map,22,39,496,12,10,9,28,264,6,8,15,30,6,-2,8,33,40
74,lgt101d.map,22,39,845,21,12,0,26,413,10,15,11,23,11,3,14,15,19
75,lgt101d.map,22,39,498,12,8,9,30,845,21,12,0,26,-9,4,13,18,14
76,lgt101d.map,22,39,785,20,33,1,5,719,18,21,3,17,2,-12,14,18,15
77,lgt101d.map,22,39,197,5,36,16,2,63,1,14,20,24,4,-22,26,79,78
78,lgt101d.map,22,39,826,21,31,0,7,795,20,23,1,15,1,-8,9,10,10
79,lgt101d.map,22,39,667,17,34,4,4,12,0,26,21,12,17,-8,25,99,226
80,lgt101d.map,22,39,722,18,18,3,20,446,11,21,10,17,7,3,10,11,11
81,lgt101d.map,22,39,150,3,5,18,33,46,1,31,20,7,2,26,28,53,29
82,lgt101d.map,22,39,784,20,34,1,4,300,7,11,14,27,13,-23,36,49,53
83,lgt101d.map,22,39,668,17,33,4,5,334,8,16,13,22,9,-17,26,38,91
84,lgt101d.map,22,39,121,3,34,18,4,63,1,14,20,24,2,-20,22,56,50
85,lgt101d.map,22,39,432,11,35,10,3,67,1,10,20,28,10,-25,35,85,38
86,lgt101d.map,22,39,826,21,31,0,7,535,13,10,8,28,8,-21,29,33,38
87,lgt101d.map,22,39,435,11,32,10,6,247,6,25,15,13,5,-7,12,13,28
88,lgt101d.map,22,39,686,17,15,4,23,687,17,14,4,24,0,-1,1,2,2
89,lgt101d.map,22,39,145,3,10,18,28,747,19,32,2,6,-16,22,38,132,45
90,lgt101d.map,22,39,189,4,5,17,33,262,6,10,15,28,-2,5,7,8,8
91,lgt101d.map,22,39,28,0,10,21,28,197,5,36,16,2,-5,26,31,107,84
92,lgt101d.map,22,39,404,10,24,11,14,293,7,18,14,20,3,-6,9,20,12
93,lgt101d.map,22,39,704,18,36,3,2,70,1,7,20,31,17,-29,46,63,261
94,lgt101d.map,22,39,645,16,17,5,21,767,19,12,2,26,-3,-5,8,9,9
95,lgt101d.map,22,39,281,7,30,14,8,606,15,17,6,21,-8,-13,21,24,23
96,lgt101d.map,22,39,262,6,10,15,28,223,5,10,16,28,1,0,1,2,2
97,lgt101d.map,22,39,793,20,25,1,13,759,19,20,2,18,1,-5,6,7,7
98,lgt101d.map,22,39,136,3,19,18,19,706,18,34,3,4,-15,15,30,233,107
99,lgt101d.map,22,39,724,18,16,3,22,365,9,24,12,14,9,8,17,22,18
0,lgt300d.map,539,427,45200,105,61,433,365,87033,203,74,335,352,-98,13,111,112,112
1,lgt300d.map,539,427,3728,8,114,530,312,212260,497,385,41,41,-489,271,760,3559,27390
2,lgt300d.map,539,427,129178,302,202,236,224,55054,128,28,410,398,174,-174,348,668,797
3,lgt300d.map,539,427,219545,514,359,24,67,183623,430,413,108,13,84,54,138,150,1588
4,lgt300d.map,539,427,143563,336,335,202,91,178991,419,348,119,78,-83,13,96,164,97
5,lgt300d.map,539,427,4585,10,111,528,315,186238,436,360,102,66,-426,249,675,3384,23786
6,lgt300d.map,539,427,80641,188,61,350,365,150852,353,305,185,121,-165,244,409,9873,921
7,lgt300d.map,539,427,96890,226,38,312,388,98554,230,82,308,344,-4,44,48,49,49
8,lgt300d.map,539,427,166186,389,343,149,83,54606,127,49,411,377,262,-294,556,1196,1009
9,lgt300d.map,539,427,118208,276,70,262,356,152520,357,345,181,81,-81,275,356,725,5974
10,lgt300d.map,539,427,193996,454,288,84,138,76375,178,57,360,369,276,-231,507,3502,15915
11,lgt300d.map,539,427,16977,39,102,499,324,136001,318,211,220,215,-279,109,388,3006,9100
12,lgt300d.map,539,427,201152,471,391,67,35,94338,220,28,318,398,251,-363,614,1254,877
13,lgt300d.map,539,427,125771,294,193,244,233,112156,262,144,276,282,32,-49,81,98,90
14,lgt300d.map,539,427,118098,276,180,262,246,188795,442,365,96,61,-166,185,351,659,780
15,lgt300d.map,539,427,93018,217,67,321,359,173803,407,412,131,14,-190,345,535,798,1253
16,lgt300d.map,539,427,139738,327,317,211,109,192626,451,377,87,49,-124,60,184,312,185
17,lgt300d.map,539,427,113434,265,147,273,279,92196,215,35,323,391,50,-112,162,268,326
18,lgt300d.map,539,427,175105,410,391,128,35,185418,434,326,104,100,-24,-65,89,140,126
19,lgt300d.map,539,427,129185,302,195,236,231,3743,8,99,530,327,294,-96,390,8596,3084
20,lgt300d.map,539,427,183237,429,372,109,54,19558,45,83,493,343,384,-289,673,21173,2447
21,lgt300d.map,539,427,136728,320,338,218,88,15681,36,117,502,309,284,-221,505,13538,3228
22,lgt300d.map,539,427,133451,312,199,226,227,138475,324,299,214,127,-12,100,112,113,332
23,lgt300d.map,539,427,17406,40,100,498,326,183271,429,338,109,88,-389,238,627,4488,20519
24,lgt300d.map,539,427,100667,235,104,303,322,142325,333,292,205,134,-98,188,286,460,735
25,lgt300d.map,539,427,107548,251,55,287,371,179046,419,293,119,133,-168,238,406,11514,2721
26,lgt300d.map,539,427,96858,226,70,312,356,127490,298,182,240,244,-72,112,184,347,394
27,lgt300d.map,539,427,114721,268,141,270,285,11428,26,100,512,326,242,-41,283,6492,2951
28,lgt300d.map,539,427,197336,462,364,76,62,119045,278,87,260,339,184,-277,461,14540,945
29,lgt300d.map,539,427,110083,257,82,281,344,49492,115,39,423,387,142,-43,185,186,409
30,lgt300d.map,539,427,98161,229,48,309,378,131251,307,264,231,162,-78,216,294,468,740
31,lgt300d.map,539,427,79370,185,51,353,375,101062,236,136,302,290,-51,85,136,2702,267
32,lgt300d.map,539,427,188337,441,396,97,30,166635,390,321,148,105,51,-75,126,137,127
33,lgt300d.map,539,427,133776,313,301,225,125,82754,193,83,345,343,120,-218,338,6365,534
34,lgt300d.map,539,427,182872,428,310,110,116,15286,35,85,503,341,393,-225,618,16172,16262
35,lgt300d.map,539,427,77682,181,31,357,395,179013,419,326,119,100,-238,295,533,1332,1252
36,lgt300d.map,539,427,196057,459,362,79,64,195237,457,328,81,98,2,-34,36,37,37
37,lgt300d.map,539,427,135505,317,280,221,146,106652,249,97,289,329,68,-183,251,651,296
38,lgt300d.map,539,427,115648,270,68,268,358,194752,456,386,82,40,-186,318,504,605,939
39,lgt300d.map,539,427,144826,339,353,199,73,63579,148,43,390,383,191,-310,501,1141,807
40,lgt300d.map,539,427,187161,438,291,100,135,131250,307,265,231,161,131,-26,157,2508,2947
41,lgt300d.map,539,427,145259,340,347,198,79,183636,430,400,108,26,-90,53,143,180,189
42,lgt300d.map,539,427,132497,310,299,228,127,140975,330,361,208,65,-20,62,82,83,92
43,lgt300d.map,539,427,61026,142,34,396,392,102803,240,103,298,323,-98,69,167,358,170
44,lgt300d.map,539,427,94360,220,6,318,420,171747,402,333,136,93,-182,327,509,1477,1083
45,lgt300d.map,539,427,193456,453,401,85,25,62746,146,22,392,404,307,-379,686,1444,1081
46,lgt300d.map,539,427,92601,216,57,322,369,137653,322,267,216,159,-106,210,316,490,768
47,lgt300d.map,539,427,38792,90,64,448,362,104918,245,123,293,303,-155,59,214,497,219
48,lgt300d.map,539,427,101499,237,126,301,300,31519,73,78,465,348,164,-48,212,3227,2911
49,lgt300d.map,539,427,157659,369,330,169,96,64847,151,56,387,370,218,-274,492,1221,13684
50,lgt300d.map,539,427,141840,332,350,206,76,128333,300,193,238,233,32,-157,189,489,198
51,lgt300d.map,539,427,12272,28,110,510,316,188757,442,403,96,23,-414,293,707,3522,25740
52,lgt300d.map,539,427,188442,441,291,97,135,156387,366,321,172,105,75,30,105,1690,150
53,lgt300d.map,539,427,133764,313,313,225,113,85333,199,66,339,360,114,-247,361,917,537
54,lgt300d.map,539,427,130010,304,224,234,202,182828,428,354,110,72,-124,130,254,476,331
55,lgt300d.map,539,427,21243,49,106,489,320,85772,200,54,338,372,-151,-52,203,447,3019
56,lgt300d.map,539,427,83618,195,73,343,353,114382,267,53,271,373,-72,-20,92,93,93
57,lgt300d.map,539,427,125778,294,186,244,240,132146,309,223,229,203,-15,37,52,55,53
58,lgt300d.map,539,427,99017,231,46,307,380,110035,257,130,281,296,-26,84,110,111,174
59,lgt300d.map,539,427,185856,435,315,103,111,184906,433,411,105,15,2,96,98,119,99
60,lgt300d.map,539,427,175201,410,295,128,131,205438,481,375,57,51,-71,80,151,152,158
61,lgt300d.map,539,427,173464,406,324,132,102,146953,344,361,194,65,62,37,99,106,139
62,lgt300d.map,539,427,196061,459,358,79,68,195662,458,330,80,96,1,-28,29,30,30
63,lgt300d.map,539,427,177259,415,372,123,54,176444,413,333,125,93,2,-39,41,110,123
64,lgt300d.map,539,427,93910,219,29,319,397,119479,279,80,259,346,-60,51,111,228,112
65,lgt300d.map,539,427,140969,330,367,208,59,55908,130,28,408,398,200,-339,539,1211,992
66,lgt300d.map,539,427,87490,204,44,334,382,161882,379,377,159,49,-175,333,508,738,1146
67,lgt300d.map,539,427,113059,264,95,274,331,25967,60,79,478,347,204,-16,220,3574,859
68,lgt300d.map,539,427,116449,272,121,266,305,201197,471,346,67,80,-199,225,424,451,853
69,lgt300d.map,539,427,121579,284,115,254,311,177339,415,292,123,134,-131,177,308,7816,7966
70,lgt300d.map,539,427,15267,35,104,503,322,97716,228,66,310,360,-193,-38,231,1395,2347
71,lgt300d.map,539,427,132162,309,207,229,219,110898,259,121,279,305,50,-86,136,190,144
72,lgt300d.map,539,427,58876,137,49,401,377,183735,430,301,108,125,-293,252,545,17053,3163
73,lgt300d.map,539,427,125336,293,201,245,225,87942,205,19,333,407,88,-182,270,492,441
74,lgt300d.map,539,427,100328,234,16,304,410,182379,427,376,111,50,-193,360,553,805,1161
75,lgt300d.map,539,427,104936,245,105,293,321,135548,317,237,221,189,-72,132,204,310,428
76,lgt300d.map,539,427,19538,45,103,493,323,112614,263,113,275,313,-218,10,228,2329,5582
77,lgt300d.map,539,427,120683,282,157,256,269,59701,139,78,399,348,143,-79,222,4196,578
78,lgt300d.map,539,427,61016,142,44,396,382,172188,403,319,135,107,-261,275,536,14350,1680
79,lgt300d.map,539,427,183680,430,356,108,70,153846,360,300,178,126,70,-56,126,743,229
80,lgt300d.map,539,427,191842,449,307,89,119,73834,172,36,366,390,277,-271,548,3521,15571
81,lgt300d.map,539,427,58002,135,69,403,357,190062,445,379,93,47,-310,310,620,1249,1260
82,lgt300d.map,539,427,4595,10,101,528,325,120310,281,103,257,323,-271,2,273,2799,5489
83,lgt300d.map,539,427,101914,238,138,300,288,128733,301,220,237,206,-63,82,145,359,2795
84,lgt300d.map,539,427,137553,322,367,216,59,132052,309,317,229,109,13,-50,63,80,64
85,lgt300d.map,539,427,104168,243,19,295,407,111783,261,90,277,336,-18,71,89,90,174
86,lgt300d.map,539,427,219970,515,361,23,65,37079,86,69,452,357,429,-292,721,17847,3429
87,lgt300d.map,539,427,91329,213,48,325,378,191806,449,343,89,83,-236,295,531,1013,1165
88,lgt300d.map,539,427,119402,279,157,259,269,15277,35,94,503,332,244,-63,307,7047,2896
89,lgt300d.map,539,427,113896,266,112,272,314,58849,137,76,401,350,129,-36,165,2246,392
90,lgt300d.map,539,427,116397,272,173,266,253,185382,434,362,104,64,-162,189,351,363,780
91,lgt300d.map,539,427,100322,234,22,304,404,192189,450,387,88,39,-216,365,581,844,1189
92,lgt300d.map,539,427,156792,367,343,171,83,89213,208,29,330,397,159,-314,473,1111,648
93,lgt300d.map,539,427,124084,290,172,248,254,121511,284,183,254,243,6,11,17,18,18
94,lgt300d.map,539,427,144448,338,304,200,122,116931,273,66,265,360,65,-238,303,596,315
95,lgt300d.map,539,427,118151,276,127,262,299,95567,223,80,315,346,53,-47,100,147,101
96,lgt300d.map,539,427,67450,157,15,381,411,202485,474,339,64,87,-317,324,641,847,1456
97,lgt300d.map,539,427,124064,290,192,248,234,8020,18,92,520,334,272,-100,372,8039,3066
98,lgt300d.map,539,427,154273,361,300,177,126,160186,375,365,163,61,-14,65,79,184,1033
99,lgt300d.map,539,427,57136,133,81,405,345,190476,446,392,92,34,-313,311,624,1115,19804
0,lgt600d.map,275,273,70241,257,192,17,80,43636,159,43,115,229,98,-149,247,371,305
1,lgt600d.map,275,273,47697,174,77,100,195,44172,161,53,113,219,13,-24,37,38,38
2,lgt600d.map,275,273,45450,166,140,108,132,54967,201,178,73,94,-35,38,73,84,83
3,lgt600d.map,275,273,46099,168,37,106,235,47613,174,161,100,111,-6,124,130,414,1591
4,lgt600d.map,275,273,28320,103,71,171,201,62937,230,125,44,147,-127,54,181,557,182
5,lgt600d.map,275,273,42481,155,106,119,166,30267,110,35,164,237,45,-71,116,117,117
6,lgt600d.map,275,273,45441,166,149,108,123,56726,207,57,67,215,-41,-92,133,2868,1431
7,lgt600d.map,275,273,53609,196,171,78,101,57811,211,64,63,208,-15,-107,122,185,536
8,lgt600d.map,275,273,18232,66,58,208,214,44410,162,88,112,184,-96,30,126,127,127
9,lgt600d.map,275,273,45728,167,135,107,137,26953,98,73,176,199,69,-62,131,132,132
10,lgt600d.map,275,273,37106,135,21,139,251,25371,92,17,182,255,43,-4,47,48,48
11,lgt600d.map,275,273,33249,121,56,153,216,23183,84,21,190,251,37,-35,72,900,78
12,lgt600d.map,275,273,32745,119,14,155,258,27559,100,13,174,259,19,-1,20,21,21
13,lgt600d.map,275,273,47704,174,70,100,202,40621,148,55,126,217,26,-15,41,42,42
14,lgt600d.map,275,273,23472,85,5,189,267,24776,90,66,184,206,-5,61,66,1196,1956
15,lgt600d.map,275,273,45224,165,93,109,179,32141,117,72,157,200,48,-21,69,70,70
16,lgt600d.map,275,273,45208,165,109,109,163,61288,224,136,50,136,-59,27,86,328,87
17,lgt600d.map,275,273,61237,224,187,50,85,60191,220,141,54,131,4,-46,50,51,51
18,lgt600d.map,275,273,56186,205,51,69,221,63431,232,177,42,95,-27,126,153,154,368
19,lgt600d.map,275,273,5995,21,10,253,262,34861,127,82,147,190,-106,72,178,326,4047
20,lgt600d.map,275,273,51762,189,107,85,165,36822,134,32,140,240,55,-75,130,464,131
21,lgt600d.map,275,273,1625,5,12,269,260,61025,223,126,51,146,-218,114,332,1087,12075
22,lgt600d.map,275,273,39517,144,67,130,205,36493,133,88,141,184,11,21,32,33,35
23,lgt600d.map,275,273,37648,137,25,137,247,41963,153,78,121,194,-16,53,69,334,1331
24,lgt600d.map,275,273,37925,138,21,136,251,56606,207,177,67,95,-69,156,225,239,2558
25,lgt600d.map,275,273,37907,138,39,136,233,55563,203,128,71,144,-65,89,154,594,344
26,lgt600d.map,275,273,58634,214,60,60,212,15003,54,11,220,261,160,-49,209,665,1047
27,lgt600d.map,275,273,32944,120,88,154,184,47145,172,83,102,189,-52,-5,57,58,58
28,lgt600d.map,275,273,58288,213,133,61,139,62948,230,114,44,158,-17,-19,36,37,37
29,lgt600d.map,275,273,53946,197,107,77,165,30220,110,82,164,190,87,-25,112,113,113
30,lgt600d.map,275,273,62626,229,163,45,109,54822,200,50,74,222,29,-113,142,436,143
31,lgt600d.map,275,273,24257,88,39,186,233,60494,221,111,53,161,-133,72,205,5746,206
32,lgt600d.map,275,273,48448,177,145,97,127,33773,123,78,151,194,54,-67,121,129,122
33,lgt600d.map,275,273,57513,210,89,64,183,58740,215,227,59,45,-5,138,143,921,229
34,lgt600d.map,275,273,36225,132,83,142,189,37897,138,49,136,223,-6,-34,40,290,165
35,lgt600d.map,275,273,18240,66,50,208,222,16590,60,62,214,210,6,12,18,19,19
36,lgt600d.map,275,273,37876,138,70,136,202,19924,72,4,202,268,66,-66,132,1651,150
37,lgt600d.map,275,273,47738,174,36,100,236,50860,186,190,88,82,-12,154,166,5781,3740
38,lgt600d.map,275,273,57353,210,249,64,23,32397,118,89,156,183,92,-160,252,863,6045
39,lgt600d.map,275,273,60483,221,122,53,150,3540,12,8,262,264,209,-114,323,2566,841
40,lgt600d.map,275,273,55898,204,66,70,206,31646,115,21,159,251,89,-45,134,135,1245
41,lgt600d.map,275,273,8184,29,5,245,267,35707,130,55,144,217,-101,50,151,241,1231
42,lgt600d.map,275,273,59914,219,145,55,127,15263,55,24,219,248,164,-121,285,10450,1298
43,lgt600d.map,275,273,32146,117,67,157,205,30798,112,50,162,222,5,-17,22,23,23
44,lgt600d.map,275,273,45502,166,88,108,184,29710,108,46,166,226,58,-42,100,101,101
45,lgt600d.map,275,273,24013,87,10,187,262,49382,180,30,94,242,-93,20,113,188,114
46,lgt600d.map,275,273,17734,64,10,210,262,39439,144,145,130,127,-80,135,215,3623,2302
47,lgt600d.map,275,273,71330,261,195,13,77,30845,112,3,162,269,149,-192,341,691,511
48,lgt600d.map,275,273,9821,35,6,239,266,59038,216,202,58,70,-181,196,377,456,2816
49,lgt600d.map,275,273,49100,179,39,95,233,37574,137,99,137,173,42,60,102,183,146
50,lgt600d.map,275,273,57348,210,254,64,18,25861,94,73,180,199,116,-181,297,969,7438
51,lgt600d.map,275,273,58224,213,197,61,75,56080,205,157,69,115,8,-40,48,49,51
52,lgt600d.map,275,273,37564,137,109,137,163,48438,177,155,97,117,-40,46,86,87,112
53,lgt600d.map,275,273,26458,96,22,178,250,25639,93,22,181,250,3,0,3,4,4
54,lgt600d.map,275,273,28925,105,12,169,260,47695,174,79,100,193,-69,67,136,137,657
55,lgt600d.map,275,273,47901,175,146,99,126,41973,153,68,121,204,22,-78,100,101,101
56,lgt600d.map,275,273,32163,117,50,157,222,59077,216,163,58,109,-99,113,212,2097,277
57,lgt600d.map,275,273,53624,196,156,78,116,48831,178,35,96,237,18,-121,139,2417,2082
58,lgt600d.map,275,273,51976,190,166,84,106,45293,165,24,109,248,25,-142,167,1750,1023
59,lgt600d.map,275,273,56424,206,86,68,186,805,2,13,272,259,204,-73,277,4641,3088
60,lgt600d.map,275,273,53138,194,96,80,176,53621,196,159,78,113,-2,63,65,1497,841
61,lgt600d.map,275,273,67512,247,191,27,81,45755,167,108,107,164,80,-83,163,287,174
62,lgt600d.map,275,273,59044,216,196,58,76,64030,234,124,40,148,-18,-72,90,91,91
63,lgt600d.map,275,273,60416,221,189,53,83,53900,197,153,77,119,24,-36,60,76,61
64,lgt600d.map,275,273,46108,168,28,106,244,40317,147,86,127,186,21,58,79,166,105
65,lgt600d.map,275,273,43892,160,60,114,212,32460,118,26,156,246,42,-34,76,77,155
66,lgt600d.map,275,273,800,2,18,272,254,30495,111,80,163,192,-109,62,171,1784,3951
67,lgt600d.map,275,273,8456,30,6,244,266,43377,158,29,116,243,-128,23,151,286,152
68,lgt600d.map,275,273,46803,171,152,103,120,38958,142,80,132,192,29,-72,101,127,102
69,lgt600d.map,275,273,54966,201,179,73,93,38966,142,72,132,200,59,-107,166,204,187
70,lgt600d.map,275,273,50118,183,113,91,159,60383,221,222,53,50,-38,109,147,181,1150
71,lgt600d.map,275,273,47633,174,141,100,131,19597,71,58,203,214,103,-83,186,188,187
72,lgt600d.map,275,273,56882,208,174,66,98,17692,64,52,210,220,144,-122,266,292,285
73,lgt600d.map,275,273,26154,95,53,179,219,45749,167,114,107,158,-72,61,133,134,160
74,lgt600d.map,275,273,33213,121,92,153,180,37598,137,75,137,197,-16,-17,33,34,34
75,lgt600d.map,275,273,50994,186,56,88,216,40286,147,117,127,155,39,61,100,481,3753
76,lgt600d.map,275,273,59331,217,182,57,90,53869,197,184,77,88,20,2,22,23,23
77,lgt600d.map,275,273,20426,74,48,200,224,50957,186,93,88,179,-112,45,157,158,158
78,lgt600d.map,275,273,35394,129,95,145,177,26715,97,38,177,234,32,-57,89,105,90
79,lgt600d.map,275,273,60641,222,237,52,35,45261,165,56,109,216,57,-181,238,609,257
80,lgt600d.map,275,273,50353,184,151,90,121,57354,210,248,64,24,-26,97,123,1346,695
81,lgt600d.map,275,273,803,2,15,272,257,71331,261,194,13,78,-259,179,438,927,16664
82,lgt600d.map,275,273,58771,215,196,59,76,46604,170,78,104,194,45,-118,163,335,174
83,lgt600d.map,275,273,61048,223,103,51,169,52372,191,43,83,229,32,-60,92,93,93
84,lgt600d.map,275,273,44163,161,62,113,210,27782,101,63,173,209,60,1,61,281,359
85,lgt600d.map,275,273,34600,126,70,148,202,23412,85,65,189,207,41,-5,46,47,56
86,lgt600d.map,275,273,60504,221,101,53,171,36477,133,104,141,168,88,3,91,547,2047
87,lgt600d.map,275,273,54234,198,92,76,180,59086,216,154,58,118,-18,62,80,113,105
88,lgt600d.map,275,273,36526,133,55,141,217,57622,211,253,63,19,-78,198,276,7338,8408
89,lgt600d.map,275,273,32145,117,68,157,204,58287,213,134,61,138,-96,66,162,803,163
90,lgt600d.map,275,273,28593,104,71,170,201,44885,164,159,110,113,-60,88,148,149,174
91,lgt600d.map,275,273,61739,226,231,48,41,43622,159,57,115,215,67,-174,241,552,264
92,lgt600d.map,275,273,42506,155,81,119,191,35467,129,22,145,250,26,-59,85,1747,426
93,lgt600d.map,275,273,29971,109,58,165,214,45820,167,43,107,229,-58,-15,73,74,74
94,lgt600d.map,275,273,37577,137,96,137,176,39247,143,64,131,208,-6,-32,38,39,39
95,lgt600d.map,275,273,47358,173,143,101,129,29431,107,52,167,220,66,-91,157,161,158
96,lgt600d.map,275,273,44200,161,25,113,247,25331,92,57,182,215,69,32,101,257,896
97,lgt600d.map,275,273,3818,13,3,261,269,47461,173,40,101,232,-160,37,197,794,198
98,lgt600d.map,275,273,31092,113,29,161,243,73511,269,198,5,74,-156,169,325,575,474
99,lgt600d.map,275,273,51547,188,49,86,223,4364,15,3,259,269,173,-46,219,675,670
0,lgt601d.map,256,256,44104,172,183,83,72,21103,82,144,173,111,90,-39,129,130,130
1,lgt601d.map,256,256,37576,146,55,109,200,51772,202,195,53,60,-56,140,196,237,1074
2,lgt601d.map,256,256,54929,214,110,41,145,23957,93,106,162,149,121,-4,125,698,1181
3,lgt601d.map,256,256,36230,141,121,114,134,23935,93,128,162,127,48,7,55,56,56
4,lgt601d.map,256,256,39480,154,199,101,56,2288,8,15,247,240,146,-184,330,409,395
5,lgt601d.map,256,256,44330,173,213,82,42,21918,85,97,170,158,88,-116,204,506,14577
6,lgt601d.map,256,256,55240,215,55,40,200,56108,219,211,36,44,-4,156,160,2831,2565
7,lgt601d.map,256,256,29084,113,99,142,156,23967,93,96,162,159,20,-3,23,24,24
8,lgt601d.map,256,256,26981,105,154,150,101,45119,176,192,79,63,-71,38,109,177,110
9,lgt601d.map,256,256,43864,171,167,84,88,36733,143,130,112,125,28,-37,65,73,66
10,lgt601d.map,256,256,16277,63,106,192,149,48719,190,176,65,79,-127,70,197,204,198
11,lgt601d.map,256,256,16538,64,101,191,154,21895,85,120,170,135,-21,19,40,41,41
12,lgt601d.map,256,256,52009,203,214,52,41,22455,87,72,168,183,116,-142,258,314,667
13,lgt601d.map,256,256,49850,194,69,61,186,18292,71,139,184,116,123,70,193,261,3191
14,lgt601d.map,256,256,25739,100,116,155,139,47719,186,152,69,103,-86,36,122,323,123
15,lgt601d.map,256,256,24770,96,61,159,194,19818,77,149,178,106,19,88,107,108,108
16,lgt601d.map,256,256,42008,164,231,91,24,28327,110,88,145,167,54,-143,197,198,198
17,lgt601d.map,256,256,3026,11,45,244,210,60966,238,217,17,38,-227,172,399,914,533
18,lgt601d.map,256,256,57672,225,183,30,72,23701,92,106,163,149,133,-77,210,302,9156
19,lgt601d.map,256,256,31124,121,107,134,148,60756,237,171,18,84,-116,64,180,5247,253
20,lgt601d.map,256,256,42442,165,53,90,202,36431,142,176,113,79,23,123,146,796,147
21,lgt601d.map,256,256,31084,121,147,134,108,61260,239,179,16,76,-118,32,150,4673,951
22,lgt601d.map,256,256,52921,206,70,49,185,58131,227,236,28,19,-21,166,187,2759,3012
23,lgt601d.map,256,256,19635,76,76,179,179,41860,163,123,92,132,-87,47,134,135,135
24,lgt601d.map,256,256,29825,116,126,139,129,46779,182,68,73,187,-66,-58,124,1322,163
25,lgt601d.map,256,256,54818,214,221,41,34,33950,132,97,123,158,82,-124,206,1221,687
26,lgt601d.map,256,256,40520,158,183,97,72,21937,85,78,170,177,73,-105,178,179,179
27,lgt601d.map,256,256,61552,240,143,15,112,34949,136,122,119,133,104,-21,125,349,2034
28,lgt601d.map,256,256,32340,126,171,129,84,40270,157,177,98,78,-31,6,37,38,38
29,lgt601d.map,256,256,21355,83,148,172,107,59694,233,209,22,46,-150,61,211,521,267
30,lgt601d.map,256,256,28042,109,117,146,138,31878,124,121,131,134,-15,4,19,20,20
31,lgt601d.map,256,256,38064,148,79,107,176,16258,63,125,192,130,85,46,131,304,4623
32,lgt601d.map,256,256,22729,88,54,167,201,21369,83,134,172,121,5,80,85,86,87
33,lgt601d.map,256,256,39763,155,172,100,83,52068,203,155,52,100,-48,-17,65,66,66
34,lgt601d.map,256,256,53114,207,133,48,122,20380,79,99,176,156,128,-34,162,163,163
35,lgt601d.map,256,256,48049,187,78,68,177,38239,149,160,106,95,38,82,120,144,697
36,lgt601d.map,256,256,61537,240,158,15,97,3578,13,5,242,250,227,-153,380,487,5894
37,lgt601d.map,256,256,49112,191,39,64,216,5843,22,44,233,211,169,5,174,2079,3435
38,lgt601d.map,256,256,48993,191,158,64,97,25222,98,121,157,134,93,-37,130,131,531
39,lgt601d.map,256,256,37168,145,207,110,48,62516,244,203,11,52,-99,-4,103,352,501
40,lgt601d.map,256,256,40112,156,79,99,176,33857,132,190,123,65,24,111,135,954,147
41,lgt601d.map,256,256,21392,83,111,172,144,17037,66,114,189,141,17,3,20,21,21
42,lgt601d.map,256,256,16801,65,94,190,161,32084,125,171,130,84,-60,77,137,142,138
43,lgt601d.map,256,256,27299,106,92,149,163,57414,224,185,31,70,-118,93,211,8200,290
44,lgt601d.map,256,256,47500,185,115,70,140,60718,237,209,18,46,-52,94,146,698,2638
45,lgt601d.map,256,256,16785,65,110,190,145,32891,128,132,127,123,-63,22,85,86,86
46,lgt601d.map,256,256,19400,75,55,180,200,15249,59,110,196,145,16,55,71,72,72
47,lgt601d.map,256,256,1513,5,22,250,233,63620,248,123,7,132,-243,101,344,1171,409
48,lgt601d.map,256,256,15034,58,69,197,186,22124,86,147,169,108,-28,78,106,107,120
49,lgt601d.map,256,256,15048,58,55,197,200,31928,124,71,131,184,-66,16,82,83,83
50,lgt601d.map,256,256,60976,238,207,17,48,43337,169,182,86,73,69,-25,94,100,157
51,lgt601d.map,256,256,43865,171,166,84,89,47202,184,157,71,98,-13,-9,22,23,23
52,lgt601d.map,256,256,57788,225,67,30,188,32399,126,112,129,143,99,45,144,2130,1083
53,lgt601d.map,256,256,28000,109,159,146,96,55824,218,239,37,16,-109,80,189,1167,255
54,lgt601d.map,256,256,42825,167,182,88,73,61799,241,152,14,103,-74,-30,104,2177,764
55,lgt601d.map,256,256,35738,139,101,116,154,38236,149,163,106,92,-10,62,72,75,292
56,lgt601d.map,256,256,54170,211,101,44,154,45679,178,144,77,111,33,43,76,2051,1460
57,lgt601d.map,256,256,37964,148,179,107,76,55957,218,106,37,149,-70,-73,143,622,197
58,lgt601d.map,256,256,28784,112,143,143,112,30604,119,115,136,140,-7,-28,35,36,36
59,lgt601d.map,256,256,35403,138,180,117,75,39950,156,241,99,14,-18,61,79,80,80
60,lgt601d.map,256,256,32836,128,187,127,68,40342,157,105,98,150,-29,-82,111,152,945
61,lgt601d.map,256,256,48960,191,191,64,64,53394,208,109,47,146,-17,-82,99,4730,2496
62,lgt601d.map,256,256,35952,140,143,115,112,25031,97,56,158,199,43,-87,130,131,131
63,lgt601d.map,256,256,25298,98,45,157,210,27308,106,83,149,172,-8,38,46,47,47
64,lgt601d.map,256,256,24249,94,70,161,185,57794,225,61,30,194,-131,-9,140,1152,1640
65,lgt601d.map,256,256,51010,199,189,56,66,41893,163,90,92,165,36,-99,135,2786,326
66,lgt601d.map,256,256,41032,160,183,95,72,21386,83,117,172,138,77,-66,143,144,144
67,lgt601d.map,256,256,20363,79,116,176,139,31372,122,115,133,140,-43,-1,44,45,45
68,lgt601d.map,256,256,59688,233,215,22,40,13244,51,67,204,188,182,-148,330,436,769
69,lgt601d.map,256,256,25010,97,77,158,178,49230,192,177,63,78,-95,100,195,196,196
70,lgt601d.map,256,256,53104,207,143,48,112,38865,151,46,104,209,56,-97,153,372,154
71,lgt601d.map,256,256,48483,189,156,66,99,42927,167,80,88,175,22,-76,98,1490,423
72,lgt601d.map,256,256,52437,204,42,51,213,41647,162,80,93,175,42,38,80,81,81
73,lgt601d.map,256,256,16248,63,135,192,120,19913,77,54,178,201,-14,-81,95,96,96
74,lgt601d.map,256,256,24186,94,133,161,122,37431,146,200,109,55,-52,67,119,120,120
75,lgt601d.map,256,256,33414,130,121,125,134,61518,240,177,15,78,-110,56,166,4168,540
76,lgt601d.map,256,256,32957,128,66,127,189,47277,184,82,71,173,-56,16,72,1076,600
77,lgt601d.map,256,256,45129,176,182,79,73,51142,199,57,56,198,-23,-125,148,2905,3526
78,lgt601d.map,256,256,24926,97,161,158,94,51886,202,81,53,174,-105,-80,185,1641,203
79,lgt601d.map,256,256,46801,182,46,73,209,31567,123,176,132,79,59,130,189,990,253
80,lgt601d.map,256,256,43064,168,199,87,56,22419,87,108,168,147,81,-91,172,173,173
81,lgt601d.map,256,256,51878,202,89,53,166,56991,222,96,33,159,-20,7,27,28,28
82,lgt601d.map,256,256,49305,192,102,63,153,32398,126,113,129,142,66,11,77,278,306
83,lgt601d.map,256,256,56588,221,243,34,12,33613,131,178,124,77,90,-65,155,221,1237
84,lgt601d.map,256,256,29368,114,71,141,184,57218,223,125,32,130,-109,54,163,791,165
85,lgt601d.map,256,256,13497,52,70,203,185,60294,235,121,20,134,-183,51,234,694,271
86,lgt601d.map,256,256,47448,185,167,70,88,41226,161,245,94,10,24,78,102,103,103
87,lgt601d.map,256,256,52541,205,194,50,61,44943,175,112,80,143,30,-82,112,3274,1246
88,lgt601d.map,256,256,53690,209,69,46,186,34679,135,136,120,119,74,67,141,179,946
89,lgt601d.map,256,256,61009,238,174,17,81,3836,14,3,241,252,224,-171,395,538,14040
90,lgt601d.map,256,256,43337,169,182,86,73,47247,184,112,71,143,-15,-70,85,1785,540
91,lgt601d.map,256,256,35905,140,190,115,65,58017,226,94,29,161,-86,-96,182,487,520
92,lgt601d.map,256,256,39945,156,246,99,9,24685,96,146,159,109,60,-100,160,161,161
93,lgt601d.map,256,256,52118,203,105,52,150,43286,169,233,86,22,34,128,162,1141,3637
94,lgt601d.map,256,256,47529,185,86,70,169,17764,69,155,186,100,116,69,185,194,2213
95,lgt601d.map,256,256,20856,81,135,174,120,27045,105,90,150,165,-24,-45,69,70,70
96,lgt601d.map,256,256,54219,211,52,44,203,35919,140,176,115,79,71,124,195,924,298
97,lgt601d.map,256,256,35721,139,118,116,137,54173,211,98,44,157,-72,-20,92,414,93
98,lgt601d.map,256,256,44940,175,115,80,140,45621,178,202,77,53,-3,87,90,548,2212
99,lgt601d.map,256,256,30801,120,174,135,81,54190,211,81,44,174,-91,-93,184,892,202
0,lgt602d.map,264,240,46611,194,188,69,51,42539,177,180,86,59,17,-8,25,7363,6674
1,lgt602d.map,264,240,35180,146,99,117,140,27181,113,178,150,61,33,79,112,8334,12826
2,lgt602d.map,264,240,3514,14,85,249,154,22246,92,73,171,166,-78,-12,90,276,92
3,lgt602d.map,264,240,45329,188,30,75,209,46578,194,221,69,18,-6,191,197,9931,7076
4,lgt602d.map,264,240,45193,188,166,75,73,29186,121,93,142,146,67,-73,140,4770,1156
5,lgt602d.map,264,240,23840,99,159,164,80,10856,45,183,218,56,54,24,78,84,79
6,lgt602d.map,264,240,52321,218,238,45,1,36698,152,21,111,218,66,-217,283,14429,21366
7,lgt602d.map,264,240,55713,232,206,31,33,32907,137,212,126,27,95,6,101,1292,1305
8,lgt602d.map,264,240,4638,19,161,244,78,63159,263,200,0,39,-244,39,283,13917,14011
9,lgt602d.map,264,240,32176,134,223,129,16,15732,65,107,198,132,69,-116,185,1698,3331
10,lgt602d.map,264,240,49667,206,12,57,227,43411,180,28,83,211,26,16,42,43,43
11,lgt602d.map,264,240,14200,59,199,204,40,20679,86,200,177,39,-27,1,28,29,29
12,lgt602d.map,264,240,54538,227,181,36,58,15157,63,202,200,37,164,21,185,8442,9481
13,lgt602d.map,264,240,22388,93,171,170,68,31926,133,233,130,6,-40,62,102,633,1766
14,lgt602d.map,264,240,22721,94,78,169,161,20309,84,90,179,149,10,12,22,23,23
15,lgt602d.map,264,240,40843,170,196,93,43,42300,176,179,87,60,-6,-17,23,24,27
16,lgt602d.map,264,240,24544,102,175,161,64,35794,149,205,114,34,-47,30,77,129,1286
17,lgt602d.map,264,240,61216,255,223,8,16,62961,262,158,1,81,-7,-65,72,7122,6055
18,lgt602d.map,264,240,44156,183,3,80,236,50383,209,16,54,223,-26,13,39,40,40
19,lgt602d.map,264,240,18322,76,157,187,82,27146,113,213,150,26,-37,56,93,3716,1848
20,lgt602d.map,264,240,42924,178,35,85,204,31151,129,48,134,191,49,13,62,3487,3016
21,lgt602d.map,264,240,11444,47,75,216,164,38022,158,137,105,102,-111,62,173,7656,2368
22,lgt602d.map,264,240,38832,161,47,102,192,45094,187,25,76,214,-26,-22,48,49,49
23,lgt602d.map,264,240,39576,164,23,99,216,36997,154,202,109,37,10,179,189,6044,4282
24,lgt602d.map,264,240,52803,220,236,43,3,9683,40,156,223,83,180,-80,260,16653,13931
25,lgt602d.map,264,240,12074,50,165,213,74,61230,255,209,8,30,-205,44,249,8547,5403
26,lgt602d.map,264,240,20232,84,167,179,72,28339,118,220,145,19,-34,53,87,2507,1894
27,lgt602d.map,264,240,43123,179,76,84,163,5559,23,200,240,39,156,124,280,12294,11237
28,lgt602d.map,264,240,32867,136,12,127,227,13549,56,130,207,109,80,118,198,414,355
29,lgt602d.map,264,240,43738,182,181,81,58,33412,139,187,124,52,43,6,49,1856,1461
30,lgt602d.map,264,240,30944,128,15,135,224,14319,59,80,204,159,69,65,134,144,135
31,lgt602d.map,264,240,20032,83,127,180,112,60043,250,196,13,43,-167,69,236,10077,7598
32,lgt602d.map,264,240,9505,39,94,224,145,43482,181,197,82,42,-142,103,245,1694,281
33,lgt602d.map,264,240,29449,122,70,141,169,28111,117,208,146,31,5,138,143,9712,8225
34,lgt602d.map,264,240,30224,125,15,138,224,45771,190,68,73,171,-65,53,118,236,2231
35,lgt602d.map,264,240,22016,91,63,172,176,55242,230,197,33,42,-139,134,273,15695,8674
36,lgt602d.map,264,240,54191,225,48,38,191,45111,187,8,76,231,38,-40,78,79,79
37,lgt602d.map,264,240,9475,39,124,224,115,8511,35,128,228,111,4,4,8,9,9
38,lgt602d.map,264,240,11825,49,174,214,65,31106,129,93,134,146,-80,-81,161,10551,1748
39,lgt602d.map,264,240,3532,14,67,249,172,36909,153,50,110,189,-139,-17,156,1418,2525
40,lgt602d.map,264,240,20763,86,116,177,123,57630,240,209,23,30,-154,93,247,8571,8013
41,lgt602d.map,264,240,59085,246,194,17,45,52983,220,56,43,183,26,-138,164,7303,11720
42,lgt602d.map,264,240,43249,180,190,83,49,6851,28,108,235,131,152,-82,234,249,1268
43,lgt602d.map,264,240,14976,62,143,201,96,54971,229,228,34,11,-167,85,252,8651,4077
44,lgt602d.map,264,240,46033,191,46,72,193,31942,133,217,130,22,58,171,229,3741,2997
45,lgt602d.map,264,240,55744,232,175,31,64,33645,140,194,123,45,92,19,111,3153,3078
46,lgt602d.map,264,240,47218,196,61,67,178,49669,206,10,57,229,-10,-51,61,62,62
47,lgt602d.map,264,240,31152,129,47,134,192,34020,141,59,122,180,-12,12,24,25,25
48,lgt602d.map,264,240,18875,78,84,185,155,32660,136,219,127,20,-58,135,193,735,1330
49,lgt602d.map,264,240,29001,120,38,143,201,53973,224,26,39,213,-104,-12,116,1794,3364
50,lgt602d.map,264,240,52394,218,165,45,74,54035,225,204,38,35,-7,39,46,47,47
51,lgt602d.map,264,240,32635,135,4,128,235,8695,36,184,227,55,99,180,279,10226,1337
52,lgt602d.map,264,240,47305,197,214,66,25,26546,110,93,153,146,87,-121,208,7977,8199
53,lgt602d.map,264,240,25161,104,38,159,201,29019,120,20,143,219,-16,-18,34,35,35
54,lgt602d.map,264,240,18373,76,106,187,133,51573,214,26,49,213,-138,-80,218,5541,4832
55,lgt602d.map,264,240,57668,240,171,23,68,17934,74,65,189,174,166,-106,272,5061,18832
56,lgt602d.map,264,240,31402,130,37,133,202,9487,39,112,224,127,91,75,166,185,780
57,lgt602d.map,264,240,48973,204,226,59,13,27423,114,176,149,63,90,-50,140,826,141
58,lgt602d.map,264,240,19368,80,71,183,168,21777,90,62,173,177,-10,-9,19,20,20
59,lgt602d.map,264,240,49128,204,71,59,168,43860,182,59,81,180,22,-12,34,35,41
60,lgt602d.map,264,240,44681,186,198,77,41,32785,136,94,127,145,50,-104,154,13250,6259
61,lgt602d.map,264,240,19770,82,149,181,90,52781,219,18,44,221,-137,-131,268,5671,5018
62,lgt602d.map,264,240,47811,199,188,64,51,61236,255,203,8,36,-56,15,71,72,77
63,lgt602d.map,264,240,21673,90,166,173,73,24247,101,232,162,7,-11,66,77,3252,2140
64,lgt602d.map,264,240,39393,164,206,99,33,15687,65,152,198,87,99,-54,153,342,5605
65,lgt602d.map,264,240,45080,187,39,76,200,63120,263,239,0,0,-76,200,276,11798,7287
66,lgt602d.map,264,240,50640,211,239,52,0,36943,153,16,110,223,58,-223,281,9131,12384
67,lgt602d.map,264,240,3299,13,60,250,179,5389,22,130,241,109,-9,70,79,1028,370
68,lgt602d.map,264,240,20272,84,127,179,112,26821,111,58,152,181,-27,-69,96,219,107
69,lgt602d.map,264,240,26654,111,225,152,14,17647,73,112,190,127,38,-113,151,2221,6408
70,lgt602d.map,264,240,30668,127,51,136,188,57684,240,155,23,84,-113,104,217,5912,7500
71,lgt602d.map,264,240,35544,148,215,115,24,24725,103,234,160,5,45,19,64,65,65
72,lgt602d.map,264,240,23716,98,43,165,196,41582,173,177,90,62,-75,134,209,5457,4286
73,lgt602d.map,264,240,9760,40,79,223,160,45553,189,46,74,193,-149,-33,182,7892,4015
74,lgt602d.map,264,240,39400,164,199,99,40,35599,148,160,115,79,16,-39,55,201,857
75,lgt602d.map,264,240,57867,241,212,22,27,18269,76,210,187,29,165,-2,167,8594,6355
76,lgt602d.map,264,240,25461,106,218,157,21,52142,217,177,46,62,-111,-41,152,2536,1270
77,lgt602d.map,264,240,11793,49,206,214,33,40105,167,214,96,25,-118,8,126,1979,4324
78,lgt602d.map,264,240,24083,100,156,163,83,41939,174,60,89,179,-74,-96,170,390,1048
79,lgt602d.map,264,240,57417,239,182,24,57,46975,195,64,68,175,44,-118,162,7270,12097
80,lgt602d.map,264,240,31985,133,174,130,65,61012,254,187,9,52,-121,13,134,5396,3696
81,lgt602d.map,264,240,52825,220,214,43,25,13303,55,136,208,103,165,-78,243,3638,8903
82,lgt602d.map,264,240,40352,168,207,95,32,43015,179,184,84,55,-11,-23,34,35,35
83,lgt602d.map,264,240,46320,193,239,70,0,60978,254,221,9,18,-61,-18,79,413,782
84,lgt602d.map,264,240,15191,63,168,200,71,42031,175,208,88,31,-112,40,152,1842,323
85,lgt602d.map,264,240,10691,44,108,219,131,20581,85,58,178,181,-41,-50,91,137,99
86,lgt602d.map,264,240,10952,45,87,218,152,13532,56,147,207,92,-11,60,71,80,564
87,lgt602d.map,264,240,22616,94,183,169,56,11150,46,129,217,110,48,-54,102,113,288
88,lgt602d.map,264,240,37517,156,162,107,77,43663,181,16,82,223,-25,-146,171,172,688
89,lgt602d.map,264,240,15205,63,154,200,85,48725,203,234,60,5,-140,80,220,1003,1863
90,lgt602d.map,264,240,47064,196,215,67,24,16973,70,66,193,173,126,-149,275,2326,11523
91,lgt602d.map,264,240,39806,165,33,98,206,4126,17,193,246,46,148,160,308,13430,11377
92,lgt602d.map,264,240,23108,96,171,167,68,45398,189,201,74,38,-93,30,123,5994,2018
93,lgt602d.map,264,240,46760,194,39,69,200,57682,240,157,23,82,-46,118,164,4231,1497
94,lgt602d.map,264,240,3944,16,135,247,104,21268,88,91,175,148,-72,-44,116,329,335
95,lgt602d.map,264,240,45850,191,229,72,10,3527,14,72,249,167,177,-157,334,2108,1980
96,lgt602d.map,264,240,56656,236,223,27,16,35438,147,81,116,158,89,-142,231,15679,13047
97,lgt602d.map,264,240,26941,112,178,151,61,27862,116,217,147,22,-4,39,43,393,1297
98,lgt602d.map,264,240,19861,82,58,181,181,11335,47,184,216,55,35,126,161,615,168
99,lgt602d.map,264,240,38318,159,81,104,158,43606,181,73,82,166,-22,-8,30,5557,6865
0,lgt603d.map,262,234,33788,144,141,117,92,48614,207,57,54,176,-63,-84,147,12182,12649
1,lgt603d.map,262,234,57180,244,149,17,84,21260,90,33,171,200,154,-116,270,2988,3286
2,lgt603d.map,262,234,57277,244,52,17,181,48382,206,55,55,178,38,3,41,236,203
3,lgt603d.map,262,234,46842,200,191,61,42,56293,240,100,21,133,-40,-91,131,10063,9543
4,lgt603d.map,262,234,26590,113,85,148,148,22135,94,94,167,139,19,9,28,29,29
5,lgt603d.map,262,234,42629,182,192,79,41,28295,120,18,141,215,62,-174,236,5607,3761
6,lgt603d.map,262,234,25768,110,205,151,28,31763,135,60,126,173,-25,-145,170,3506,7538
7,lgt603d.map,262,234,38712,165,131,96,102,55308,236,149,25,84,-71,18,89,7913,5959
8,lgt603d.map,262,234,54274,231,13,30,220,31245,133,110,128,123,98,97,195,14133,7137
9,lgt603d.map,262,234,39160,167,151,94,82,60200,257,171,4,62,-90,20,110,8851,5975
10,lgt603d.map,262,234,31773,135,50,126,183,39519,168,26,93,207,-33,-24,57,8229,13699
11,lgt603d.map,262,234,42521,181,66,80,167,55573,237,118,24,115,-56,52,108,3334,4610
12,lgt603d.map,262,234,22192,94,37,167,196,19738,84,151,177,82,10,114,124,17454,13201
13,lgt603d.map,262,234,57979,247,52,14,181,13683,58,122,203,111,189,70,259,14956,13723
14,lgt603d.map,262,234,28010,119,69,142,164,37748,161,159,100,74,-42,90,132,345,1984
15,lgt603d.map,262,234,35323,150,10,111,223,26307,112,134,149,99,38,124,162,9381,8718
16,lgt603d.map,262,234,32852,140,141,121,92,30998,132,123,129,110,8,-18,26,27,27
17,lgt603d.map,262,234,31465,134,124,127,109,26213,112,228,149,5,22,104,126,920,2509
18,lgt603d.map,262,234,53794,229,25,32,208,24542,104,27,157,206,125,2,127,128,128
19,lgt603d.map,262,234,24274,103,61,158,172,37621,160,52,101,181,-57,-9,66,14489,14426
20,lgt603d.map,262,234,46510,198,55,63,178,28998,123,17,138,216,75,-38,113,1039,5181
21,lgt603d.map,262,234,41364,176,53,85,180,16966,72,115,189,118,104,62,166,8375,7402
22,lgt603d.map,262,234,23259,99,140,162,93,48379,206,58,55,175,-107,-82,189,14167,13899
23,lgt603d.map,262,234,53915,230,138,31,95,36086,154,183,107,50,76,45,121,9167,14702
24,lgt603d.map,262,234,33441,142,20,119,213,31333,133,22,128,211,9,2,11,12,12
25,lgt603d.map,262,234,21626,92,135,169,98,33051,141,176,120,57,-49,41,90,91,91
26,lgt603d.map,262,234,50763,216,14,45,219,6597,28,188,233,45,188,174,362,20292,11922
27,lgt603d.map,262,234,60442,258,163,3,70,57725,246,72,15,161,12,-91,103,270,522
28,lgt603d.map,262,234,48186,205,17,56,216,34918,149,181,112,52,56,164,220,4424,5072
29,lgt603d.map,262,234,35140,150,193,111,40,25038,107,233,154,0,43,40,83,84,84
30,lgt603d.map,262,234,28386,121,161,140,72,36535,156,202,105,31,-35,41,76,77,107
31,lgt603d.map,262,234,34322,146,75,115,158,30491,130,162,131,71,16,87,103,2474,817
32,lgt603d.map,262,234,11433,48,32,213,201,31580,134,9,127,224,-86,-23,109,110,110
33,lgt603d.map,262,234,45850,195,13,66,220,37709,161,198,100,35,34,185,219,3380,3292
34,lgt603d.map,262,234,26128,111,79,150,154,56607,241,20,20,213,-130,-59,189,9214,17401
35,lgt603d.map,262,234,37120,158,85,103,148,54273,231,14,30,219,-73,-71,144,7663,15661
36,lgt603d.map,262,234,24224,103,111,158,122,53405,228,180,33,53,-125,69,194,16435,14688
37,lgt603d.map,262,234,48844,208,61,53,172,21965,93,30,168,203,115,-31,146,1283,4991
38,lgt603d.map,262,234,54217,231,70,30,163,38022,162,119,99,114,69,49,118,3465,2506
39,lgt603d.map,262,234,41685,178,200,83,33,21502,91,25,170,208,87,-175,262,7708,3736
40,lgt603d.map,262,234,27697,118,148,143,85,39206,167,105,94,128,-49,-43,92,4653,1736
41,lgt603d.map,262,234,11088,47,143,214,90,32865,140,128,121,105,-93,-15,108,5008,3551
42,lgt603d.map,262,234,4970,21,177,240,56,15999,68,146,193,87,-47,-31,78,329,79
43,lgt603d.map,262,234,52947,226,170,35,63,60549,258,56,3,177,-32,-114,146,147,207
44,lgt603d.map,262,234,8643,36,14,225,219,54454,232,67,29,166,-196,53,249,2464,779
45,lgt603d.map,262,234,29195,124,54,137,179,6614,28,171,233,62,96,117,213,230,264
46,lgt603d.map,262,234,29432,125,51,136,182,58446,249,53,12,180,-124,2,126,11136,16455
47,lgt603d.map,262,234,35941,153,94,108,139,53790,229,29,32,204,-76,-65,141,7929,14985
48,lgt603d.map,262,234,31651,135,172,126,61,60107,256,30,5,203,-121,-142,263,7110,11415
49,lgt603d.map,262,234,35498,151,69,110,164,33258,142,203,119,30,9,134,143,1019,1001
50,lgt603d.map,262,234,31698,135,125,126,108,25151,107,120,154,113,28,-5,33,2297,3256
51,lgt603d.map,262,234,36468,155,35,106,198,52732,225,151,36,82,-70,116,186,5098,3113
52,lgt603d.map,262,234,27547,117,64,144,169,35476,151,91,110,142,-34,27,61,202,412
53,lgt603d.map,262,234,21845,93,150,168,83,58095,248,170,13,63,-155,20,175,14873,19846
54,lgt603d.map,262,234,56306,240,87,21,146,11916,50,17,211,216,190,-70,260,663,2891
55,lgt603d.map,262,234,47944,204,25,57,208,19510,83,145,178,88,121,120,241,20284,12443
56,lgt603d.map,262,234,29648,126,69,135,164,43456,185,67,76,166,-59,-2,61,7094,14366
57,lgt603d.map,262,234,35019,149,80,112,153,39245,167,66,94,167,-18,-14,32,33,33
58,lgt603d.map,262,234,40210,171,37,90,196,25965,110,8,151,225,61,-29,90,114,2485
59,lgt603d.map,262,234,50479,215,64,46,169,27783,118,62,143,171,97,-2,99,16575,14678
60,lgt603d.map,262,234,52824,225,59,36,174,28957,123,58,138,175,102,-1,103,16471,11525
61,lgt603d.map,262,234,45810,195,53,66,180,52494,224,155,37,78,-29,102,131,1598,1767
62,lgt603d.map,262,234,42624,182,197,79,36,29322,125,161,136,72,57,-36,93,111,94
63,lgt603d.map,262,234,54398,232,123,29,110,27567,117,44,144,189,115,-79,194,3452,4873
64,lgt603d.map,262,234,33497,143,198,118,35,31921,136,136,125,97,7,-62,69,593,328
65,lgt603d.map,262,234,35602,152,199,109,34,17542,74,7,187,226,78,-192,270,10115,5909
66,lgt603d.map,262,234,53186,227,165,34,68,32963,140,30,121,203,87,-135,222,2603,5314
67,lgt603d.map,262,234,21753,92,8,169,225,41123,175,60,86,173,-83,52,135,849,184
68,lgt603d.map,262,234,8641,36,16,225,217,54039,230,14,31,219,-194,-2,196,305,474
69,lgt603d.map,262,234,59897,255,6,6,227,28867,123,148,138,85,132,142,274,13269,8527
70,lgt603d.map,262,234,25226,107,45,154,188,32797,140,196,121,37,-33,151,184,4704,11867
71,lgt603d.map,262,234,54872,234,117,27,116,36673,156,64,105,169,78,-53,131,15965,15248
72,lgt603d.map,262,234,18234,77,17,184,216,31963,136,94,125,139,-59,77,136,12869,9052
73,lgt603d.map,262,234,47200,201,67,60,166,59169,252,32,9,201,-51,-35,86,175,119
74,lgt603d.map,262,234,24776,105,27,156,206,38563,164,46,97,187,-59,19,78,14792,9041
75,lgt603d.map,262,234,26178,111,29,150,204,41703,178,182,83,51,-67,153,220,3614,6062
76,lgt603d.map,262,234,51781,221,166,40,67,30437,130,216,131,17,91,50,141,9310,17108
77,lgt603d.map,262,234,59172,252,29,9,204,52495,224,154,37,79,28,125,153,699,154
78,lgt603d.map,262,234,48617,207,54,54,179,41407,176,10,85,223,31,-44,75,982,2562
79,lgt603d.map,262,234,34344,146,53,115,180,42260,180,93,81,140,-34,40,74,6483,10279
80,lgt603d.map,262,234,31688,135,135,126,98,43662,186,95,75,138,-51,-40,91,4213,2653
81,lgt603d.map,262,234,57033,243,62,18,171,12604,53,31,208,202,190,-31,221,2163,2163
82,lgt603d.map,262,234,38554,164,55,97,178,53884,230,169,31,64,-66,114,180,16224,16334
83,lgt603d.map,262,234,30396,129,23,132,210,41918,179,201,82,32,-50,178,228,2962,5647
84,lgt603d.map,262,234,59410,253,25,8,208,56742,242,119,19,114,11,94,105,106,106
85,lgt603d.map,262,234,44663,190,30,71,203,59863,255,40,6,193,-65,10,75,114,610
86,lgt603d.map,262,234,31555,134,34,127,199,60671,259,168,2,65,-125,134,259,2552,4018
87,lgt603d.map,262,234,5588,23,27,238,206,34293,146,104,115,129,-123,77,200,13308,9513
88,lgt603d.map,262,234,55049,235,174,26,59,23854,101,13,160,220,134,-161,295,1835,6506
89,lgt603d.map,262,234,51076,218,169,43,64,60439,258,166,3,67,-40,-3,43,44,44
90,lgt603d.map,262,234,34778,148,87,113,146,33967,145,196,116,37,3,109,112,508,597
91,lgt603d.map,262,234,43233,184,56,77,177,46035,196,62,65,171,-12,6,18,3509,2361
92,lgt603d.map,262,234,36770,157,201,104,32,12460,53,175,208,58,104,-26,130,5598,2967
93,lgt603d.map,262,234,38086,162,55,99,178,37702,161,205,100,28,1,150,151,1052,2830
94,lgt603d.map,262,234,11790,50,143,211,90,24342,104,227,157,6,-54,84,138,2110,1778
95,lgt603d.map,262,234,30440,130,213,131,20,47911,204,58,57,175,-74,-155,229,13932,8620
96,lgt603d.map,262,234,8252,35,171,226,62,26167,111,40,150,193,-76,-131,207,13320,15181
97,lgt603d.map,262,234,23476,100,157,161,76,56606,241,21,20,212,-141,-136,277,11220,19200
98,lgt603d.map,262,234,25335,108,170,153,63,58807,251,160,10,73,-143,-10,153,14866,17988
99,lgt603d.map,262,234,43985,187,6,74,227,35532,151,35,110,198,36,29,65,66,66
0,lgt604d.map,180,253,23971,94,63,85,189,16031,63,160,116,92,31,97,128,2110,1165
1,lgt604d.map,180,253,18147,71,68,108,184,27140,107,183,72,69,-36,115,151,152,456
2,lgt604d.map,180,253,13795,54,119,125,133,5742,22,76,157,176,32,-43,75,76,76
3,lgt604d.map,180,253,4451,17,102,162,150,18180,71,35,108,217,-54,-67,121,1858,211
4,lgt604d.map,180,253,29408,116,192,63,60,8086,31,9,148,243,85,-183,268,3380,585
5,lgt604d.map,180,253,27904,110,178,69,74,7190,28,146,151,106,82,-32,114,115,115
6,lgt604d.map,180,253,9715,38,151,141,101,13343,52,65,127,187,-14,-86,100,955,179
7,lgt604d.map,180,253,18921,74,53,105,199,18687,73,34,106,218,1,-19,20,21,21
8,lgt604d.map,180,253,19168,75,59,104,193,17367,68,89,111,163,7,30,37,38,38
9,lgt604d.map,180,253,11245,44,139,135,113,12767,50,135,129,117,-6,-4,10,11,11
10,lgt604d.map,180,253,18689,73,32,106,220,12218,48,178,131,74,25,146,171,1705,2494
11,lgt604d.map,180,253,19907,78,79,101,173,21708,85,49,94,203,-7,-30,37,38,38
12,lgt604d.map,180,253,25112,99,187,80,65,13248,52,160,127,92,47,-27,74,75,75
13,lgt604d.map,180,253,6188,24,136,155,116,19039,75,188,104,64,-51,52,103,104,104
14,lgt604d.map,180,253,24716,97,77,82,175,22501,88,15,91,237,9,-62,71,263,1108
15,lgt604d.map,180,253,16013,63,178,116,74,16623,65,74,114,178,-2,-104,106,1932,1358
16,lgt604d.map,180,253,24609,97,184,82,68,8227,32,121,147,131,65,-63,128,129,129
17,lgt604d.map,180,253,4434,17,119,162,133,24970,98,76,81,176,-81,-43,124,9389,1127
18,lgt604d.map,180,253,8458,33,143,146,109,14998,59,181,120,71,-26,38,64,65,65
19,lgt604d.map,180,253,12760,50,142,129,110,13785,54,129,125,123,-4,-13,17,18,18
20,lgt604d.map,180,253,21064,83,187,96,65,2389,9,140,170,112,74,-47,121,122,122
21,lgt604d.map,180,253,2415,9,114,170,138,22615,89,154,90,98,-80,40,120,3228,929
22,lgt604d.map,180,253,20826,82,172,97,80,26775,105,42,74,210,-23,-130,153,4809,2012
23,lgt604d.map,180,253,15505,61,180,118,72,15335,60,97,119,155,1,-83,84,1860,712
24,lgt604d.map,180,253,18546,73,175,106,77,7923,31,172,148,80,42,-3,45,46,46
25,lgt604d.map,180,253,19440,76,40,103,212,21325,84,179,95,73,-8,139,147,1137,383
26,lgt604d.map,180,253,12267,48,129,131,123,1150,4,114,175,138,44,-15,59,60,60
27,lgt604d.map,180,253,16369,64,75,115,177,15756,62,182,117,70,2,107,109,1397,1923
28,lgt604d.map,180,253,19657,77,76,102,176,1906,7,117,172,135,70,41,111,112,402
29,lgt604d.map,180,253,15261,60,171,119,81,19703,77,30,102,222,-17,-141,158,818,2015
30,lgt604d.map,180,253,28280,111,55,68,197,17877,70,85,109,167,41,30,71,862,2692
31,lgt604d.map,180,253,19654,77,79,102,173,12526,49,123,130,129,28,44,72,1171,454
32,lgt604d.map,180,253,18370,72,98,107,154,29412,116,188,63,64,-44,90,134,158,471
33,lgt604d.map,180,253,6912,27,171,152,81,11801,46,89,133,163,-19,-82,101,102,102
34,lgt604d.map,180,253,9755,38,111,141,141,24734,97,59,82,193,-59,-52,111,131,112
35,lgt604d.map,180,253,5153,20,159,159,93,20391,80,101,99,151,-60,-58,118,2582,288
36,lgt604d.map,180,253,10229,40,143,139,109,17110,67,93,112,159,-27,-50,77,637,204
37,lgt604d.map,180,253,2165,8,111,171,141,16023,63,168,116,84,-55,57,112,113,113
38,lgt604d.map,180,253,12026,47,117,132,135,9020,35,87,144,165,12,-30,42,43,43
39,lgt604d.map,180,253,9946,39,173,140,79,26131,103,180,76,72,-64,7,71,72,72
40,lgt604d.map,180,253,22363,88,153,91,99,13547,53,114,126,138,35,-39,74,1476,1313
41,lgt604d.map,180,253,13252,52,156,127,96,34965,138,201,41,51,-86,45,131,205,132
42,lgt604d.map,180,253,21691,85,66,94,186,14005,55,162,124,90,30,96,126,1854,1304
43,lgt604d.map,180,253,14132,55,35,124,217,15390,60,42,119,210,-5,7,12,13,13
44,lgt604d.map,180,253,20386,80,106,99,146,31687,125,190,54,62,-45,84,129,153,310
45,lgt604d.map,180,253,15273,60,159,119,93,12471,49,178,130,74,11,19,30,31,31
46,lgt604d.map,180,253,18445,72,23,107,229,10614,41,11,138,241,31,-12,43,44,74
47,lgt604d.map,180,253,33706,133,195,46,57,13527,53,134,126,118,80,-61,141,2395,318
48,lgt604d.map,180,253,9232,36,128,143,124,28533,112,55,67,197,-76,-73,149,6734,1117
49,lgt604d.map,180,253,3650,14,144,165,108,3695,14,99,165,153,0,-45,45,46,46
50,lgt604d.map,180,253,20161,79,78,100,174,15846,62,92,117,160,17,14,31,32,32
51,lgt604d.map,180,253,23722,93,59,86,193,44539,176,241,3,11,-83,182,265,568,2554
52,lgt604d.map,180,253,17914,70,48,109,204,24629,97,164,82,88,-27,116,143,144,290
53,lgt604d.map,180,253,35467,140,205,39,47,40766,161,219,18,33,-21,14,35,36,36
54,lgt604d.map,180,253,8752,34,102,145,150,18881,74,93,105,159,-40,-9,49,50,50
55,lgt604d.map,180,253,20171,79,68,100,184,28646,113,195,66,57,-34,127,161,185,362
56,lgt604d.map,180,253,19305,76,175,103,77,6739,26,91,153,161,50,-84,134,135,135
57,lgt604d.map,180,253,25240,99,59,80,193,2185,8,91,171,161,91,32,123,124,663
58,lgt604d.map,180,253,9035,35,72,144,180,23163,91,112,88,140,-56,40,96,230,97
59,lgt604d.map,180,253,6466,25,111,154,141,5951,23,120,156,132,2,9,11,12,12
60,lgt604d.map,180,253,10496,41,129,138,123,23862,94,172,85,80,-53,43,96,97,97
61,lgt604d.map,180,253,14553,57,120,122,132,21863,86,147,93,105,-29,27,56,1734,1845
62,lgt604d.map,180,253,6962,27,121,152,131,16365,64,79,115,173,-37,-42,79,197,80
63,lgt604d.map,180,253,6426,25,151,154,101,14886,58,40,121,212,-33,-111,144,145,166
64,lgt604d.map,180,253,31429,124,195,55,57,20663,81,82,98,170,43,-113,156,317,180
65,lgt604d.map,180,253,19422,76,58,103,194,11799,46,91,133,161,30,33,63,64,65
66,lgt604d.map,180,253,22720,89,49,90,203,22393,88,123,91,129,1,74,75,296,270
67,lgt604d.map,180,253,13529,53,132,126,120,12002,47,141,132,111,6,9,15,16,16
68,lgt604d.map,180,253,12084,47,59,132,193,8718,34,136,145,116,13,77,90,91,91
69,lgt604d.map,180,253,12113,47,30,132,222,20653,81,92,98,160,-34,62,96,586,2437
70,lgt604d.map,180,253,22837,90,185,89,67,22710,89,59,90,193,1,-126,127,936,290
71,lgt604d.map,180,253,23120,91,155,88,97,23380,92,148,87,104,-1,-7,8,9,9
72,lgt604d.map,180,253,4408,17,145,162,107,38247,151,208,28,44,-134,63,197,271,198
73,lgt604d.map,180,253,20052,79,187,100,65,7501,29,88,150,164,50,-99,149,150,150
74,lgt604d.map,180,253,8224,32,124,147,128,14501,57,172,122,80,-25,48,73,74,74
75,lgt604d.map,180,253,22349,88,167,91,85,22647,89,122,90,130,-1,-45,46,47,47
76,lgt604d.map,180,253,25529,100,23,79,229,26780,105,37,74,215,-5,14,19,20,20
77,lgt604d.map,180,253,7186,28,150,151,102,23635,93,146,86,106,-65,-4,69,1565,531
78,lgt604d.map,180,253,13532,53,129,126,123,5725,22,93,157,159,31,-36,67,68,68
79,lgt604d.map,180,253,19818,78,168,101,84,18636,73,85,106,167,5,-83,88,303,717
80,lgt604d.map,180,253,9690,38,176,141,76,23893,94,141,85,111,-56,-35,91,644,120
81,lgt604d.map,180,253,22624,89,145,90,107,2410,9,119,170,133,80,-26,106,944,3413
82,lgt604d.map,180,253,20681,81,64,98,188,13284,52,124,127,128,29,60,89,1669,518
83,lgt604d.map,180,253,16512,65,185,114,67,9257,36,103,143,149,29,-82,111,112,112
84,lgt604d.map,180,253,8218,32,130,147,122,25635,101,170,78,82,-69,40,109,110,110
85,lgt604d.map,180,253,11579,45,58,134,194,41271,163,220,16,32,-118,162,280,621,5775
86,lgt604d.map,180,253,23618,93,163,86,89,11735,46,155,133,97,47,-8,55,233,364
87,lgt604d.map,180,253,1163,4,101,175,151,14005,55,162,124,90,-51,61,112,113,113
88,lgt604d.map,180,253,34467,136,193,43,59,11543,45,94,134,158,91,-99,190,1393,234
89,lgt604d.map,180,253,21387,84,117,95,135,1382,5,135,174,117,79,18,97,775,2928
90,lgt604d.map,180,253,11744,46,146,133,106,9759,38,107,141,145,8,-39,47,48,48
91,lgt604d.map,180,253,40518,160,214,19,38,12766,50,136,129,116,110,-78,188,2627,312
92,lgt604d.map,180,253,17272,68,184,111,68,21907,86,103,93,149,-18,-81,99,476,284
93,lgt604d.map,180,253,12123,47,20,132,232,2412,9,117,170,135,38,97,135,326,2351
94,lgt604d.map,180,253,26794,105,23,74,229,36486,144,198,35,54,-39,175,214,991,3769
95,lgt604d.map,180,253,20819,82,179,97,73,3651,14,143,165,109,68,-36,104,105,105
96,lgt604d.map,180,253,43525,172,243,7,9,10791,42,87,137,165,130,-156,286,1683,345
97,lgt604d.map,180,253,18882,74,92,105,160,3899,15,148,164,104,59,56,115,116,116
98,lgt604d.map,180,253,7970,31,125,148,127,4462,17,91,162,161,14,-34,48,49,49
99,lgt604d.map,180,253,21331,84,173,95,79,1127,4,137,175,115,80,-36,116,117,117
0,lgt605d.map,74,103,3424,33,77,40,25,6822,66,78,7,24,-33,1,34,519,316
1,lgt605d.map,74,103,2729,26,51,47,51,2227,21,38,52,64,5,-13,18,19,19
2,lgt605d.map,74,103,1864,18,92,55,10,1378,13,63,60,39,5,-29,34,35,35
3,lgt605d.map,74,103,2825,27,58,46,44,2554,24,20,49,82,3,-38,41,42,42
4,lgt605d.map,74,103,1520,14,24,59,78,3261,31,34,42,68,-17,10,27,28,28
5,lgt605d.map,74,103,7137,69,72,4,30,612,5,5,68,97,64,-67,131,137,606
6,lgt605d.map,74,103,1370,13,71,60,31,3547,34,57,39,45,-21,-14,35,36,36
7,lgt605d.map,74,103,7040,68,66,5,36,2315,22,53,51,49,46,-13,59,60,245
8,lgt605d.map,74,103,1118,10,14,63,88,5415,52,43,21,59,-42,29,71,72,72
9,lgt605d.map,74,103,2450,23,21,50,81,1285,12,53,61,49,11,32,43,44,44
10,lgt605d.map,74,103,2200,21,65,52,37,6634,64,60,9,42,-43,-5,48,221,121
11,lgt605d.map,74,103,3539,34,65,39,37,2798,27,85,46,17,7,20,27,28,28
12,lgt605d.map,74,103,2000,19,59,54,43,2526,24,48,49,54,-5,-11,16,17,17
13,lgt605d.map,74,103,4365,42,63,31,39,1767,17,86,56,16,25,23,48,49,49
14,lgt605d.map,74,103,4688,45,49,28,53,3559,34,45,39,57,11,-4,15,16,16
15,lgt605d.map,74,103,7554,73,67,0,35,2332,22,36,51,66,51,-31,82,83,291
16,lgt605d.map,74,103,6720,65,77,8,25,2618,25,59,48,43,40,-18,58,188,398
17,lgt605d.map,74,103,1124,10,8,63,94,1188,11,47,62,55,-1,39,40,41,41
18,lgt605d.map,74,103,1523,14,21,59,81,6517,63,74,10,28,-49,53,102,595,108
19,lgt605d.map,74,103,4896,47,47,26,55,2516,24,58,49,44,23,11,34,35,35
20,lgt605d.map,74,103,2483,24,91,49,11,2239,21,26,52,76,3,-65,68,69,69
21,lgt605d.map,74,103,2546,24,28,49,74,2446,23,25,50,77,1,-3,4,5,5
22,lgt605d.map,74,103,2505,24,69,49,33,2089,20,73,53,29,4,4,8,9,9
23,lgt605d.map,74,103,5712,55,55,18,47,2390,23,81,50,21,32,26,58,59,59
24,lgt605d.map,74,103,4888,47,55,26,47,4045,39,74,34,28,8,19,27,28,28
25,lgt605d.map,74,103,1416,13,25,60,77,6927,67,76,6,26,-54,51,105,665,111
26,lgt605d.map,74,103,1987,19,72,54,30,1316,12,22,61,80,7,-50,57,58,58
27,lgt605d.map,74,103,2280,22,88,51,14,2325,22,43,51,59,0,-45,45,46,46
28,lgt605d.map,74,103,3976,38,40,35,62,4382,42,46,31,56,-4,6,10,11,11
29,lgt605d.map,74,103,4994,48,52,25,50,1919,18,37,55,65,30,-15,45,46,46
30,lgt605d.map,74,103,1026,9,3,64,99,2647,25,30,48,72,-16,27,43,44,44
31,lgt605d.map,74,103,1416,13,25,60,77,5606,54,58,19,44,-41,33,74,75,75
32,lgt605d.map,74,103,1794,17,59,56,43,5607,54,57,19,45,-37,-2,39,40,40
33,lgt605d.map,74,103,1840,17,13,56,89,2807,27,76,46,26,-10,63,73,74,74
34,lgt605d.map,74,103,3964,38,52,35,50,1125,10,7,63,95,28,-45,73,74,74
35,lgt605d.map,74,103,1494,14,50,59,52,3735,36,75,37,27,-22,25,47,48,48
36,lgt605d.map,74,103,3673,35,34,38,68,4887,47,56,26,46,-12,22,34,35,35
37,lgt605d.map,74,103,2820,27,63,46,39,2277,22,91,51,11,5,28,33,34,34
38,lgt605d.map,74,103,1776,17,77,56,25,1799,17,54,56,48,0,-23,23,24,24
39,lgt605d.map,74,103,4896,47,47,26,55,2857,27,26,46,76,20,-21,41,42,42
40,lgt605d.map,74,103,5101,49,48,24,54,2695,26,85,47,17,23,37,60,61,61
41,lgt605d.map,74,103,504,4,10,69,92,2138,20,24,53,78,-16,14,30,31,31
42,lgt605d.map,74,103,1932,18,24,55,78,2951,28,35,45,67,-10,11,21,22,22
43,lgt605d.map,74,103,2530,24,44,49,58,5197,50,55,23,47,-26,11,37,38,38
44,lgt605d.map,74,103,5505,53,56,20,46,6636,64,58,9,44,-11,2,13,14,14
45,lgt605d.map,74,103,819,7,4,66,98,2092,20,70,53,32,-13,66,79,80,80
46,lgt605d.map,74,103,2380,23,91,50,11,4582,44,52,29,50,-21,-39,60,61,61
47,lgt605d.map,74,103,811,7,12,66,90,3764,36,46,37,56,-29,34,63,64,64
48,lgt605d.map,74,103,6825,66,75,7,27,1123,10,9,63,93,56,-66,122,128,689
49,lgt605d.map,74,103,7445,72,73,1,29,6110,59,69,14,33,13,-4,17,18,18
50,lgt605d.map,74,103,896,8,30,65,72,5714,55,53,18,49,-47,23,70,71,71
51,lgt605d.map,74,103,2852,27,31,46,71,2637,25,40,48,62,2,9,11,12,12
52,lgt605d.map,74,103,1386,13,55,60,47,2645,25,32,48,70,-12,-23,35,36,36
53,lgt605d.map,74,103,4584,44,50,29,52,1733,16,17,57,85,28,-33,61,62,62
54,lgt605d.map,74,103,2061,20,101,53,1,1566,15,81,58,21,5,-20,25,40,26
55,lgt605d.map,74,103,2820,27,63,46,39,4391,42,37,31,65,-15,-26,41,42,42
56,lgt605d.map,74,103,1005,9,24,64,78,6415,62,73,11,29,-53,49,102,609,108
57,lgt605d.map,74,103,2939,28,47,45,55,6837,66,63,7,39,-38,16,54,141,55
58,lgt605d.map,74,103,2506,24,68,49,34,1691,16,59,57,43,8,-9,17,18,18
59,lgt605d.map,74,103,6328,61,57,12,45,7146,69,63,4,39,-8,6,14,15,15
60,lgt605d.map,74,103,3040,29,49,44,53,3350,32,48,41,54,-3,-1,4,5,5
61,lgt605d.map,74,103,3673,35,34,38,68,1430,13,11,60,91,22,-23,45,46,46
62,lgt605d.map,74,103,2337,22,31,51,71,4286,41,39,32,63,-19,8,27,28,28
63,lgt605d.map,74,103,3777,36,33,37,69,2399,23,72,50,30,13,39,52,53,53
64,lgt605d.map,74,103,6729,65,68,8,34,6740,65,57,8,45,0,-11,11,12,12
65,lgt605d.map,74,103,3152,30,40,43,62,2702,26,78,47,24,4,38,42,43,43
66,lgt605d.map,74,103,2478,24,96,49,6,6535,63,56,10,46,-39,-40,79,80,80
67,lgt605d.map,74,103,2490,24,84,49,18,4183,40,39,33,63,-16,-45,61,62,62
68,lgt605d.map,74,103,3139,30,53,43,49,2479,24,95,49,7,6,42,48,49,49
69,lgt605d.map,74,103,2308,22,60,51,42,3149,30,43,43,59,-8,-17,25,26,26
70,lgt605d.map,74,103,1924,18,32,55,70,807,7,16,66,86,11,-16,27,28,28
71,lgt605d.map,74,103,904,8,22,65,80,3148,30,44,43,58,-22,22,44,45,45
72,lgt605d.map,74,103,3875,37,38,36,64,303,2,5,71,97,35,-33,68,69,69
73,lgt605d.map,74,103,1529,14,15,59,87,2933,28,53,45,49,-14,38,52,53,53
74,lgt605d.map,74,103,1696,16,54,57,48,1807,17,46,56,56,-1,-8,9,10,10
75,lgt605d.map,74,103,3557,34,47,39,55,6631,64,63,9,39,-30,16,46,103,47
76,lgt605d.map,74,103,3864,37,49,36,53,2010,19,49,54,53,18,0,18,19,19
77,lgt605d.map,74,103,6114,59,65,14,37,6838,66,62,7,40,-7,-3,10,11,11
78,lgt605d.map,74,103,1632,15,15,58,87,4599,44,35,29,67,-29,20,49,50,50
79,lgt605d.map,74,103,3138,30,54,43,48,4583,44,51,29,51,-14,-3,17,18,18
80,lgt605d.map,74,103,3328,32,70,41,32,1120,10,12,63,90,22,-58,80,81,81
81,lgt605d.map,74,103,5916,57,57,16,45,1822,17,31,56,71,40,-26,66,67,67
82,lgt605d.map,74,103,1680,16,70,57,32,1866,18,90,55,12,-2,20,22,23,23
83,lgt605d.map,74,103,2755,26,25,47,77,4083,39,36,34,66,-13,11,24,25,25
84,lgt605d.map,74,103,2201,21,64,52,38,3564,34,40,39,62,-13,-24,37,38,38
85,lgt605d.map,74,103,5296,51,59,22,43,3443,33,58,40,44,18,-1,19,20,33
86,lgt605d.map,74,103,1477,14,67,59,35,1655,16,95,57,7,-2,28,30,76,33
87,lgt605d.map,74,103,4379,42,49,31,53,4591,44,43,29,59,-2,-6,8,9,9
88,lgt605d.map,74,103,2346,22,22,51,80,2171,21,94,52,8,1,72,73,74,74
89,lgt605d.map,74,103,3008,29,81,44,21,2292,22,76,51,26,7,-5,12,13,13
90,lgt605d.map,74,103,2757,26,23,47,79,3646,35,61,38,41,-9,38,47,48,48
91,lgt605d.map,74,103,3228,31,67,42,35,6830,66,70,7,32,-35,3,38,362,296
92,lgt605d.map,74,103,2650,25,27,48,75,2647,25,30,48,72,0,3,3,4,4
93,lgt605d.map,74,103,1761,17,92,56,10,1181,11,54,62,48,6,-38,44,45,45
94,lgt605d.map,74,103,1635,15,12,58,90,3230,31,65,42,37,-16,53,69,70,70
95,lgt605d.map,74,103,3112,30,80,43,22,1458,14,86,59,16,16,6,22,23,23
96,lgt605d.map,74,103,504,4,10,69,92,2390,23,81,50,21,-19,71,90,91,91
97,lgt605d.map,74,103,2611,25,66,48,36,1549,15,98,58,4,10,32,42,95,43
98,lgt605d.map,74,103,7034,68,72,5,30,6735,65,62,8,40,3,-10,13,14,14
99,lgt605d.map,74,103,2953,28,33,45,69,2438,23,33,50,69,5,0,5,6,6
0,orz000d.map,137,41,2515,61,26,75,14,2652,64,12,72,28,-3,-14,17,18,18
1,orz000d.map,137,41,2298,56,38,80,2,3637,88,11,48,29,-32,-27,59,60,60
2,orz000d.map,137,41,1752,42,10,94,30,2859,69,10,67,30,-27,0,27,28,28
3,orz000d.map,137,41,4361,106,25,30,15,1358,33,35,103,5,73,10,83,84,84
4,orz000d.map,137,41,1288,31,23,105,17,5007,122,35,14,5,-91,12,103,1702,153
5,orz000d.map,137,41,4161,101,20,35,20,4051,98,7,38,33,3,-13,16,17,17
6,orz000d.map,137,41,1970,48,38,88,2,429,10,21,126,19,38,-17,55,56,110
7,orz000d.map,137,41,2496,60,4,76,36,3594,87,13,49,27,-27,9,36,37,37
8,orz000d.map,137,41,5179,126,27,10,13,1765,43,38,93,2,83,11,94,95,95
9,orz000d.map,137,41,5130,125,35,11,5,2430,59,29,77,11,66,-6,72,132,757
10,orz000d.map,137,41,1750,42,12,94,28,1414,34,20,102,20,8,8,16,17,17
11,orz000d.map,137,41,2816,68,12,68,28,4728,115,27,21,13,-47,15,62,63,78
12,orz000d.map,137,41,4097,99,2,37,38,2602,63,21,73,19,36,19,55,56,56
13,orz000d.map,137,41,2716,66,30,70,10,2031,49,18,87,22,17,-12,29,30,30
14,orz000d.map,137,41,4116,100,24,36,16,1983,48,25,88,15,52,1,53,54,54
15,orz000d.map,137,41,1653,40,27,96,13,4582,111,9,25,31,-71,-18,89,90,90
16,orz000d.map,137,41,2962,72,30,64,10,1910,46,16,90,24,26,-14,40,49,41
17,orz000d.map,137,41,3579,87,28,49,12,3245,79,34,57,6,8,6,14,15,15
18,orz000d.map,137,41,850,20,10,116,30,4247,103,16,33,24,-83,6,89,92,90
19,orz000d.map,137,41,955,23,28,113,12,2940,71,11,65,29,-48,-17,65,66,90
20,orz000d.map,137,41,2482,60,18,76,22,4519,110,31,26,9,-50,13,63,64,64
21,orz000d.map,137,41,3714,90,16,46,24,1341,32,11,104,29,58,-5,63,64,64
22,orz000d.map,137,41,4320,105,25,31,15,4740,115,15,21,25,-10,-10,20,43,24
23,orz000d.map,137,41,2308,56,28,80,12,295,7,32,129,8,49,4,53,209,74
24,orz000d.map,137,41,153,3,10,133,30,1482,36,34,100,6,-33,24,57,111,73
25,orz000d.map,137,41,632,15,23,121,17,3382,82,20,54,20,-67,-3,70,205,315
26,orz000d.map,137,41,3528,86,38,50,2,3780,92,32,44,8,-6,-6,12,13,13
27,orz000d.map,137,41,568,13,5,123,35,3610,88,38,48,2,-75,33,108,197,2482
28,orz000d.map,137,41,427,10,23,126,17,5030,122,12,14,28,-112,-11,123,127,124
29,orz000d.map,137,41,3955,96,21,40,19,695,16,1,120,39,80,-20,100,1882,405
30,orz000d.map,137,41,3323,81,38,55,2,1924,46,2,90,38,35,-36,71,88,72
31,orz000d.map,137,41,2100,51,31,85,9,2526,61,15,75,25,-10,-16,26,27,27
32,orz000d.map,137,41,2325,56,11,80,29,3919,95,16,41,24,-39,5,44,45,45
33,orz000d.map,137,41,2027,49,22,87,18,1860,45,25,91,15,4,3,7,8,8
34,orz000d.map,137,41,5239,127,8,9,32,1583,38,15,98,25,89,7,96,103,503
35,orz000d.map,137,41,1496,36,20,100,20,183,4,21,132,19,32,1,33,131,182
36,orz000d.map,137,41,1318,32,34,104,6,566,13,7,123,33,19,-27,46,449,97
37,orz000d.map,137,41,4275,104,29,32,11,2133,52,39,84,1,52,10,62,63,63
38,orz000d.map,137,41,3640,88,8,48,32,3604,87,3,49,37,1,-5,6,7,7
39,orz000d.map,137,41,5236,127,11,9,29,1277,31,34,105,6,96,23,119,120,303
40,orz000d.map,137,41,1643,40,37,96,3,2596,63,27,73,13,-23,-10,33,34,34
41,orz000d.map,137,41,3533,86,33,50,7,5389,131,22,5,18,-45,-11,56,142,57
42,orz000d.map,137,41,3643,88,5,48,35,4231,103,32,33,8,-15,27,42,43,43
43,orz000d.map,137,41,4418,107,9,29,31,3957,96,19,40,21,11,10,21,22,22
44,orz000d.map,137,41,2570,62,12,74,28,3622,88,26,48,14,-26,14,40,41,41
45,orz000d.map,137,41,3579,87,28,49,12,1327,32,25,104,15,55,-3,58,59,59
46,orz000d.map,137,41,313,7,14,129,26,1979,48,29,88,11,-41,15,56,68,57
47,orz000d.map,137,41,4746,115,9,21,31,4203,102,19,34,21,13,10,23,24,24
48,orz000d.map,137,41,276,6,10,130,30,3535,86,31,50,9,-80,21,101,124,102
49,orz000d.map,137,41,3696,90,34,46,6,4783,116,13,20,27,-26,-21,47,48,74
50,orz000d.map,137,41,3292,80,28,56,12,831,20,29,116,11,60,1,61,62,62
51,orz000d.map,137,41,3395,82,7,54,33,351,8,17,128,23,74,10,84,85,114
52,orz000d.map,137,41,2012,49,37,87,3,1831,44,13,92,27,5,-24,29,75,30
53,orz000d.map,137,41,3692,90,38,46,2,3775,92,37,44,3,-2,-1,3,4,4
54,orz000d.map,137,41,3719,90,11,46,29,3167,77,30,59,10,13,19,32,33,33
55,orz000d.map,137,41,4942,120,18,16,22,3159,77,38,59,2,43,20,63,64,289
56,orz000d.map,137,41,3456,84,28,52,12,3672,89,17,47,23,-5,-11,16,17,17
57,orz000d.map,137,41,3971,96,5,40,35,3475,84,9,52,31,12,4,16,17,17
58,orz000d.map,137,41,2585,63,38,73,2,2975,72,17,64,23,-9,-21,30,31,31
59,orz000d.map,137,41,2286,55,9,81,31,5599,136,17,0,23,-81,8,89,251,90
60,orz000d.map,137,41,420,10,30,126,10,2975,72,17,64,23,-62,-13,75,142,76
61,orz000d.map,137,41,3490,85,35,51,5,834,20,26,116,14,65,-9,74,75,78
62,orz000d.map,137,41,1948,47,19,89,21,3023,73,10,63,30,-26,-9,35,36,36
63,orz000d.map,137,41,2064,50,26,86,14,413,10,37,126,3,40,11,51,52,52
64,orz000d.map,137,41,2466,60,34,76,6,3926,95,9,41,31,-35,-25,60,61,61
65,orz000d.map,137,41,2962,72,30,64,10,1454,35,21,101,19,37,-9,46,47,47
66,orz000d.map,137,41,4396,107,31,29,9,1479,36,37,100,3,71,6,77,78,78
67,orz000d.map,137,41,4234,103,29,33,11,4231,103,32,33,8,0,3,3,4,4
68,orz000d.map,137,41,2053,50,37,86,3,5239,127,8,9,32,-77,-29,106,453,113
69,orz000d.map,137,41,1370,33,23,103,17,1716,41,5,95,35,-8,-18,26,27,27
70,orz000d.map,137,41,4866,118,12,18,28,5172,126,34,10,6,-8,22,30,133,58
71,orz000d.map,137,41,2625,64,39,72,1,1289,31,22,105,18,33,-17,50,51,51
72,orz000d.map,137,41,5026,122,16,14,24,1610,39,29,97,11,83,13,96,97,714
73,orz000d.map,137,41,2477,60,23,76,17,1478,36,38,100,2,24,15,39,40,40
74,orz000d.map,137,41,4483,109,26,27,14,4884,119,35,17,5,-10,9,19,211,73
75,orz000d.map,137,41,1851,45,34,91,6,2636,64,28,72,12,-19,-6,25,26,26
76,orz000d.map,137,41,2473,60,27,76,13,2756,67,31,69,9,-7,4,11,12,12
77,orz000d.map,137,41,5313,129,16,7,24,3324,81,37,55,3,48,21,69,70,317
78,orz000d.map,137,41,1796,43,7,93,33,3182,77,15,59,25,-34,8,42,43,43
79,orz000d.map,137,41,1659,40,21,96,19,1526,37,31,99,9,3,10,13,14,14
80,orz000d.map,137,41,547,13,26,123,14,4479,109,30,27,10,-96,4,100,101,101
81,orz000d.map,137,41,3298,80,22,56,18,1595,38,3,98,37,42,-19,61,62,178
82,orz000d.map,137,41,4539,110,11,26,29,470,11,21,125,19,99,10,109,110,113
83,orz000d.map,137,41,5275,128,13,8,27,4135,100,5,36,35,28,-8,36,37,37
84,orz000d.map,137,41,2316,56,20,80,20,5468,133,25,3,15,-77,5,82,215,160
85,orz000d.map,137,41,1941,47,26,89,14,559,13,14,123,26,34,-12,46,47,47
86,orz000d.map,137,41,2163,52,9,84,31,3694,90,36,46,4,-38,27,65,66,66
87,orz000d.map,137,41,4745,115,10,21,30,842,20,18,116,22,95,8,103,109,104
88,orz000d.map,137,41,3458,84,26,52,14,2773,67,14,69,26,17,-12,29,46,30
89,orz000d.map,137,41,4133,100,7,36,33,5399,131,12,5,28,-31,5,36,114,80
90,orz000d.map,137,41,4256,103,7,33,33,3111,75,4,61,36,28,-3,31,32,32
91,orz000d.map,137,41,352,8,16,128,24,1415,34,19,102,21,-26,3,29,89,64
92,orz000d.map,137,41,274,6,12,130,28,2303,56,33,80,7,-50,21,71,110,72
93,orz000d.map,137,41,315,7,12,129,28,2260,55,35,81,5,-48,23,71,124,72
94,orz000d.map,137,41,2841,69,28,67,12,1547,37,10,99,30,32,-18,50,51,51
95,orz000d.map,137,41,2169,52,3,84,37,4622,112,10,24,30,-60,7,67,68,68
96,orz000d.map,137,41,1530,37,27,99,13,2643,64,21,72,19,-27,-6,33,44,34
97,orz000d.map,137,41,4237,103,26,33,14,4398,107,29,29,11,-4,3,7,8,8
98,orz000d.map,137,41,2740,66,6,70,34,2981,72,11,64,29,-6,5,11,12,12
99,orz000d.map,137,41,2440,59,19,77,21,2490,60,10,76,30,-1,-9,10,11,11
0,orz100d.map,394,410,94758,231,361,162,48,94510,230,199,163,210,1,-162,163,14130,5534
1,orz100d.map,394,410,122363,298,226,95,183,111774,272,155,121,254,26,-71,97,42592,37030
2,orz100d.map,394,410,4411,10,98,383,311,28077,68,212,325,197,-58,114,172,173,173
3,orz100d.map,394,410,121313,295,46,98,363,66938,163,301,230,108,132,255,387,12154,24387
4,orz100d.map,394,410,42936,104,113,289,296,79775,194,174,199,235,-90,61,151,2410,3503
5,orz100d.map,394,410,37145,90,164,303,245,93679,228,210,165,199,-138,46,184,11330,4515
6,orz100d.map,394,410,152455,371,64,22,345,152767,372,162,21,247,-1,98,99,229,451
7,orz100d.map,394,410,133685,326,384,67,25,83198,202,31,191,378,124,-353,477,53746,21445
8,orz100d.map,394,410,132896,324,353,69,56,33900,82,129,311,280,242,-224,466,49164,35458
9,orz100d.map,394,410,160076,390,233,3,176,158365,386,304,7,105,4,71,75,76,76
10,orz100d.map,394,410,8496,20,113,373,296,68757,167,122,226,287,-147,9,156,3614,3686
11,orz100d.map,394,410,82768,201,51,192,358,86182,210,327,183,82,-9,276,285,20036,19411
12,orz100d.map,394,410,131145,319,54,74,355,50261,122,168,271,241,197,114,311,54721,59654
13,orz100d.map,394,410,117946,287,133,106,276,71477,174,272,219,137,113,139,252,9184,2583
14,orz100d.map,394,410,36706,89,193,304,216,40925,99,74,294,335,-10,-119,129,855,1877
15,orz100d.map,394,410,107962,263,277,130,132,64485,157,294,236,115,106,17,123,1474,1861
16,orz100d.map,394,410,156822,382,207,11,202,17855,43,184,350,225,339,-23,362,61527,54154
17,orz100d.map,394,410,101741,248,348,145,61,114838,280,371,113,38,-32,23,55,56,56
18,orz100d.map,394,410,135981,331,138,62,271,105574,257,205,136,204,74,67,141,41991,32008
19,orz100d.map,394,410,43356,105,103,288,306,38837,94,112,299,297,11,9,20,21,21
20,orz100d.map,394,410,15739,38,250,355,159,33148,80,61,313,348,-42,-189,231,232,232
21,orz100d.map,394,410,66275,161,144,232,265,14172,34,177,359,232,127,33,160,5527,3644
22,orz100d.map,394,410,60005,146,264,247,145,128510,313,229,80,180,-167,-35,202,15412,39079
23,orz100d.map,394,410,34296,83,143,310,266,64654,157,125,236,284,-74,-18,92,93,93
24,orz100d.map,394,410,80072,195,287,198,122,13752,33,187,360,222,162,-100,262,23922,37112
25,orz100d.map,394,410,96275,234,74,159,335,150135,366,334,27,75,-132,260,392,30735,49592
26,orz100d.map,394,410,159634,389,265,4,144,148173,361,246,32,163,28,-19,47,69,49
27,orz100d.map,394,410,57875,141,344,252,65,124755,304,294,89,115,-163,-50,213,927,324
28,orz100d.map,394,410,8928,21,91,372,318,44005,107,274,286,135,-86,183,269,38271,7972
29,orz100d.map,394,410,74080,180,129,213,280,31375,76,194,317,215,104,65,169,3916,411
30,orz100d.map,394,410,124298,303,341,90,68,110083,268,206,125,203,35,-135,170,37292,14654
31,orz100d.map,394,410,15512,37,67,356,342,153138,373,201,20,208,-336,134,470,54259,54918
32,orz100d.map,394,410,105720,257,59,136,350,150953,368,336,25,73,-111,277,388,28435,45888
33,orz100d.map,394,410,122907,299,92,94,317,156764,382,265,11,144,-83,173,256,861,1921
34,orz100d.map,394,410,152154,371,365,22,44,66356,161,63,232,346,210,-302,512,56485,24516
35,orz100d.map,394,410,153539,374,210,19,199,119543,291,176,102,233,83,-34,117,128,528
36,orz100d.map,394,410,41585,101,234,292,175,146100,356,269,37,140,-255,35,290,48997,56121
37,orz100d.map,394,410,88418,215,141,178,268,61762,150,147,243,262,65,6,71,72,72
38,orz100d.map,394,410,97220,237,359,156,50,117909,287,170,106,239,-50,-189,239,8948,2616
39,orz100d.map,394,410,143794,350,115,43,294,69533,169,166,224,243,181,51,232,53913,60774
40,orz100d.map,394,410,112282,273,57,120,352,85503,208,186,185,223,65,129,194,13716,4904
41,orz100d.map,394,410,31002,75,157,318,252,121139,295,220,98,189,-220,63,283,57985,66780
42,orz100d.map,394,410,21161,51,158,342,251,81522,198,67,195,342,-147,-91,238,23489,11748
43,orz100d.map,394,410,157329,383,110,10,299,128206,312,123,81,286,71,13,84,2595,1840
44,orz100d.map,394,410,132507,323,332,70,77,81540,198,49,195,360,125,-283,408,53775,25284
45,orz100d.map,394,410,105088,256,281,137,128,99597,242,32,151,377,14,-249,263,18923,8508
46,orz100d.map,394,410,113064,275,95,118,314,90835,221,184,172,225,54,89,143,11052,7506
47,orz100d.map,394,410,122632,299,367,94,42,61353,149,146,244,263,150,-221,371,45236,27904
48,orz100d.map,394,410,95240,232,289,161,120,145477,354,72,39,337,-122,-217,339,1035,4148
49,orz100d.map,394,410,36802,89,97,304,312,64618,157,161,236,248,-68,64,132,5061,7791
50,orz100d.map,394,410,155946,380,263,13,146,140725,343,314,50,95,37,51,88,145,118
51,orz100d.map,394,410,83247,203,392,190,17,10031,24,218,369,191,179,-174,353,43296,47133
52,orz100d.map,394,410,104300,254,249,139,160,14277,34,72,359,337,220,-177,397,8387,40343
53,orz100d.map,394,410,4875,11,44,382,365,35575,86,94,307,315,-75,50,125,126,126
54,orz100d.map,394,410,3828,9,271,384,138,44839,109,260,284,149,-100,-11,111,36804,17001
55,orz100d.map,394,410,25986,63,253,330,156,153658,374,91,19,318,-311,-162,473,67111,58530
56,orz100d.map,394,410,36297,88,192,305,217,30113,73,226,320,183,15,34,49,50,50
57,orz100d.map,394,410,133936,326,133,67,276,151515,369,184,24,225,-43,51,94,1063,5179
58,orz100d.map,394,410,12138,29,161,364,248,29751,72,178,321,231,-43,17,60,61,61
59,orz100d.map,394,410,90827,221,192,172,217,141943,346,326,47,83,-125,134,259,33378,58982
60,orz100d.map,394,410,108546,264,103,129,306,17582,42,47,351,362,222,-56,278,3721,6054
61,orz100d.map,394,410,20366,49,133,344,276,104206,254,343,139,66,-205,210,415,47953,58535
62,orz100d.map,394,410,30929,75,230,318,179,52636,128,253,265,156,-53,23,76,34659,13682
63,orz100d.map,394,410,137989,336,180,57,229,129238,315,321,78,88,21,141,162,2002,1173
64,orz100d.map,394,410,104576,255,383,138,26,155117,378,272,15,137,-123,-111,234,1063,1600
65,orz100d.map,394,410,51985,126,84,267,325,139459,340,350,53,59,-214,266,480,44189,53970
66,orz100d.map,394,410,32722,79,77,314,332,86311,210,198,183,211,-131,121,252,7052,8855
67,orz100d.map,394,410,37160,90,149,303,260,136241,332,288,61,121,-242,139,381,37220,48997
68,orz100d.map,394,410,136072,331,47,62,362,96320,234,29,159,380,97,-18,115,1402,755
69,orz100d.map,394,410,143784,350,125,43,284,102506,250,403,143,6,100,278,378,8654,13216
70,orz100d.map,394,410,144099,351,220,42,189,34263,83,176,310,233,268,-44,312,55660,51782
71,orz100d.map,394,410,22849,55,110,338,299,97332,237,247,156,162,-182,137,319,35641,17531
72,orz100d.map,394,410,155553,379,246,14,163,32158,78,231,315,178,301,-15,316,58474,51399
73,orz100d.map,394,410,8496,20,113,373,296,14261,34,88,359,321,-14,-25,39,40,40
74,orz100d.map,394,410,146554,357,225,36,184,136324,332,205,61,204,25,-20,45,304,353
75,orz100d.map,394,410,132794,323,45,70,364,132173,322,256,71,153,1,211,212,5066,3024
76,orz100d.map,394,410,7171,17,208,376,201,155980,380,229,13,180,-363,21,384,53323,58531
77,orz100d.map,394,410,94376,230,333,163,76,152249,371,270,22,139,-141,-63,204,1892,252
78,orz100d.map,394,410,11802,28,87,365,322,3575,8,114,385,295,20,27,47,48,48
79,orz100d.map,394,410,62828,153,311,240,98,13773,33,166,360,243,120,-145,265,34706,43229
80,orz100d.map,394,410,34363,83,76,310,333,3028,7,251,386,158,76,175,251,256,252
81,orz100d.map,394,410,150306,366,163,27,246,153566,374,183,19,226,-8,20,28,29,29
82,orz100d.map,394,410,35776,87,303,306,106,42842,104,207,289,202,-17,-96,113,11012,35316
83,orz100d.map,394,410,12892,31,227,362,182,144909,353,230,40,179,-322,3,325,53193,58536
84,orz100d.map,394,410,102068,248,21,145,388,128631,313,108,80,301,-65,87,152,446,1666
85,orz100d.map,394,410,27402,66,67,327,342,139028,339,371,54,38,-273,304,577,49192,55980
86,orz100d.map,394,410,144987,353,152,40,257,6116,14,33,379,376,339,-119,458,54399,59544
87,orz100d.map,394,410,18219,44,230,349,179,58476,142,153,251,256,-98,-77,175,4913,2413
88,orz100d.map,394,410,39969,97,210,296,199,147852,360,157,33,252,-263,-53,316,53843,57671
89,orz100d.map,394,410,142148,346,121,47,288,97413,237,166,156,243,109,45,154,58646,62063
90,orz100d.map,394,410,41609,101,210,292,199,4754,11,165,382,244,90,-45,135,136,136
91,orz100d.map,394,410,150952,368,337,25,72,72451,176,118,217,291,192,-219,411,51210,36626
92,orz100d.map,394,410,102408,249,91,144,318,109894,268,395,125,14,-19,304,323,18314,33059
93,orz100d.map,394,410,75515,184,334,209,75,158831,387,248,6,161,-203,-86,289,1174,352
94,orz100d.map,394,410,93977,229,322,164,87,32158,78,231,315,178,151,-91,242,43985,40722
95,orz100d.map,394,410,84733,206,136,187,273,127734,311,185,82,224,-105,49,154,47649,46687
96,orz100d.map,394,410,114432,279,367,114,42,48258,117,121,276,288,162,-246,408,41784,32996
97,orz100d.map,394,410,23120,56,249,337,160,96181,234,168,159,241,-178,-81,259,962,1449
98,orz100d.map,394,410,82772,201,47,192,362,9766,23,73,370,336,178,26,204,4239,15499
99,orz100d.map,394,410,63901,155,58,238,351,65463,159,136,234,273,-4,78,82,2419,8857
0,orz101d.map,83,42,56,1,27,81,14,1950,46,23,36,18,-45,-4,49,50,50
1,orz101d.map,83,42,2136,50,5,32,36,3437,81,6,1,35,-31,1,32,85,77
2,orz101d.map,83,42,3172,75,19,7,22,1645,39,34,43,7,36,15,51,338,265
3,orz101d.map,83,42,861,20,20,62,21,3095,73,12,9,29,-53,-8,61,118,62
4,orz101d.map,83,42,2797,66,16,16,25,1895,45,36,37,5,21,20,41,58,329
5,orz101d.map,83,42,2235,53,32,29,9,1947,46,26,36,15,7,-6,13,14,14
6,orz101d.map,83,42,1136,27,39,55,2,2995,71,28,11,13,-44,-11,55,174,57
7,orz101d.map,83,42,3411,81,32,1,9,2755,65,16,17,25,16,-16,32,76,33
8,orz101d.map,83,42,2571,61,32,21,9,403,9,16,73,25,52,-16,68,69,178
9,orz101d.map,83,42,3320,79,39,3,2,2006,47,9,35,32,32,-30,62,63,108
10,orz101d.map,83,42,989,23,18,59,23,1982,47,33,35,8,-24,15,39,126,40
11,orz101d.map,83,42,1403,33,24,49,17,3203,76,30,6,11,-43,6,49,78,50
12,orz101d.map,83,42,1656,39,23,43,18,816,19,23,63,18,20,0,20,21,21
13,orz101d.map,83,42,2804,66,9,16,32,317,7,18,75,23,59,9,68,323,165
14,orz101d.map,83,42,1641,39,38,43,3,866,20,15,62,26,19,-23,42,58,43
15,orz101d.map,83,42,2957,70,24,12,17,1959,46,14,36,27,24,-10,34,39,105
16,orz101d.map,83,42,2720,64,9,18,32,3034,72,31,10,10,-8,22,30,31,75
17,orz101d.map,83,42,2798,66,15,16,26,1375,32,10,50,31,34,-5,39,131,68
18,orz101d.map,83,42,2172,51,11,31,30,3207,76,26,6,15,-25,15,40,65,58
19,orz101d.map,83,42,2072,49,27,33,14,2341,55,10,27,31,-6,-17,23,24,24
20,orz101d.map,83,42,3393,80,8,2,33,2175,51,8,31,33,29,0,29,32,36
21,orz101d.map,83,42,814,19,25,63,16,3310,78,7,4,34,-59,-18,77,174,132
22,orz101d.map,83,42,1253,29,6,53,35,982,23,25,59,16,6,19,25,147,567
23,orz101d.map,83,42,3261,77,14,5,27,3166,75,25,7,16,2,11,13,40,30
24,orz101d.map,83,42,2219,52,6,30,35,1443,34,26,48,15,18,20,38,73,51
25,orz101d.map,83,42,2345,55,6,27,35,1700,40,21,42,20,15,15,30,42,33
26,orz101d.map,83,42,3136,74,13,8,28,1920,45,11,37,30,29,-2,31,32,32
27,orz101d.map,83,42,3216,76,17,6,24,2469,58,8,24,33,18,-9,27,28,28
28,orz101d.map,83,42,1640,39,39,43,2,3303,78,14,4,27,-39,-25,64,74,114
29,orz101d.map,83,42,2073,49,26,33,15,1627,38,10,44,31,11,-16,27,147,37
30,orz101d.map,83,42,2633,62,12,20,29,2882,68,15,14,26,-6,3,9,10,10
31,orz101d.map,83,42,861,20,20,62,21,1669,39,10,43,31,-19,-10,29,280,135
32,orz101d.map,83,42,2929,69,10,13,31,2163,51,20,31,21,18,10,28,29,29
33,orz101d.map,83,42,521,12,24,70,17,1563,37,32,45,9,-25,8,33,53,36
34,orz101d.map,83,42,1561,37,34,45,7,2276,54,33,28,8,-17,-1,18,41,71
35,orz101d.map,83,42,2804,66,9,16,32,1599,38,38,44,3,28,29,57,74,62
36,orz101d.map,83,42,3305,78,12,4,29,2084,49,15,33,26,29,3,32,33,33
37,orz101d.map,83,42,2993,71,30,11,11,271,6,22,76,19,65,-8,73,74,171
38,orz101d.map,83,42,1417,33,10,49,31,1639,39,40,43,1,-6,30,36,151,411
39,orz101d.map,83,42,2882,68,15,14,26,1667,39,12,43,29,29,-3,32,176,52
40,orz101d.map,83,42,273,6,20,76,21,3265,77,10,5,31,-71,-10,81,210,82
41,orz101d.map,83,42,2552,60,9,22,32,1611,38,26,44,15,22,17,39,56,44
42,orz101d.map,83,42,3115,74,34,8,7,1189,28,28,54,13,46,-6,52,249,169
43,orz101d.map,83,42,3370,80,31,2,10,3365,80,36,2,5,0,5,5,6,6
44,orz101d.map,83,42,1696,40,25,42,16,1567,37,28,45,13,3,3,6,7,7
45,orz101d.map,83,42,857,20,24,62,17,730,17,25,65,16,3,1,4,5,5
46,orz101d.map,83,42,1303,31,40,51,1,1359,32,26,50,15,-1,-14,15,16,16
47,orz101d.map,83,42,1560,37,35,45,6,1312,31,31,51,10,6,-4,10,11,17
48,orz101d.map,83,42,1528,36,25,46,16,1902,45,29,37,12,-9,4,13,26,14
49,orz101d.map,83,42,3009,71,14,11,27,3075,73,32,9,9,-2,18,20,21,21
50,orz101d.map,83,42,3282,78,35,4,6,3287,78,30,4,11,0,-5,5,6,6
51,orz101d.map,83,42,1168,27,7,55,34,2745,65,26,17,15,-38,19,57,480,432
52,orz101d.map,83,42,2089,49,10,33,31,1963,46,10,36,31,3,0,3,4,4
53,orz101d.map,83,42,2201,52,24,30,17,1959,46,14,36,27,6,-10,16,17,17
54,orz101d.map,83,42,1389,33,38,49,3,191,4,18,78,23,29,-20,49,65,101
55,orz101d.map,83,42,1921,45,10,37,31,650,15,21,67,20,30,11,41,42,124
56,orz101d.map,83,42,2842,67,13,15,28,1559,37,36,45,5,30,23,53,54,60
57,orz101d.map,83,42,2837,67,18,15,23,1157,27,18,55,23,40,0,40,147,210
58,orz101d.map,83,42,1341,31,2,51,39,3239,77,36,5,5,-46,34,80,146,831
59,orz101d.map,83,42,1315,31,28,51,13,3053,72,12,10,29,-41,-16,57,76,58
60,orz101d.map,83,42,2587,61,16,21,25,949,22,16,60,25,39,0,39,154,180
61,orz101d.map,83,42,2260,53,7,29,34,2303,54,6,28,35,-1,-1,2,3,3
62,orz101d.map,83,42,2386,56,7,26,34,823,19,16,63,25,37,9,46,303,102
63,orz101d.map,83,42,3184,75,7,7,34,1356,32,29,50,12,43,22,65,103,116
64,orz101d.map,83,42,2787,66,26,16,15,1862,44,27,38,14,22,1,23,54,78
65,orz101d.map,83,42,1400,33,27,49,14,1945,46,28,36,13,-13,1,14,23,19
66,orz101d.map,83,42,3216,76,17,6,24,3236,77,39,5,2,-1,22,23,45,109
67,orz101d.map,83,42,2153,51,30,31,11,2615,62,30,20,11,-11,0,11,12,12
68,orz101d.map,83,42,1360,32,25,50,16,1859,44,30,38,11,-12,5,17,50,18
69,orz101d.map,83,42,824,19,15,63,26,1306,31,37,51,4,-12,22,34,37,49
70,orz101d.map,83,42,1218,29,41,53,0,2486,59,33,23,8,-30,-8,38,73,39
71,orz101d.map,83,42,1265,30,36,52,5,1479,35,32,47,9,-5,-4,9,10,10
72,orz101d.map,83,42,859,20,22,62,19,3243,77,32,5,9,-57,10,67,146,68
73,orz101d.map,83,42,3454,82,31,0,10,2870,68,27,14,14,14,-4,18,19,19
74,orz101d.map,83,42,2402,57,33,25,8,2118,50,23,32,18,7,-10,17,18,18
75,orz101d.map,83,42,2361,56,32,26,9,2301,54,8,28,33,2,-24,26,45,63
76,orz101d.map,83,42,1301,30,0,52,41,1991,47,24,35,17,-17,24,41,74,184
77,orz101d.map,83,42,1194,28,23,54,18,1143,27,32,55,9,1,9,10,18,11
78,orz101d.map,83,42,1810,43,37,39,4,779,18,18,64,23,25,-19,44,59,50
79,orz101d.map,83,42,857,20,24,62,17,991,23,16,59,25,-3,-8,11,12,12
80,orz101d.map,83,42,1560,37,35,45,6,1313,31,30,51,11,6,-5,11,12,18
81,orz101d.map,83,42,905,21,18,61,23,1401,33,26,49,15,-12,8,20,21,21
82,orz101d.map,83,42,2970,70,11,12,30,1407,33,20,49,21,37,9,46,47,61
83,orz101d.map,83,42,1736,41,27,41,14,3177,75,14,7,27,-34,-13,47,48,48
84,orz101d.map,83,42,1957,46,16,36,25,398,9,21,73,20,37,5,42,43,137
85,orz101d.map,83,42,3224,76,9,6,32,1823,43,24,39,17,33,15,48,51,49
86,orz101d.map,83,42,233,5,18,77,23,3075,73,32,9,9,-68,14,82,208,83
87,orz101d.map,83,42,2826,67,29,15,12,68,1,15,81,26,66,-14,80,112,585
88,orz101d.map,83,42,436,10,25,72,16,2702,64,27,18,14,-54,2,56,316,157
89,orz101d.map,83,42,193,4,16,78,25,1404,33,23,49,18,-29,7,36,37,37
90,orz101d.map,83,42,153,3,14,79,27,2211,52,14,30,27,-49,0,49,173,215
91,orz101d.map,83,42,1865,44,24,38,17,2717,64,12,18,29,-20,-12,32,33,33
92,orz101d.map,83,42,2514,59,5,23,36,1524,36,29,46,12,23,24,47,75,58
93,orz101d.map,83,42,1129,26,4,56,37,190,4,19,78,22,22,15,37,162,601
94,orz101d.map,83,42,2129,50,12,32,29,3054,72,11,10,30,-22,-1,23,24,24
95,orz101d.map,83,42,234,5,17,77,24,989,23,18,59,23,-18,1,19,20,20
96,orz101d.map,83,42,2613,62,32,20,9,1951,46,22,36,19,16,-10,26,27,27
97,orz101d.map,83,42,2203,52,22,30,19,773,18,24,64,17,34,2,36,37,37
98,orz101d.map,83,42,3273,77,2,5,39,687,16,26,66,15,61,24,85,140,242
99,orz101d.map,83,42,1737,41,26,41,15,2490,59,29,23,12,-18,3,21,49,24
0,orz102d.map,44,39,889,22,7,21,31,513,13,32,30,6,9,25,34,43,35
1,orz102d.map,44,39,1259,32,27,11,11,549,14,35,29,3,18,8,26,27,27
2,orz102d.map,44,39,515,13,30,30,8,995,25,18,18,20,-12,-12,24,25,25
3,orz102d.map,44,39,826,21,31,22,7,699,17,2,26,36,4,-29,33,34,34
4,orz102d.map,44,39,916,23,19,20,19,1020,26,32,17,6,-3,13,16,17,17
5,orz102d.map,44,39,675,17,26,26,12,893,22,3,21,35,-5,-23,28,29,29
6,orz102d.map,44,39,604,15,19,28,19,559,14,25,29,13,1,6,7,8,8
7,orz102d.map,44,39,1369,35,34,8,4,694,17,7,26,31,18,-27,45,46,46
8,orz102d.map,44,39,901,23,34,20,4,535,13,10,30,28,10,-24,34,47,35
9,orz102d.map,44,39,828,21,29,22,9,798,20,20,23,18,1,-9,10,11,11
10,orz102d.map,44,39,481,12,25,31,13,829,21,28,22,10,-9,3,12,13,13
11,orz102d.map,44,39,739,18,1,25,37,926,23,9,20,29,-5,8,13,14,14
12,orz102d.map,44,39,124,3,31,40,7,895,22,1,21,37,-19,-30,49,52,68
13,orz102d.map,44,39,8,0,30,43,8,1258,32,28,11,10,-32,-2,34,35,35
14,orz102d.map,44,39,1251,32,35,11,3,239,6,33,37,5,26,-2,28,206,56
15,orz102d.map,44,39,1568,40,30,3,8,667,17,34,26,4,23,4,27,28,28
16,orz102d.map,44,39,864,22,32,21,6,932,23,3,20,35,-1,-29,30,31,36
17,orz102d.map,44,39,1371,35,32,8,6,607,15,16,28,22,20,-16,36,37,37
18,orz102d.map,44,39,206,5,27,38,11,47,1,30,42,8,4,3,7,8,8
19,orz102d.map,44,39,660,16,2,27,36,655,16,7,27,31,0,5,5,6,6
20,orz102d.map,44,39,1448,37,33,6,5,161,4,33,39,5,33,0,33,242,63
21,orz102d.map,44,39,629,16,33,27,5,911,23,24,20,14,-7,-9,16,17,17
22,orz102d.map,44,39,1601,41,36,2,2,1451,37,30,6,8,4,-6,10,11,11
23,orz102d.map,44,39,1217,31,30,12,8,1291,33,34,10,4,-2,4,6,7,7
24,orz102d.map,44,39,1259,32,27,11,11,653,16,9,27,29,16,-18,34,35,35
25,orz102d.map,44,39,699,17,2,26,36,949,24,25,19,13,-7,23,30,31,31
26,orz102d.map,44,39,900,23,35,20,3,1487,38,33,5,5,-15,-2,17,18,18
27,orz102d.map,44,39,992,25,21,18,17,950,24,24,19,14,1,3,4,5,5
28,orz102d.map,44,39,1489,38,31,5,7,1535,39,24,4,14,-1,-7,8,9,9
29,orz102d.map,44,39,629,16,33,27,5,613,15,10,28,28,1,-23,24,25,25
30,orz102d.map,44,39,945,24,29,19,9,761,19,18,24,20,5,-11,16,17,17
31,orz102d.map,44,39,1256,32,30,11,8,943,24,31,19,7,8,1,9,10,10
32,orz102d.map,44,39,1571,40,27,3,11,1563,40,35,3,3,0,8,8,9,9
33,orz102d.map,44,39,658,16,4,27,34,828,21,29,22,9,-5,25,30,31,31
34,orz102d.map,44,39,47,1,30,42,8,1063,27,28,16,10,-26,-2,28,29,29
35,orz102d.map,44,39,1369,35,34,8,4,595,15,28,28,10,20,-6,26,27,27
36,orz102d.map,44,39,915,23,20,20,18,1292,33,33,10,5,-10,13,23,24,24
37,orz102d.map,44,39,1572,40,26,3,12,670,17,31,26,7,23,5,28,29,29
38,orz102d.map,44,39,784,20,34,23,4,1527,39,32,4,6,-19,-2,21,22,22
39,orz102d.map,44,39,1016,26,36,17,2,906,23,29,20,9,3,-7,10,11,11
40,orz102d.map,44,39,705,18,35,25,3,631,16,31,27,7,2,-4,6,7,7
41,orz102d.map,44,39,816,20,2,23,36,246,6,26,37,12,14,24,38,57,39
42,orz102d.map,44,39,753,19,26,24,12,548,14,36,29,2,5,10,15,16,16
43,orz102d.map,44,39,1610,41,27,2,11,967,24,7,19,31,17,-20,37,38,38
44,orz102d.map,44,39,670,17,31,26,7,551,14,33,29,5,3,2,5,6,6
45,orz102d.map,44,39,641,16,21,27,17,1021,26,31,17,7,-10,10,20,21,21
46,orz102d.map,44,39,976,25,37,18,1,962,24,12,19,26,1,-25,26,27,27
47,orz102d.map,44,39,988,25,25,18,13,1645,42,31,1,7,-17,6,23,24,24
48,orz102d.map,44,39,1290,33,35,10,3,285,7,26,36,12,26,-9,35,36,36
49,orz102d.map,44,39,1573,40,25,3,13,607,15,16,28,22,25,-9,34,46,126
50,orz102d.map,44,39,1412,36,30,7,8,1535,39,24,4,14,-3,-6,9,10,10
51,orz102d.map,44,39,1377,35,26,8,12,563,14,21,29,17,21,-5,26,27,27
52,orz102d.map,44,39,669,17,32,26,6,1094,28,36,15,2,-11,4,15,16,16
53,orz102d.map,44,39,659,16,3,27,35,1452,37,29,6,9,-21,26,47,48,48
54,orz102d.map,44,39,873,22,23,21,15,1405,36,37,7,1,-14,14,28,41,29
55,orz102d.map,44,39,627,16,35,27,3,284,7,27,36,11,9,-8,17,18,18
56,orz102d.map,44,39,891,22,5,21,33,245,6,27,37,11,16,22,38,55,39
57,orz102d.map,44,39,785,20,33,23,5,930,23,5,20,33,-3,-28,31,32,41
58,orz102d.map,44,39,1456,37,25,6,13,980,25,33,18,5,12,8,20,21,25
59,orz102d.map,44,39,1020,26,32,17,6,1340,34,24,9,14,-8,-8,16,22,17
60,orz102d.map,44,39,1646,42,30,1,8,1567,40,31,3,7,2,1,3,4,4
61,orz102d.map,44,39,640,16,22,27,16,777,19,2,24,36,-3,-20,23,24,24
62,orz102d.map,44,39,775,19,4,24,34,495,12,11,31,27,7,7,14,15,15
63,orz102d.map,44,39,482,12,24,31,14,1413,36,29,7,9,-24,5,29,30,30
64,orz102d.map,44,39,563,14,21,29,17,1063,27,28,16,10,-13,7,20,21,21
65,orz102d.map,44,39,793,20,25,23,13,532,13,13,30,25,7,-12,19,23,20
66,orz102d.map,44,39,163,4,31,39,7,1373,35,30,8,8,-31,-1,32,46,111
67,orz102d.map,44,39,976,25,37,18,1,400,10,28,33,10,15,-9,24,25,29
68,orz102d.map,44,39,656,16,6,27,32,925,23,10,20,28,-7,4,11,18,12
69,orz102d.map,44,39,593,15,30,28,8,609,15,14,28,24,0,-16,16,17,17
70,orz102d.map,44,39,473,12,33,31,5,916,23,19,20,19,-11,-14,25,26,26
71,orz102d.map,44,39,1250,32,36,11,2,1563,40,35,3,3,-8,-1,9,10,10
72,orz102d.map,44,39,1099,28,31,15,7,533,13,12,30,26,15,-19,34,44,35
73,orz102d.map,44,39,1369,35,34,8,4,1255,32,31,11,7,3,-3,6,7,7
74,orz102d.map,44,39,627,16,35,27,3,1102,28,28,15,10,-12,-7,19,20,20
75,orz102d.map,44,39,169,4,25,39,13,650,16,12,27,26,-12,-13,25,29,67
76,orz102d.map,44,39,1290,33,35,10,3,854,21,3,22,35,12,-32,44,83,45
77,orz102d.map,44,39,1640,42,36,1,2,200,5,33,38,5,37,-3,40,272,79
78,orz102d.map,44,39,659,16,3,27,35,773,19,6,24,32,-3,3,6,7,7
79,orz102d.map,44,39,556,14,28,29,10,1181,30,27,13,11,-16,-1,17,18,18
80,orz102d.map,44,39,1651,42,25,1,13,1483,38,37,5,1,4,12,16,17,17
81,orz102d.map,44,39,1564,40,34,3,4,772,19,7,24,31,21,-27,48,121,49
82,orz102d.map,44,39,995,25,18,18,20,606,15,17,28,21,10,-1,11,12,12
83,orz102d.map,44,39,985,25,28,18,10,956,24,18,19,20,1,-10,11,12,12
84,orz102d.map,44,39,904,23,31,20,7,1488,38,32,5,6,-15,1,16,17,17
85,orz102d.map,44,39,917,23,18,20,20,575,14,9,29,29,9,-9,18,19,19
86,orz102d.map,44,39,674,17,27,26,11,1099,28,31,15,7,-11,4,15,16,16
87,orz102d.map,44,39,669,17,32,26,6,655,16,7,27,31,1,-25,26,27,27
88,orz102d.map,44,39,497,12,9,31,29,705,18,35,25,3,-6,26,32,33,58
89,orz102d.map,44,39,1016,26,36,17,2,239,6,33,37,5,20,-3,23,157,54
90,orz102d.map,44,39,644,16,18,27,20,204,5,29,38,9,11,11,22,23,23
91,orz102d.map,44,39,587,15,36,28,2,870,22,26,21,12,-7,-10,17,18,18
92,orz102d.map,44,39,243,6,29,37,9,549,14,35,29,3,-8,6,14,28,29
93,orz102d.map,44,39,1017,26,35,17,3,921,23,14,20,24,3,-21,24,25,25
94,orz102d.map,44,39,877,22,19,21,19,639,16,23,27,15,6,4,10,11,11
95,orz102d.map,44,39,1061,27,30,16,8,1685,43,30,0,8,-16,0,16,17,17
96,orz102d.map,44,39,1608,41,29,2,9,867,22,29,21,9,19,0,19,20,20
97,orz102d.map,44,39,480,12,26,31,12,1298,33,27,10,11,-21,1,22,23,23
98,orz102d.map,44,39,793,20,25,23,13,1100,28,30,15,8,-8,5,13,14,14
99,orz102d.map,44,39,633,16,29,27,9,1173,30,35,13,3,-14,6,20,21,21
0,orz103d.map,453,461,67386,146,380,306,80,81887,177,170,275,290,-31,-210,241,18987,10176
1,orz103d.map,453,461,127782,277,375,175,85,13190,28,178,424,282,249,-197,446,1937,4005
2,orz103d.map,453,461,167415,363,388,89,72,42575,92,297,360,163,271,-91,362,5134,13746
3,orz103d.map,453,461,150208,325,77,127,383,165991,360,429,92,31,-35,352,387,34605,30119
4,orz103d.map,453,461,81410,176,186,276,274,169271,367,376,85,84,-191,190,381,35894,22757
5,orz103d.map,453,461,109595,237,122,215,338,92077,199,122,253,338,38,0,38,10476,8279
6,orz103d.map,453,461,74728,162,414,290,46,107071,232,341,220,119,-70,-73,143,663,311
7,orz103d.map,453,461,76340,165,185,287,275,104670,227,437,225,23,-62,252,314,19349,22618
8,orz103d.map,453,461,155749,337,68,115,392,100014,216,22,236,438,121,-46,167,1436,2413
9,orz103d.map,453,461,180113,390,137,62,323,88598,192,374,260,86,198,237,435,25104,27273
10,orz103d.map,453,461,135001,292,71,160,389,109764,238,414,214,46,54,343,397,23223,28169
11,orz103d.map,453,461,76361,165,164,287,296,79635,172,117,280,343,-7,-47,54,900,680
12,orz103d.map,453,461,100475,217,22,235,438,164644,357,393,95,67,-140,371,511,37130,34502
13,orz103d.map,453,461,56780,123,383,329,77,92974,201,147,251,313,-78,-236,314,17048,9140
14,orz103d.map,453,461,22202,48,386,404,74,79350,172,402,280,58,-124,16,140,506,423
15,orz103d.map,453,461,79652,172,100,280,360,106526,231,425,221,35,-59,325,384,11046,13781
16,orz103d.map,453,461,91984,199,215,253,245,57322,124,302,328,158,75,87,162,11760,20022
17,orz103d.map,453,461,121988,264,176,188,284,151596,328,72,124,388,-64,-104,168,301,2682
18,orz103d.map,453,461,109294,237,423,215,37,36503,79,376,373,84,158,-47,205,296,1217
19,orz103d.map,453,461,145553,315,122,137,338,50038,108,210,344,250,207,88,295,17342,12736
20,orz103d.map,453,461,135441,293,92,159,368,14081,30,209,422,251,263,117,380,17395,19440
21,orz103d.map,453,461,83592,181,309,271,151,190699,413,154,39,306,-232,-155,387,29647,26247
22,orz103d.map,453,461,109411,237,306,215,154,205469,445,136,7,324,-208,-170,378,27754,27274
23,orz103d.map,453,461,160436,348,452,104,8,51909,112,183,340,277,236,-269,505,17485,19662
24,orz103d.map,453,461,164156,356,420,96,40,32021,69,248,383,212,287,-172,459,19741,23081
25,orz103d.map,453,461,133435,289,254,163,206,93117,201,4,251,456,88,-250,338,12009,6158
26,orz103d.map,453,461,171064,371,427,81,33,91185,197,92,255,368,174,-335,509,20173,30532
27,orz103d.map,453,461,166065,360,355,92,105,136109,295,346,157,114,65,-9,74,2613,3216
28,orz103d.map,453,461,56323,122,379,330,81,46644,101,377,351,83,21,-2,23,24,24
29,orz103d.map,453,461,52892,114,122,338,338,99551,215,24,237,436,-101,-98,199,19780,16390
30,orz103d.map,453,461,125672,272,180,180,280,113174,245,231,207,229,27,51,78,3372,2497
31,orz103d.map,453,461,50867,110,303,342,157,119791,259,68,193,392,-149,-235,384,28152,22179
32,orz103d.map,453,461,76640,166,346,286,114,79072,171,219,281,241,-5,-127,132,22320,18717
33,orz103d.map,453,461,108931,236,325,216,135,105076,227,31,225,429,9,-294,303,34852,26911
34,orz103d.map,453,461,55922,121,319,331,141,149467,324,357,128,103,-203,38,241,4866,6201
35,orz103d.map,453,461,90218,195,137,257,323,152052,329,77,123,383,-134,-60,194,8635,13687
36,orz103d.map,453,461,146507,317,90,135,370,155197,336,159,116,301,-19,69,88,3299,1597
37,orz103d.map,453,461,85523,185,222,267,238,18262,39,177,413,283,146,-45,191,3618,8333
38,orz103d.map,453,461,163625,354,29,98,431,57314,124,310,328,150,230,281,511,22306,27002
39,orz103d.map,453,461,26456,57,281,395,179,81198,176,398,276,62,-119,117,236,3533,886
40,orz103d.map,453,461,179635,389,154,63,306,133773,290,377,162,83,99,223,322,24862,29548
41,orz103d.map,453,461,169694,368,414,84,46,106006,229,23,223,437,139,-391,530,34489,35446
42,orz103d.map,453,461,141040,305,25,147,435,144761,314,453,138,7,-9,428,437,32647,33534
43,orz103d.map,453,461,143809,311,22,141,438,177844,385,101,67,359,-74,79,153,8407,7867
44,orz103d.map,453,461,100931,218,27,234,433,6532,14,382,438,78,204,355,559,24820,34496
45,orz103d.map,453,461,19074,41,287,411,173,156579,339,160,113,300,-298,-127,425,24673,17784
46,orz103d.map,453,461,146068,316,68,136,392,136069,295,386,157,74,21,318,339,23155,26828
47,orz103d.map,453,461,54092,117,305,335,155,143717,311,114,141,346,-194,-191,385,26775,22220
48,orz103d.map,453,461,148499,322,403,130,57,106493,231,458,221,2,91,55,146,2998,3146
49,orz103d.map,453,461,15411,33,262,419,198,133907,290,243,162,217,-257,-19,276,20815,10671
50,orz103d.map,453,461,85084,184,200,268,260,103039,223,224,229,236,-39,24,63,104,70
51,orz103d.map,453,461,165817,359,142,93,318,141347,306,179,146,281,53,37,90,164,129
52,orz103d.map,453,461,123477,267,70,185,390,16790,36,266,416,194,231,196,427,17446,24456
53,orz103d.map,453,461,18202,39,237,413,223,43086,93,247,359,213,-54,10,64,4161,2402
54,orz103d.map,453,461,42164,91,247,361,213,99196,215,379,237,81,-124,132,256,5657,16467
55,orz103d.map,453,461,135971,294,23,158,437,139027,301,194,151,266,-7,171,178,1944,6167
56,orz103d.map,453,461,147067,319,452,133,8,70421,152,111,300,349,167,-341,508,16750,22284
57,orz103d.map,453,461,42657,92,215,360,245,142925,310,445,142,15,-218,230,448,20393,20706
58,orz103d.map,453,461,54628,118,230,334,230,47703,103,240,349,220,15,10,25,26,26
59,orz103d.map,453,461,76073,165,452,287,8,180154,390,96,62,364,-225,-356,581,29816,25214
60,orz103d.map,453,461,161642,350,168,102,292,146012,316,124,136,336,34,-44,78,2408,1434
61,orz103d.map,453,461,166354,360,66,92,394,110318,239,321,213,139,121,255,376,26950,26948
62,orz103d.map,453,461,161942,351,329,101,131,108823,236,433,216,27,115,104,219,5214,10485
63,orz103d.map,453,461,76163,165,362,287,98,146565,317,32,135,428,-152,-330,482,33583,26317
64,orz103d.map,453,461,134122,290,28,162,432,108539,235,256,217,204,55,228,283,8680,10459
65,orz103d.map,453,461,161944,351,327,101,133,49487,107,300,345,160,244,-27,271,7592,16444
66,orz103d.map,453,461,46778,101,243,351,217,54203,117,194,335,266,-16,-49,65,66,180
67,orz103d.map,453,461,132121,286,185,166,275,122551,265,74,187,386,21,-111,132,1672,1650
68,orz103d.map,453,461,106468,230,22,222,438,109550,237,167,215,293,-7,145,152,7004,6642
69,orz103d.map,453,461,148836,322,66,130,394,127669,276,27,176,433,46,-39,85,2000,2145
70,orz103d.map,453,461,141413,306,113,146,347,124855,270,75,182,385,36,-38,74,840,104
71,orz103d.map,453,461,164961,357,76,95,384,113252,245,153,207,307,112,77,189,3880,3972
72,orz103d.map,453,461,79387,172,365,280,95,132047,286,259,166,201,-114,-106,220,25640,26138
73,orz103d.map,453,461,5139,11,392,441,68,152053,329,76,123,384,-318,-316,634,29722,24833
74,orz103d.map,453,461,45780,99,319,353,141,6535,14,379,438,81,85,60,145,272,1047
75,orz103d.map,453,461,51937,112,155,340,305,94003,203,40,249,420,-91,-115,206,26661,17076
76,orz103d.map,453,461,49935,108,313,344,147,137039,297,338,155,122,-189,25,214,3346,4047
77,orz103d.map,453,461,47592,103,351,349,109,137959,299,340,153,120,-196,-11,207,2521,1113
78,orz103d.map,453,461,145707,316,429,136,31,39813,86,293,366,167,230,-136,366,2718,8551
79,orz103d.map,453,461,19907,43,376,409,84,88406,191,105,261,355,-148,-271,419,15153,11499
80,orz103d.map,453,461,188859,409,150,43,310,45005,97,172,355,288,312,22,334,14413,12259
81,orz103d.map,453,461,47648,103,295,349,165,3807,8,341,444,119,95,46,141,3047,743
82,orz103d.map,453,461,105211,228,357,224,103,90724,196,92,256,368,32,-265,297,17335,16109
83,orz103d.map,453,461,137479,298,359,154,101,83703,181,198,271,262,117,-161,278,23529,23957
84,orz103d.map,453,461,86540,187,127,265,333,113693,246,173,206,287,-59,46,105,7978,10965
85,orz103d.map,453,461,111408,241,153,211,307,79539,172,213,280,247,69,60,129,4214,5442
86,orz103d.map,453,461,106626,231,325,221,135,134695,292,377,160,83,-61,52,113,742,250
87,orz103d.map,453,461,91596,198,142,254,318,115332,250,378,202,82,-52,236,288,12331,18306
88,orz103d.map,453,461,155641,337,176,115,284,116147,251,24,201,436,86,-152,238,7077,5038
89,orz103d.map,453,461,149189,323,174,129,286,144862,314,352,138,108,9,178,187,28519,26774
90,orz103d.map,453,461,167865,364,399,88,61,161949,351,322,101,138,13,-77,90,536,93
91,orz103d.map,453,461,63505,137,112,315,348,161028,349,321,103,139,-212,209,421,36102,16731
92,orz103d.map,453,461,6537,14,377,438,83,48058,104,346,348,114,-90,-31,121,398,456
93,orz103d.map,453,461,57328,124,296,328,164,165543,359,416,93,44,-235,120,355,11444,10065
94,orz103d.map,453,461,167396,363,407,89,53,167844,364,420,88,40,-1,13,14,15,15
95,orz103d.map,453,461,13641,29,188,423,272,135404,293,129,159,331,-264,-59,323,13399,17259
96,orz103d.map,453,461,134499,291,112,161,348,97061,210,209,242,251,81,97,178,6454,5217
97,orz103d.map,453,461,146714,318,344,134,116,166987,362,355,90,105,-44,11,55,2646,2348
98,orz103d.map,453,461,72977,158,321,294,139,115476,250,234,202,226,-92,-87,179,24143,23872
99,orz103d.map,453,461,126139,273,174,179,286,103406,224,318,228,142,49,144,193,28520,27679
0,orz105d.map,55,25,611,24,13,30,11,1270,50,4,4,20,-26,-9,35,36,36
1,orz105d.map,55,25,670,26,4,28,20,1111,44,13,10,11,-18,9,27,28,28
2,orz105d.map,55,25,596,23,3,31,21,1165,46,9,8,15,-23,6,29,30,30
3,orz105d.map,55,25,737,29,12,25,12,885,35,14,19,10,-6,2,8,9,9
4,orz105d.map,55,25,35,1,14,53,10,820,32,4,22,20,-31,-10,41,45,45
5,orz105d.map,55,25,1364,54,10,0,14,1070,42,4,12,20,12,-6,18,19,19
6,orz105d.map,55,25,1292,51,7,3,17,1068,42,6,12,18,9,-1,10,11,11
7,orz105d.map,55,25,721,28,3,26,21,1218,48,6,6,18,-20,3,23,24,24
8,orz105d.map,55,25,1144,45,5,9,19,919,36,5,18,19,9,0,9,10,10
9,orz105d.map,55,25,787,31,12,23,12,710,28,14,26,10,3,2,5,6,6
10,orz105d.map,55,25,884,35,15,19,9,294,11,5,43,19,24,-10,34,37,60
11,orz105d.map,55,25,642,25,7,29,17,1294,51,5,3,19,-26,-2,28,29,29
12,orz105d.map,55,25,285,11,14,43,10,335,13,14,41,10,-2,0,2,3,3
13,orz105d.map,55,25,337,13,12,41,12,759,30,15,24,9,-17,3,20,44,84
14,orz105d.map,55,25,1066,42,8,12,16,494,19,5,35,19,23,-3,26,27,27
15,orz105d.map,55,25,370,14,4,40,20,1087,43,12,11,12,-29,8,37,42,38
16,orz105d.map,55,25,1339,53,10,1,14,892,35,7,19,17,18,-3,21,22,22
17,orz105d.map,55,25,336,13,13,41,11,163,6,11,48,13,7,-2,9,16,18
18,orz105d.map,55,25,914,36,10,18,14,893,35,6,19,18,1,-4,5,6,6
19,orz105d.map,55,25,771,30,3,24,21,110,4,14,50,10,26,11,37,40,41
20,orz105d.map,55,25,768,30,6,24,18,886,35,13,19,11,-5,7,12,13,13
21,orz105d.map,55,25,948,37,1,17,23,788,31,11,23,13,6,10,16,17,17
22,orz105d.map,55,25,589,23,10,31,14,567,22,7,32,17,1,-3,4,5,5
23,orz105d.map,55,25,418,16,6,38,18,311,12,13,42,11,4,7,11,12,12
24,orz105d.map,55,25,1162,46,12,8,12,159,6,15,48,9,40,3,43,198,70
25,orz105d.map,55,25,266,10,8,44,16,366,14,8,40,16,-4,0,4,5,5
26,orz105d.map,55,25,113,4,11,50,13,735,29,14,25,10,-25,3,28,70,69
27,orz105d.map,55,25,344,13,5,41,19,418,16,6,38,18,-3,1,4,5,5
28,orz105d.map,55,25,320,12,4,42,20,861,34,13,20,11,-22,9,31,44,32
29,orz105d.map,55,25,1034,41,15,13,9,765,30,9,24,15,11,-6,17,18,18
30,orz105d.map,55,25,112,4,12,50,12,113,4,11,50,13,0,-1,1,2,2
31,orz105d.map,55,25,309,12,15,42,9,719,28,5,26,19,-16,-10,26,27,27
32,orz105d.map,55,25,769,30,5,24,19,987,39,12,15,12,-9,7,16,17,17
33,orz105d.map,55,25,162,6,12,48,12,660,26,14,28,10,-20,2,22,61,57
34,orz105d.map,55,25,760,30,14,24,10,835,33,14,21,10,-3,0,3,4,4
35,orz105d.map,55,25,112,4,12,50,12,370,14,4,40,20,-10,-8,18,22,20
36,orz105d.map,55,25,872,34,2,20,22,1043,41,6,13,18,-7,4,11,12,12
37,orz105d.map,55,25,419,16,5,38,19,1022,40,2,14,22,-24,-3,27,48,28
38,orz105d.map,55,25,691,27,8,27,16,518,20,6,34,18,7,-2,9,10,10
39,orz105d.map,55,25,819,32,5,22,19,1244,49,5,5,19,-17,0,17,18,18
40,orz105d.map,55,25,826,33,23,21,1,908,36,16,18,8,-3,-7,10,11,11
41,orz105d.map,55,25,444,17,5,37,19,964,38,10,16,14,-21,5,26,27,27
42,orz105d.map,55,25,640,25,9,29,15,1010,40,14,14,10,-15,5,20,21,21
43,orz105d.map,55,25,874,34,0,20,24,670,26,4,28,20,8,4,12,13,13
44,orz105d.map,55,25,1309,52,15,2,9,839,33,10,21,14,19,-5,24,25,49
45,orz105d.map,55,25,522,20,2,34,22,842,33,7,21,17,-13,5,18,19,19
46,orz105d.map,55,25,972,38,2,16,22,645,25,4,29,20,13,2,15,16,16
47,orz105d.map,55,25,314,12,10,42,14,108,4,16,50,8,8,6,14,15,15
48,orz105d.map,55,25,1296,51,3,3,21,798,31,1,23,23,20,-2,22,27,38
49,orz105d.map,55,25,1308,52,16,2,8,519,20,5,34,19,32,-11,43,44,103
50,orz105d.map,55,25,313,12,11,42,13,759,30,15,24,9,-18,4,22,46,75
51,orz105d.map,55,25,1321,52,3,2,21,1236,49,13,5,11,3,10,13,14,14
52,orz105d.map,55,25,336,13,13,41,11,490,19,9,35,15,-6,-4,10,11,11
53,orz105d.map,55,25,585,23,14,31,10,717,28,7,26,17,-5,-7,12,13,19
54,orz105d.map,55,25,1161,46,13,8,11,1212,48,12,6,12,-2,-1,3,4,4
55,orz105d.map,55,25,1035,41,14,13,10,1069,42,5,12,19,-1,-9,10,11,11
56,orz105d.map,55,25,442,17,7,37,17,1084,43,15,11,9,-26,8,34,35,37
57,orz105d.map,55,25,539,21,10,33,14,1062,42,12,12,12,-21,2,23,24,24
58,orz105d.map,55,25,889,35,10,19,14,1258,50,16,4,8,-15,6,21,48,22
59,orz105d.map,55,25,584,23,15,31,9,819,32,5,22,19,-9,-10,19,20,28
60,orz105d.map,55,25,368,14,6,40,18,598,23,1,31,23,-9,-5,14,15,15
61,orz105d.map,55,25,112,4,12,50,12,1014,40,10,14,14,-36,-2,38,45,79
62,orz105d.map,55,25,785,31,14,23,10,286,11,13,43,11,20,-1,21,97,47
63,orz105d.map,55,25,811,32,13,22,11,758,30,16,24,8,2,3,5,6,6
64,orz105d.map,55,25,1114,44,10,10,14,342,13,7,41,17,31,-3,34,35,39
65,orz105d.map,55,25,1211,48,13,6,11,1263,50,11,4,13,-2,-2,4,5,5
66,orz105d.map,55,25,801,32,23,22,1,634,25,15,29,9,7,-8,15,16,16
67,orz105d.map,55,25,1040,41,9,13,15,1314,52,10,2,14,-11,1,12,13,13
68,orz105d.map,55,25,971,38,3,16,21,491,19,8,35,16,19,5,24,25,25
69,orz105d.map,55,25,446,17,3,37,21,735,29,14,25,10,-12,11,23,24,25
70,orz105d.map,55,25,520,20,4,34,20,465,18,9,36,15,2,5,7,8,8
71,orz105d.map,55,25,780,31,19,23,5,862,34,12,20,12,-3,-7,10,11,11
72,orz105d.map,55,25,688,27,11,27,13,718,28,6,26,18,-1,-5,6,7,7
73,orz105d.map,55,25,1092,43,7,11,17,733,29,16,25,8,14,9,23,24,24
74,orz105d.map,55,25,136,5,13,49,11,884,35,15,19,9,-30,2,32,83,146
75,orz105d.map,55,25,592,23,7,31,17,715,28,9,26,15,-5,2,7,8,8
76,orz105d.map,55,25,189,7,10,47,14,415,16,9,38,15,-9,-1,10,11,11
77,orz105d.map,55,25,728,29,21,25,3,838,33,11,21,13,-4,-10,14,15,15
78,orz105d.map,55,25,584,23,15,31,9,739,29,10,25,14,-6,-5,11,12,15
79,orz105d.map,55,25,860,34,14,20,10,1086,43,13,11,11,-9,-1,10,11,11
80,orz105d.map,55,25,872,34,2,20,22,845,33,4,21,20,1,2,3,4,4
81,orz105d.map,55,25,520,20,4,34,20,415,16,9,38,15,4,5,9,10,10
82,orz105d.map,55,25,1192,47,7,7,17,1137,45,12,9,12,2,5,7,8,8
83,orz105d.map,55,25,716,28,8,26,16,767,30,7,24,17,-2,-1,3,4,4
84,orz105d.map,55,25,91,3,8,51,16,766,30,8,24,16,-27,0,27,28,28
85,orz105d.map,55,25,191,7,8,47,16,1215,48,9,6,15,-41,1,42,43,43
86,orz105d.map,55,25,963,38,11,16,13,140,5,9,49,15,33,-2,35,36,54
87,orz105d.map,55,25,808,32,16,22,8,990,39,9,15,15,-7,-7,14,15,15
88,orz105d.map,55,25,490,19,9,35,15,658,26,16,28,8,-7,7,14,15,17
89,orz105d.map,55,25,729,29,20,25,4,363,14,11,40,13,15,-9,24,79,40
90,orz105d.map,55,25,814,32,10,22,14,271,10,3,44,21,22,-7,29,32,36
91,orz105d.map,55,25,792,31,7,23,17,719,28,5,26,19,3,-2,5,6,6
92,orz105d.map,55,25,441,17,8,37,16,662,26,12,28,12,-9,4,13,14,14
93,orz105d.map,55,25,889,35,10,19,14,1084,43,15,11,9,-8,5,13,14,14
94,orz105d.map,55,25,1019,40,5,14,19,540,21,9,33,15,19,4,23,24,24
95,orz105d.map,55,25,1241,49,8,5,16,591,23,8,31,16,26,0,26,27,27
96,orz105d.map,55,25,1316,52,8,2,16,589,23,10,31,14,29,2,31,32,32
97,orz105d.map,55,25,259,10,15,44,9,935,37,14,17,10,-27,-1,28,53,172
98,orz105d.map,55,25,674,26,0,28,24,492,19,7,35,17,7,7,14,15,15
99,orz105d.map,55,25,646,25,3,29,21,167,6,7,48,17,19,4,23,84,27
0,orz106d.map,30,20,205,10,14,19,5,302,15,17,14,2,-5,3,8,9,9
1,orz106d.map,30,20,196,9,3,20,16,165,8,14,21,5,1,11,12,13,13
2,orz106d.map,30,20,131,6,8,23,11,277,13,2,16,17,-7,-6,13,15,14
3,orz106d.map,30,20,281,14,18,15,1,516,25,3,4,16,-11,-15,26,27,27
4,orz106d.map,30,20,418,20,1,9,18,309,15,10,14,9,5,9,14,15,16
5,orz106d.map,30,20,323,16,16,13,3,92,4,7,25,12,12,-9,21,22,26
6,orz106d.map,30,20,137,6,2,23,17,386,19,13,10,6,-13,11,24,25,25
7,orz106d.map,30,20,164,8,15,21,4,533,26,6,3,13,-18,-9,27,28,28
8,orz106d.map,30,20,291,14,8,15,11,286,14,13,15,6,0,5,5,6,6
9,orz106d.map,30,20,152,7,7,22,12,467,23,12,6,7,-16,5,21,22,22
10,orz106d.map,30,20,234,11,5,18,14,451,22,8,7,11,-11,3,14,27,15
11,orz106d.map,30,20,326,16,13,13,6,567,28,12,1,7,-12,-1,13,14,14
12,orz106d.map,30,20,468,23,11,6,8,52,2,7,27,12,21,-4,25,26,26
13,orz106d.map,30,20,476,23,3,6,16,263,13,16,16,3,10,13,23,24,24
14,orz106d.map,30,20,571,28,8,1,11,295,14,4,15,15,14,-4,18,19,25
15,orz106d.map,30,20,458,22,1,7,18,327,16,12,13,7,6,11,17,18,18
16,orz106d.map,30,20,397,19,2,10,17,455,22,4,7,15,-3,2,5,6,6
17,orz106d.map,30,20,568,28,11,1,8,72,3,7,26,12,25,-4,29,30,30
18,orz106d.map,30,20,193,9,6,20,13,511,25,8,4,11,-16,2,18,35,19
19,orz106d.map,30,20,546,27,13,2,6,597,29,2,0,17,-2,-11,13,14,14
20,orz106d.map,30,20,249,12,10,17,9,234,11,5,18,14,1,-5,6,7,7
21,orz106d.map,30,20,251,12,8,17,11,455,22,4,7,15,-10,-4,14,15,15
22,orz106d.map,30,20,313,15,6,14,13,347,17,12,12,7,-2,6,8,9,9
23,orz106d.map,30,20,154,7,5,22,14,191,9,8,20,11,-2,3,5,6,6
24,orz106d.map,30,20,229,11,10,18,9,367,18,12,11,7,-7,2,9,10,10
25,orz106d.map,30,20,264,13,15,16,4,495,24,4,5,15,-11,-11,22,23,23
26,orz106d.map,30,20,265,13,14,16,5,156,7,3,22,16,6,-11,17,18,18
27,orz106d.map,30,20,408,20,11,9,8,478,23,1,6,18,-3,-10,13,14,20
28,orz106d.map,30,20,329,16,10,13,9,573,28,6,1,13,-12,-4,16,17,17
29,orz106d.map,30,20,450,22,9,7,10,334,16,5,13,14,6,-4,10,11,14
30,orz106d.map,30,20,296,14,3,15,16,194,9,5,20,14,5,2,7,8,8
31,orz106d.map,30,20,325,16,14,13,5,535,26,4,3,15,-10,-10,20,21,21
32,orz106d.map,30,20,513,25,6,4,13,263,13,16,16,3,12,10,22,23,23
33,orz106d.map,30,20,321,16,18,13,1,243,12,16,17,3,4,-2,6,7,7
34,orz106d.map,30,20,568,28,11,1,8,330,16,9,13,10,12,-2,14,15,15
35,orz106d.map,30,20,434,21,5,8,14,134,6,5,23,14,15,0,15,16,16
36,orz106d.map,30,20,246,12,13,17,6,495,24,4,5,15,-12,-9,21,22,22
37,orz106d.map,30,20,97,4,2,25,17,295,14,4,15,15,-10,2,12,13,13
38,orz106d.map,30,20,148,7,11,22,8,373,18,6,11,13,-11,-5,16,17,17
39,orz106d.map,30,20,345,17,14,12,5,493,24,6,5,13,-7,-8,15,16,20
40,orz106d.map,30,20,299,14,0,15,19,243,12,16,17,3,2,16,18,19,19
41,orz106d.map,30,20,474,23,5,6,14,413,20,6,9,13,3,1,4,5,5
42,orz106d.map,30,20,512,25,7,4,12,476,23,3,6,16,2,-4,6,7,7
43,orz106d.map,30,20,273,13,6,16,13,174,8,5,21,14,5,-1,6,7,7
44,orz106d.map,30,20,144,7,15,22,4,354,17,5,12,14,-10,-10,20,21,21
45,orz106d.map,30,20,547,27,12,2,7,244,12,15,17,4,15,3,18,19,19
46,orz106d.map,30,20,387,19,12,10,7,118,5,1,24,18,14,-11,25,26,26
47,orz106d.map,30,20,577,28,2,1,17,154,7,5,22,14,21,3,24,25,25
48,orz106d.map,30,20,303,15,16,14,3,151,7,8,22,11,8,-8,16,17,20
49,orz106d.map,30,20,433,21,6,8,13,486,24,13,5,6,-3,7,10,11,11
50,orz106d.map,30,20,306,15,13,14,6,267,13,12,16,7,2,-1,3,4,4
51,orz106d.map,30,20,331,16,8,13,11,190,9,9,20,10,7,1,8,9,9
52,orz106d.map,30,20,344,17,15,12,4,287,14,12,15,7,3,-3,6,7,7
53,orz106d.map,30,20,322,16,17,13,2,516,25,3,4,16,-9,-14,23,24,24
54,orz106d.map,30,20,226,11,13,18,6,556,27,3,2,16,-16,-10,26,27,27
55,orz106d.map,30,20,435,21,4,8,15,507,25,12,4,7,-4,8,12,13,13
56,orz106d.map,30,20,457,22,2,7,17,506,25,13,4,6,-3,11,14,15,15
57,orz106d.map,30,20,394,19,5,10,14,510,25,9,4,10,-6,4,10,11,11
58,orz106d.map,30,20,472,23,7,6,12,387,19,12,10,7,4,5,9,10,10
59,orz106d.map,30,20,578,28,1,1,18,132,6,7,23,12,22,6,28,29,40
60,orz106d.map,30,20,394,19,5,10,14,347,17,12,12,7,2,7,9,14,20
61,orz106d.map,30,20,241,12,18,17,1,97,4,2,25,17,8,-16,24,28,29
62,orz106d.map,30,20,233,11,6,18,13,92,4,7,25,12,7,1,8,9,9
63,orz106d.map,30,20,241,12,18,17,1,434,21,5,8,14,-9,-13,22,23,23
64,orz106d.map,30,20,329,16,10,13,9,297,14,2,15,17,2,-8,10,11,11
65,orz106d.map,30,20,475,23,4,6,15,534,26,5,3,14,-3,1,4,5,5
66,orz106d.map,30,20,245,12,14,17,5,598,29,1,0,18,-17,-13,30,40,31
67,orz106d.map,30,20,529,26,10,3,9,354,17,5,12,14,9,-5,14,16,15
68,orz106d.map,30,20,255,12,4,17,15,303,15,16,14,3,-3,12,15,16,16
69,orz106d.map,30,20,240,12,19,17,0,12,0,7,29,12,12,-12,24,25,29
70,orz106d.map,30,20,288,14,11,15,8,175,8,4,21,15,6,-7,13,14,14
71,orz106d.map,30,20,408,20,11,9,8,269,13,10,16,9,7,-1,8,9,9
72,orz106d.map,30,20,233,11,6,18,13,124,6,15,23,4,5,9,14,15,15
73,orz106d.map,30,20,52,2,7,27,12,230,11,9,18,10,-9,2,11,12,12
74,orz106d.map,30,20,387,19,12,10,7,518,25,1,4,18,-6,-11,17,18,30
75,orz106d.map,30,20,597,29,2,0,17,149,7,10,22,9,22,8,30,31,31
76,orz106d.map,30,20,376,18,3,11,16,242,12,17,17,2,6,14,20,21,21
77,orz106d.map,30,20,398,19,1,10,18,174,8,5,21,14,11,4,15,16,18
78,orz106d.map,30,20,125,6,14,23,5,510,25,9,4,10,-19,-5,24,47,25
79,orz106d.map,30,20,137,6,2,23,17,282,14,17,15,2,-8,15,23,28,24
80,orz106d.map,30,20,137,6,2,23,17,138,6,1,23,18,0,-1,1,2,2
81,orz106d.map,30,20,291,14,8,15,11,211,10,8,19,11,4,0,4,5,5
82,orz106d.map,30,20,211,10,8,19,11,189,9,10,20,9,1,2,3,4,4
83,orz106d.map,30,20,498,24,1,5,18,98,4,1,25,18,20,0,20,33,29
84,orz106d.map,30,20,73,3,6,26,13,250,12,9,17,10,-9,3,12,13,13
85,orz106d.map,30,20,240,12,19,17,0,525,26,14,3,5,-14,-5,19,40,22
86,orz106d.map,30,20,552,27,7,2,12,386,19,13,10,6,8,6,14,15,15
87,orz106d.map,30,20,387,19,12,10,7,134,6,5,23,14,13,-7,20,21,21
88,orz106d.map,30,20,257,12,2,17,17,156,7,3,22,16,5,1,6,7,7
89,orz106d.map,30,20,545,27,14,2,5,436,21,3,8,16,6,-11,17,18,18
90,orz106d.map,30,20,490,24,9,5,10,366,18,13,11,6,6,4,10,11,11
91,orz106d.map,30,20,205,10,14,19,5,431,21,8,8,11,-11,-6,17,39,18
92,orz106d.map,30,20,176,8,3,21,16,165,8,14,21,5,0,11,11,12,12
93,orz106d.map,30,20,536,26,3,3,16,343,17,16,12,3,9,13,22,39,23
94,orz106d.map,30,20,426,21,13,8,6,250,12,9,17,10,9,-4,13,14,14
95,orz106d.map,30,20,474,23,5,6,14,311,15,8,14,11,8,3,11,12,12
96,orz106d.map,30,20,417,20,2,9,17,366,18,13,11,6,2,11,13,29,20
97,orz106d.map,30,20,210,10,9,19,10,118,5,1,24,18,5,-8,13,14,14
98,orz106d.map,30,20,476,23,3,6,16,191,9,8,20,11,14,5,19,20,20
99,orz106d.map,30,20,429,21,10,8,9,327,16,12,13,7,5,2,7,8,9
0,orz107d.map,45,29,266,9,23,35,5,1028,35,15,9,13,-26,-8,34,61,35
1,orz107d.map,45,29,850,29,19,15,9,1028,35,15,9,13,-6,-4,10,11,11
2,orz107d.map,45,29,904,31,23,13,5,530,18,20,26,8,13,-3,16,17,17
3,orz107d.map,45,29,265,9,24,35,4,209,7,22,37,6,2,-2,4,5,5
4,orz107d.map,45,29,273,9,16,35,12,1135,39,24,5,4,-30,8,38,53,39
5,orz107d.map,45,29,301,10,17,34,11,295,10,23,34,5,0,6,6,7,7
6,orz107d.map,45,29,256,8,4,36,24,534,18,16,26,12,-10,12,22,23,35
7,orz107d.map,45,29,1049,36,23,8,5,92,3,23,41,5,33,0,33,36,37
8,orz107d.map,45,29,42,1,15,43,13,404,13,1,31,27,-12,-14,26,27,59
9,orz107d.map,45,29,905,31,22,13,6,793,27,18,17,10,4,-4,8,9,9
10,orz107d.map,45,29,386,13,19,31,9,187,6,15,38,13,7,-4,11,12,12
11,orz107d.map,45,29,1137,39,22,5,6,986,34,28,10,0,5,6,11,12,12
12,orz107d.map,45,29,326,11,21,33,7,967,33,18,11,10,-22,-3,25,26,26
13,orz107d.map,45,29,1112,38,18,6,10,816,28,24,16,4,10,6,16,17,17
14,orz107d.map,45,29,256,8,4,36,24,388,13,17,31,11,-5,13,18,19,34
15,orz107d.map,45,29,796,27,15,17,13,1028,35,15,9,13,-8,0,8,9,9
16,orz107d.map,45,29,176,6,26,38,2,503,17,18,27,10,-11,-8,19,20,20
17,orz107d.map,45,29,505,17,16,27,12,358,12,18,32,10,5,2,7,8,8
18,orz107d.map,45,29,217,7,14,37,14,615,21,22,23,6,-14,8,22,23,23
19,orz107d.map,45,29,929,32,27,12,1,853,29,16,15,12,3,-11,14,15,15
20,orz107d.map,45,29,643,22,23,22,5,276,9,13,35,15,13,-10,23,24,31
21,orz107d.map,45,29,209,7,22,37,6,645,22,21,22,7,-15,-1,16,17,17
22,orz107d.map,45,29,410,14,24,30,4,431,14,3,30,25,0,-21,21,24,24
23,orz107d.map,45,29,165,5,8,39,20,95,3,20,41,8,2,12,14,41,118
24,orz107d.map,45,29,792,27,19,17,9,612,21,25,23,3,6,6,12,13,13
25,orz107d.map,45,29,165,5,8,39,20,126,4,18,40,10,1,10,11,38,93
26,orz107d.map,45,29,795,27,16,17,12,1103,38,27,6,1,-11,11,22,23,23
27,orz107d.map,45,29,97,3,18,41,10,343,11,4,33,24,-8,-14,22,23,49
28,orz107d.map,45,29,210,7,21,37,7,180,6,22,38,6,1,1,2,3,3
29,orz107d.map,45,29,997,34,17,10,11,326,11,21,33,7,23,4,27,28,28
30,orz107d.map,45,29,1220,42,26,2,2,911,31,16,13,12,11,-10,21,22,22
31,orz107d.map,45,29,825,28,15,16,13,594,20,14,24,14,8,-1,9,21,18
32,orz107d.map,45,29,734,25,19,19,9,703,24,21,20,7,1,2,3,4,4
33,orz107d.map,45,29,1112,38,18,6,10,814,28,26,16,2,10,8,18,19,19
34,orz107d.map,45,29,240,8,20,36,8,214,7,17,37,11,1,-3,4,5,5
35,orz107d.map,45,29,235,8,25,36,3,324,11,23,33,5,-3,-2,5,6,6
36,orz107d.map,45,29,369,12,7,32,21,444,15,19,29,9,-3,12,15,16,16
37,orz107d.map,45,29,613,21,24,23,4,119,4,25,40,3,17,1,18,27,57
38,orz107d.map,45,29,501,17,20,27,8,397,13,8,31,20,4,-12,16,17,17
39,orz107d.map,45,29,1018,35,25,9,3,1251,43,24,1,4,-8,-1,9,10,10
40,orz107d.map,45,29,966,33,19,11,9,446,15,17,29,11,18,-2,20,21,21
41,orz107d.map,45,29,820,28,20,16,8,207,7,24,37,4,21,4,25,26,26
42,orz107d.map,45,29,612,21,25,23,3,303,10,15,34,13,11,-10,21,22,39
43,orz107d.map,45,29,8,0,20,44,8,1054,36,18,8,10,-36,-2,38,39,39
44,orz107d.map,45,29,217,7,14,37,14,990,34,24,10,4,-27,10,37,56,38
45,orz107d.map,45,29,364,12,12,32,16,1086,37,15,7,13,-25,3,28,65,58
46,orz107d.map,45,29,818,28,22,16,6,766,26,16,18,12,2,-6,8,9,9
47,orz107d.map,45,29,196,6,6,38,22,285,9,4,35,24,-3,-2,5,6,6
48,orz107d.map,45,29,450,15,13,29,15,445,15,18,29,10,0,5,5,6,6
49,orz107d.map,45,29,532,18,18,26,10,366,12,10,32,18,6,-8,14,15,15
50,orz107d.map,45,29,58,2,28,42,0,293,10,25,34,3,-8,-3,11,12,12
51,orz107d.map,45,29,147,5,26,39,2,677,23,18,21,10,-18,-8,26,27,27
52,orz107d.map,45,29,127,4,17,40,11,343,11,4,33,24,-7,-13,20,21,47
53,orz107d.map,45,29,346,11,1,33,27,532,18,18,26,10,-7,17,24,25,25
54,orz107d.map,45,29,253,8,7,36,21,71,2,15,42,13,6,8,14,37,51
55,orz107d.map,45,29,793,27,18,17,10,90,3,25,41,3,24,7,31,32,32
56,orz107d.map,45,29,61,2,25,42,3,215,7,16,37,12,-5,-9,14,15,15
57,orz107d.map,45,29,988,34,26,10,2,1165,40,23,4,5,-6,-3,9,10,10
58,orz107d.map,45,29,286,9,3,35,25,647,22,19,22,9,-13,16,29,30,44
59,orz107d.map,45,29,912,31,15,13,13,321,11,26,33,2,20,11,31,32,54
60,orz107d.map,45,29,322,11,25,33,3,1165,40,23,4,5,-29,-2,31,41,72
61,orz107d.map,45,29,331,11,16,33,12,557,19,22,25,6,-8,6,14,15,15
62,orz107d.map,45,29,997,34,17,10,11,823,28,17,16,11,6,0,6,7,7
63,orz107d.map,45,29,1192,41,25,3,3,282,9,7,35,21,32,-18,50,71,67
64,orz107d.map,45,29,1137,39,22,5,6,957,33,28,11,0,6,6,12,13,13
65,orz107d.map,45,29,361,12,15,32,13,239,8,21,36,7,4,6,10,11,11
66,orz107d.map,45,29,243,8,17,36,11,1046,36,26,8,2,-28,9,37,70,38
67,orz107d.map,45,29,121,4,23,40,5,705,24,19,20,9,-20,-4,24,25,25
68,orz107d.map,45,29,729,25,24,19,4,356,12,20,32,8,13,-4,17,18,26
69,orz107d.map,45,29,929,32,27,12,1,99,3,16,41,12,29,-11,40,41,99
70,orz107d.map,45,29,1251,43,24,1,4,430,14,4,30,24,29,-20,49,302,58
71,orz107d.map,45,29,913,31,14,13,14,1019,35,24,9,4,-4,10,14,15,15
72,orz107d.map,45,29,445,15,18,29,10,94,3,21,41,7,12,3,15,16,16
73,orz107d.map,45,29,1085,37,16,7,12,333,11,14,33,14,26,-2,28,55,51
74,orz107d.map,45,29,675,23,20,21,8,30,1,27,43,1,22,7,29,33,30
75,orz107d.map,45,29,154,5,19,39,9,735,25,18,19,10,-20,-1,21,22,22
76,orz107d.map,45,29,768,26,14,18,14,67,2,19,42,9,24,5,29,30,90
77,orz107d.map,45,29,345,11,2,33,26,145,5,28,39,0,6,26,32,63,33
78,orz107d.map,45,29,401,13,4,31,24,356,12,20,32,8,1,16,17,18,18
79,orz107d.map,45,29,326,11,21,33,7,990,34,24,10,4,-23,3,26,37,27
80,orz107d.map,45,29,409,14,25,30,3,37,1,20,43,8,13,-5,18,19,19
81,orz107d.map,45,29,994,34,20,10,8,942,32,14,12,14,2,-6,8,9,9
82,orz107d.map,45,29,760,26,22,18,6,159,5,14,39,14,21,-8,29,30,30
83,orz107d.map,45,29,99,3,16,41,12,413,14,21,30,7,-11,5,16,17,17
84,orz107d.map,45,29,232,8,28,36,0,67,2,19,42,9,6,-9,15,16,16
85,orz107d.map,45,29,1224,42,22,2,6,404,13,1,31,27,29,-21,50,51,51
86,orz107d.map,45,29,755,26,27,18,1,403,13,2,31,26,13,-25,38,39,51
87,orz107d.map,45,29,29,1,28,43,0,31,1,26,43,2,0,-2,2,3,3
88,orz107d.map,45,29,99,3,16,41,12,909,31,18,13,10,-28,2,30,31,31
89,orz107d.map,45,29,337,11,10,33,18,1166,40,22,4,6,-29,12,41,42,42
90,orz107d.map,45,29,244,8,16,36,12,783,27,28,17,0,-19,12,31,66,32
91,orz107d.map,45,29,267,9,22,35,6,255,8,5,36,23,1,-17,18,56,35
92,orz107d.map,45,29,386,13,19,31,9,94,3,21,41,7,10,2,12,13,13
93,orz107d.map,45,29,339,11,8,33,20,732,25,21,19,7,-14,13,27,28,28
94,orz107d.map,45,29,417,14,17,30,11,1051,36,21,8,7,-22,4,26,27,27
95,orz107d.map,45,29,1049,36,23,8,5,759,26,23,18,5,10,0,10,11,11
96,orz107d.map,45,29,380,13,25,31,3,1047,36,25,8,3,-23,0,23,41,84
97,orz107d.map,45,29,329,11,18,33,10,766,26,16,18,12,-15,-2,17,29,18
98,orz107d.map,45,29,345,11,2,33,26,501,17,20,27,8,-6,18,24,25,25
99,orz107d.map,45,29,910,31,17,13,11,671,23,24,21,4,8,7,15,16,16
0,orz200d.map,134,134,14030,104,39,29,94,6383,47,48,86,85,57,9,66,425,3408
1,orz200d.map,134,134,14552,108,53,25,80,3449,25,34,108,99,83,-19,102,236,1679
2,orz200d.map,134,134,13460,100,73,33,60,9455,70,58,63,75,30,-15,45,46,72
3,orz200d.map,134,134,12644,94,85,39,48,6933,51,34,82,99,43,-51,94,218,1673
4,orz200d.map,134,134,12393,92,68,41,65,14412,107,59,26,74,-15,-9,24,25,25
5,orz200d.map,134,134,359,2,42,131,91,11463,85,60,48,73,-83,18,101,561,1025
6,orz200d.map,134,134,15290,114,119,19,14,1027,7,44,126,89,107,-75,182,2421,732
7,orz200d.map,134,134,4936,36,21,97,112,11997,89,62,44,71,-53,41,94,165,98
8,orz200d.map,134,134,4662,34,27,99,106,5598,41,29,92,104,-7,2,9,10,10
9,orz200d.map,134,134,11994,89,65,44,68,7597,56,40,77,93,33,-25,58,64,107
10,orz200d.map,134,134,15095,112,46,21,87,1967,14,42,119,91,98,-4,102,455,2868
11,orz200d.map,134,134,7179,53,56,80,77,16222,121,125,12,8,-68,69,137,286,1915
12,orz200d.map,134,134,12240,91,87,42,46,12796,95,67,38,66,-4,-20,24,115,249
13,orz200d.map,134,134,15580,116,97,17,36,5180,38,45,95,88,78,-52,130,2250,398
14,orz200d.map,134,134,15844,118,101,15,32,10647,79,72,54,61,39,-29,68,668,132
15,orz200d.map,134,134,8549,63,26,70,107,15054,112,87,21,46,-49,61,110,190,165
16,orz200d.map,134,134,8669,64,40,69,93,7605,56,32,77,101,8,-8,16,17,17
17,orz200d.map,134,134,11625,86,32,47,101,7318,54,51,79,82,32,19,51,74,638
18,orz200d.map,134,134,9843,73,72,60,61,4661,34,28,99,105,39,-44,83,102,1134
19,orz200d.map,134,134,11225,83,30,50,103,2363,17,48,116,85,66,18,84,93,559
20,orz200d.map,134,134,15707,117,104,16,29,14499,108,106,25,27,9,2,11,12,12
21,orz200d.map,134,134,15190,113,85,20,48,10262,76,55,57,78,37,-30,67,106,129
22,orz200d.map,134,134,2504,18,41,115,92,14479,108,126,25,7,-90,85,175,2444,2194
23,orz200d.map,134,134,2369,17,42,116,91,7879,58,26,75,107,-41,-16,57,80,65
24,orz200d.map,134,134,15984,119,95,14,38,6155,45,8,88,125,74,-87,161,218,317
25,orz200d.map,134,134,14920,111,87,22,46,5306,39,53,94,80,72,-34,106,2221,381
26,orz200d.map,134,134,2490,18,55,115,78,4531,33,24,100,109,-15,-31,46,51,339
27,orz200d.map,134,134,15449,115,94,18,39,8811,65,32,68,101,50,-62,112,169,194
28,orz200d.map,134,134,14658,109,81,24,52,15463,115,80,18,53,-6,-1,7,8,8
29,orz200d.map,134,134,7745,57,26,76,107,15865,118,80,15,53,-61,54,115,234,127
30,orz200d.map,134,134,3593,26,24,107,109,14885,111,122,22,11,-85,98,183,2460,589
31,orz200d.map,134,134,16217,121,130,12,3,11635,86,22,47,111,35,-108,143,2238,839
32,orz200d.map,134,134,1558,11,49,122,84,16695,124,54,9,79,-113,5,118,2517,472
33,orz200d.map,134,134,15704,117,107,16,26,16164,120,49,13,84,-3,-58,61,3096,873
34,orz200d.map,134,134,12510,93,85,40,48,13071,97,60,36,73,-4,-25,29,89,286
35,orz200d.map,134,134,8122,60,51,73,82,8669,64,40,69,93,-4,-11,15,16,16
36,orz200d.map,134,134,12368,92,93,41,40,15213,113,62,20,71,-21,-31,52,67,169
37,orz200d.map,134,134,15469,115,74,18,59,10391,77,60,56,73,38,-14,52,57,435
38,orz200d.map,134,134,4380,32,41,101,92,16964,126,53,7,80,-94,12,106,2172,433
39,orz200d.map,134,134,9055,67,56,66,77,1423,10,50,123,83,57,-6,63,677,491
40,orz200d.map,134,134,15229,113,46,20,87,7863,58,42,75,91,55,-4,59,408,2035
41,orz200d.map,134,134,7890,58,15,75,118,9855,73,60,60,73,-15,45,60,114,409
42,orz200d.map,134,134,3866,28,19,105,114,15861,118,84,15,49,-90,65,155,425,202
43,orz200d.map,134,134,10252,76,65,57,68,1158,8,47,125,86,68,-18,86,891,557
44,orz200d.map,134,134,6249,46,48,87,85,2370,17,41,116,92,29,-7,36,106,269
45,orz200d.map,134,134,4666,34,23,99,110,9716,72,65,61,68,-38,42,80,224,88
46,orz200d.map,134,134,15955,119,124,14,9,14644,109,95,24,38,10,-29,39,161,40
47,orz200d.map,134,134,13369,99,30,34,103,4662,34,27,99,106,65,-3,68,227,951
48,orz200d.map,134,134,12810,95,53,38,80,4243,31,44,102,89,64,-9,73,980,1263
49,orz200d.map,134,134,12234,91,93,42,40,12503,93,92,40,41,-2,-1,3,4,4
50,orz200d.map,134,134,5195,38,30,95,103,15045,112,96,21,37,-74,66,140,296,199
51,orz200d.map,134,134,14004,104,65,29,68,6671,49,28,84,105,55,-37,92,157,150
52,orz200d.map,134,134,15033,112,108,21,25,11623,86,34,47,99,26,-74,100,2425,1564
53,orz200d.map,134,134,6290,46,7,87,126,8797,65,46,68,87,-19,39,58,70,609
54,orz200d.map,134,134,14770,110,103,23,30,6252,46,45,87,88,64,-58,122,269,1451
55,orz200d.map,134,134,1292,9,47,124,86,7463,55,40,78,93,-46,-7,53,237,209
56,orz200d.map,134,134,8548,63,27,70,106,7853,58,52,75,81,5,25,30,31,31
57,orz200d.map,134,134,12660,94,69,39,64,15013,112,128,21,5,-18,59,77,416,483
58,orz200d.map,134,134,15570,116,107,17,26,12519,93,76,40,57,23,-31,54,525,81
59,orz200d.map,134,134,4658,34,31,99,102,6519,48,46,85,87,-14,15,29,67,31
60,orz200d.map,134,134,14673,109,66,24,67,10683,79,36,54,97,30,-30,60,858,283
61,orz200d.map,134,134,5609,41,18,92,115,17042,127,109,6,24,-86,91,177,2257,351
62,orz200d.map,134,134,4385,32,36,101,97,11093,82,28,51,105,-50,-8,58,225,61
63,orz200d.map,134,134,3184,23,31,110,102,12923,96,74,37,59,-73,43,116,360,125
64,orz200d.map,134,134,12796,95,67,38,66,14974,111,33,22,100,-16,-34,50,1914,738
65,orz200d.map,134,134,10426,77,25,56,108,14403,107,68,26,65,-30,43,73,501,848
66,orz200d.map,134,134,14090,105,113,28,20,14654,109,85,24,48,-4,-28,32,179,185
67,orz200d.map,134,134,15832,118,113,15,20,12302,91,25,42,108,27,-88,115,2456,831
68,orz200d.map,134,134,6011,44,18,89,115,15718,117,93,16,40,-73,75,148,304,207
69,orz200d.map,134,134,13729,102,72,31,61,14005,104,64,29,69,-2,-8,10,11,11
70,orz200d.map,134,134,5200,38,25,95,108,14563,108,42,25,91,-70,17,87,2971,472
71,orz200d.map,134,134,16083,120,130,13,3,15364,114,45,19,88,6,-85,91,3395,899
72,orz200d.map,134,134,7073,52,28,81,105,3453,25,30,108,103,27,2,29,30,31
73,orz200d.map,134,134,13099,97,32,36,101,9181,68,64,65,69,29,32,61,116,1144
74,orz200d.map,134,134,15728,117,83,16,50,17308,129,111,4,22,-12,28,40,46,142
75,orz200d.map,134,134,6012,44,17,89,116,2519,18,26,115,107,26,9,35,39,42
76,orz200d.map,134,134,13954,104,115,29,18,494,3,41,130,92,101,-74,175,2675,2869
77,orz200d.map,134,134,9346,69,33,64,100,15086,112,55,21,78,-43,22,65,714,191
78,orz200d.map,134,134,13466,100,67,33,66,9884,73,31,60,102,27,-36,63,581,303
79,orz200d.map,134,134,12888,96,109,37,24,1963,14,46,119,87,82,-63,145,2483,3704
80,orz200d.map,134,134,6122,45,41,88,92,10259,76,58,57,75,-31,17,48,103,49
81,orz200d.map,134,134,16220,121,127,12,6,16221,121,126,12,7,0,-1,1,2,2
82,orz200d.map,134,134,11996,89,63,44,70,15430,115,113,18,20,-26,50,76,111,317
83,orz200d.map,134,134,7855,58,50,75,83,17839,133,116,0,17,-75,66,141,255,429
84,orz200d.map,134,134,4392,32,29,101,104,3586,26,31,107,102,6,2,8,9,9
85,orz200d.map,134,134,10105,75,78,58,55,6796,50,37,83,96,25,-41,66,131,133
86,orz200d.map,134,134,7497,55,6,78,127,6940,51,27,82,106,4,21,25,32,26
87,orz200d.map,134,134,15027,112,114,21,19,13838,103,97,30,36,9,-17,26,58,27
88,orz200d.map,134,134,10010,74,39,59,94,5725,42,36,91,97,32,-3,35,36,36
89,orz200d.map,134,134,13848,103,87,30,46,2373,17,38,116,95,86,-49,135,1115,518
90,orz200d.map,134,134,14088,105,115,28,18,15695,117,116,16,17,-12,1,13,14,14
91,orz200d.map,134,134,6800,50,33,83,100,1826,13,49,120,84,37,16,53,57,57
92,orz200d.map,134,134,4674,34,15,99,118,15831,118,114,15,19,-84,99,183,408,446
93,orz200d.map,134,134,16120,120,93,13,40,13601,101,66,32,67,19,-27,46,58,49
94,orz200d.map,134,134,2913,21,34,112,99,4916,36,41,97,92,-15,7,22,31,23
95,orz200d.map,134,134,11833,88,92,45,41,13093,97,38,36,95,-9,-54,63,4106,1840
96,orz200d.map,134,134,9067,67,44,66,89,7998,59,41,74,92,8,-3,11,12,12
97,orz200d.map,134,134,9181,68,64,65,69,10287,76,30,57,103,-8,-34,42,48,45
98,orz200d.map,134,134,13466,100,67,33,66,13716,102,85,31,48,-2,18,20,21,36
99,orz200d.map,134,134,10272,76,45,57,88,14961,111,46,22,87,-35,1,36,1536,391
0,orz201d.map,43,36,246,6,5,36,30,559,15,16,27,19,-9,11,20,21,22
1,orz201d.map,43,36,1209,33,14,9,21,233,6,18,36,17,27,4,31,32,42
2,orz201d.map,43,36,433,12,34,30,1,413,11,18,31,17,1,-16,17,41,76
3,orz201d.map,43,36,427,11,4,31,31,333,9,26,33,9,2,22,24,25,25
4,orz201d.map,43,36,445,12,22,30,13,1103,30,12,12,23,-18,-10,28,44,29
5,orz201d.map,43,36,809,22,18,20,17,1058,29,21,13,14,-7,3,10,11,11
6,orz201d.map,43,36,420,11,11,31,24,1327,36,4,6,31,-25,-7,32,123,187
7,orz201d.map,43,36,437,12,30,30,5,246,6,5,36,30,6,-25,31,50,154
8,orz201d.map,43,36,952,26,19,16,16,879,24,20,18,15,2,1,3,4,4
9,orz201d.map,43,36,1392,38,11,4,24,815,22,12,20,23,16,1,17,18,18
10,orz201d.map,43,36,490,13,13,29,22,380,10,15,32,20,3,2,5,6,6
11,orz201d.map,43,36,1312,36,19,6,16,427,11,4,31,31,25,-15,40,41,53
12,orz201d.map,43,36,288,8,35,34,0,1100,30,15,12,20,-22,-20,42,67,204
13,orz201d.map,43,36,1354,37,13,5,22,1221,33,2,9,33,4,-11,15,16,16
14,orz201d.map,43,36,769,21,22,21,13,399,11,32,31,3,10,10,20,145,170
15,orz201d.map,43,36,482,13,21,29,14,918,25,17,17,18,-12,-4,16,17,17
16,orz201d.map,43,36,1128,31,23,11,12,189,5,26,37,9,26,3,29,90,172
17,orz201d.map,43,36,147,4,32,38,3,854,23,9,19,26,-19,-23,42,100,65
18,orz201d.map,43,36,354,9,5,33,30,1277,35,18,7,17,-26,13,39,48,40
19,orz201d.map,43,36,442,12,25,30,10,554,15,21,27,14,-3,-4,7,8,8
20,orz201d.map,43,36,1315,36,16,6,19,399,11,32,31,3,25,16,41,282,63
21,orz201d.map,43,36,1219,33,4,9,31,950,26,21,16,14,7,17,24,27,25
22,orz201d.map,43,36,148,4,31,38,4,1326,36,5,6,30,-32,-26,58,149,80
23,orz201d.map,43,36,1283,35,12,7,23,252,7,35,35,0,28,23,51,52,82
24,orz201d.map,43,36,1424,39,15,3,20,1076,29,3,13,32,10,-12,22,53,24
25,orz201d.map,43,36,955,26,16,16,19,1205,33,18,9,17,-7,2,9,10,10
26,orz201d.map,43,36,1098,30,17,12,18,300,8,23,34,12,22,6,28,29,29
27,orz201d.map,43,36,74,2,33,40,2,373,10,22,32,13,-8,-11,19,21,38
28,orz201d.map,43,36,41,1,30,41,5,519,14,20,28,15,-13,-10,23,26,111
29,orz201d.map,43,36,922,25,13,17,22,294,8,29,34,6,17,16,33,34,52
30,orz201d.map,43,36,1313,36,18,6,17,1278,35,17,7,18,1,-1,2,3,3
31,orz201d.map,43,36,1203,33,20,9,15,996,27,11,15,24,6,-9,15,16,16
32,orz201d.map,43,36,848,23,15,19,20,1182,32,5,10,30,-9,-10,19,69,23
33,orz201d.map,43,36,425,11,6,31,29,326,9,33,33,2,2,27,29,72,41
34,orz201d.map,43,36,1164,32,23,10,12,317,8,6,34,29,24,-17,41,42,99
35,orz201d.map,43,36,1285,35,10,7,25,278,7,9,35,26,28,-1,29,141,123
36,orz201d.map,43,36,392,10,3,32,32,992,27,15,15,20,-17,12,29,30,30
37,orz201d.map,43,36,1329,36,2,6,33,423,11,8,31,27,25,6,31,198,143
38,orz201d.map,43,36,1389,38,14,4,21,815,22,12,20,23,16,-2,18,19,19
39,orz201d.map,43,36,344,9,15,33,20,385,10,10,32,25,-1,-5,6,7,7
40,orz201d.map,43,36,879,24,20,18,15,447,12,20,30,15,12,0,12,37,43
41,orz201d.map,43,36,353,9,6,33,29,1029,28,14,14,21,-19,8,27,73,65
42,orz201d.map,43,36,209,5,6,37,29,1237,34,22,8,13,-29,16,45,97,50
43,orz201d.map,43,36,554,15,21,27,14,1316,36,15,6,20,-21,-6,27,28,28
44,orz201d.map,43,36,293,8,30,34,5,1310,36,21,6,14,-28,-9,37,159,119
45,orz201d.map,43,36,457,12,10,30,25,290,8,33,34,2,4,23,27,95,45
46,orz201d.map,43,36,1186,32,1,10,34,292,8,31,34,4,24,30,54,81,328
47,orz201d.map,43,36,40,1,31,41,4,1257,34,2,8,33,-33,-29,62,173,118
48,orz201d.map,43,36,4,0,31,42,4,1293,35,2,7,33,-35,-29,64,176,121
49,orz201d.map,43,36,1328,36,3,6,32,1459,40,16,2,19,-4,13,17,18,18
50,orz201d.map,43,36,813,22,14,20,21,381,10,14,32,21,12,0,12,15,15
51,orz201d.map,43,36,1428,39,11,3,24,815,22,12,20,23,17,1,18,19,19
52,orz201d.map,43,36,465,12,2,30,33,446,12,21,30,14,0,19,19,20,20
53,orz201d.map,43,36,590,16,21,26,14,1326,36,5,6,30,-20,-16,36,46,39
54,orz201d.map,43,36,777,21,14,21,21,732,20,23,22,12,1,9,10,14,11
55,orz201d.map,43,36,274,7,13,35,22,565,15,10,27,25,-8,-3,11,12,12
56,orz201d.map,43,36,265,7,22,35,13,882,24,17,18,18,-17,-5,22,23,23
57,orz201d.map,43,36,1075,29,4,13,31,933,25,2,17,33,4,-2,6,7,7
58,orz201d.map,43,36,808,22,19,20,16,771,21,20,21,15,1,1,2,3,3
59,orz201d.map,43,36,1150,31,1,11,34,1183,32,4,10,31,-1,3,4,5,5
60,orz201d.map,43,36,118,3,25,39,10,1039,28,4,14,31,-25,-21,46,487,77
61,orz201d.map,43,36,444,12,23,30,12,1247,34,12,8,23,-22,-11,33,49,34
62,orz201d.map,43,36,921,25,14,17,21,815,22,12,20,23,3,-2,5,6,6
63,orz201d.map,43,36,1293,35,2,7,33,1143,31,8,11,27,4,6,10,17,11
64,orz201d.map,43,36,17,0,18,42,17,1421,39,18,3,17,-39,0,39,57,93
65,orz201d.map,43,36,1176,32,11,10,24,1429,39,10,3,25,-7,-1,8,9,9
66,orz201d.map,43,36,274,7,13,35,22,197,5,18,37,17,2,5,7,8,8
67,orz201d.map,43,36,1289,35,6,7,29,429,11,2,31,33,24,-4,28,198,141
68,orz201d.map,43,36,667,18,16,24,19,1382,38,21,4,14,-20,5,25,26,26
69,orz201d.map,43,36,588,16,23,26,12,557,15,18,27,17,1,-5,6,7,7
70,orz201d.map,43,36,155,4,24,38,11,1366,37,1,5,34,-33,-23,56,165,78
71,orz201d.map,43,36,364,10,31,32,4,278,7,9,35,26,3,-22,25,26,26
72,orz201d.map,43,36,1460,40,15,2,20,1247,34,12,8,23,6,-3,9,10,10
73,orz201d.map,43,36,776,21,15,21,20,850,23,13,19,22,-2,-2,4,5,5
74,orz201d.map,43,36,1494,41,17,1,18,182,5,33,37,2,36,16,52,63,53
75,orz201d.map,43,36,1310,36,21,6,14,1167,32,20,10,15,4,-1,5,6,6
76,orz201d.map,43,36,1502,41,9,1,26,446,12,21,30,14,29,12,41,43,75
77,orz201d.map,43,36,1067,29,12,13,23,1140,31,11,11,24,-2,-1,3,4,4
78,orz201d.map,43,36,992,27,15,15,20,1417,39,22,3,13,-12,7,19,20,20
79,orz201d.map,43,36,1107,30,8,12,27,924,25,11,17,24,5,3,8,9,9
80,orz201d.map,43,36,306,8,17,34,18,494,13,9,29,26,-5,-8,13,14,14
81,orz201d.map,43,36,122,3,21,39,14,1215,33,8,9,27,-30,-13,43,115,45
82,orz201d.map,43,36,218,6,33,36,2,1254,34,5,8,30,-28,-28,56,147,59
83,orz201d.map,43,36,194,5,21,37,14,1390,38,13,4,22,-33,-8,41,62,42
84,orz201d.map,43,36,1466,40,9,2,26,1388,38,15,4,20,2,6,8,9,9
85,orz201d.map,43,36,513,14,26,28,9,453,12,14,30,21,2,-12,14,15,15
86,orz201d.map,43,36,952,26,19,16,16,1324,36,7,6,28,-10,-12,22,23,23
87,orz201d.map,43,36,1353,37,14,5,21,1289,35,6,7,29,2,-8,10,11,11
88,orz201d.map,43,36,379,10,16,32,19,253,7,34,35,1,3,18,21,22,22
89,orz201d.map,43,36,137,3,6,39,29,1171,32,16,10,19,-29,10,39,40,42
90,orz201d.map,43,36,400,11,31,31,4,276,7,11,35,24,4,-20,24,25,25
91,orz201d.map,43,36,1104,30,11,12,24,85,2,22,40,13,28,11,39,41,79
92,orz201d.map,43,36,1427,39,12,3,23,1095,30,20,12,15,9,8,17,18,18
93,orz201d.map,43,36,457,12,10,30,25,811,22,16,20,19,-10,6,16,17,17
94,orz201d.map,43,36,1029,28,14,14,21,1462,40,13,2,22,-12,-1,13,14,14
95,orz201d.map,43,36,273,7,14,35,21,182,5,33,37,2,2,19,21,33,22
96,orz201d.map,43,36,156,4,23,38,12,199,5,16,37,19,-1,-7,8,9,9
97,orz201d.map,43,36,1315,36,16,6,19,1062,29,17,13,18,7,1,8,9,9
98,orz201d.map,43,36,275,7,12,35,23,245,6,6,36,29,1,-6,7,8,8
99,orz201d.map,43,36,1200,33,23,9,12,370,10,25,32,10,23,2,25,96,119
0,orz203d.map,27,15,42,2,2,24,12,108,7,11,19,3,-5,9,14,15,15
1,orz203d.map,27,15,200,13,9,13,5,110,7,9,19,5,6,0,6,7,7
2,orz203d.map,27,15,297,19,2,7,12,111,7,8,19,6,12,6,18,19,29
3,orz203d.map,27,15,264,17,5,9,9,383,25,6,1,8,-8,1,9,10,10
4,orz203d.map,27,15,366,24,8,2,6,326,21,3,5,11,3,-5,8,9,9
5,orz203d.map,27,15,290,19,9,7,5,171,11,8,15,6,8,-1,9,10,10
6,orz203d.map,27,15,124,8,10,18,4,324,21,5,5,9,-13,-5,18,19,19
7,orz203d.map,27,15,370,24,4,2,10,127,8,7,18,7,16,3,19,20,20
8,orz203d.map,27,15,154,10,10,16,4,181,12,13,14,1,-2,3,5,6,6
9,orz203d.map,27,15,276,18,8,8,6,229,15,10,11,4,3,2,5,6,6
10,orz203d.map,27,15,43,2,1,24,13,261,17,8,9,6,-15,7,22,23,23
11,orz203d.map,27,15,306,20,8,6,6,146,9,3,17,11,11,-5,16,17,17
12,orz203d.map,27,15,227,15,12,11,2,278,18,6,8,8,-3,-6,9,10,10
13,orz203d.map,27,15,196,13,13,13,1,189,12,5,14,9,1,-8,9,10,10
14,orz203d.map,27,15,296,19,3,7,11,147,9,2,17,12,10,-1,11,16,14
15,orz203d.map,27,15,219,14,5,12,9,364,24,10,2,4,-10,5,15,16,16
16,orz203d.map,27,15,113,7,6,19,8,70,4,4,22,10,3,-2,5,6,6
17,orz203d.map,27,15,168,11,11,15,3,262,17,7,9,7,-6,-4,10,11,11
18,orz203d.map,27,15,160,10,4,16,10,153,10,11,16,3,0,7,7,8,8
19,orz203d.map,27,15,211,14,13,12,1,364,24,10,2,4,-10,-3,13,14,14
20,orz203d.map,27,15,97,6,7,20,7,247,16,7,10,7,-10,0,10,11,11
21,orz203d.map,27,15,226,15,13,11,1,138,9,11,17,3,6,-2,8,9,9
22,orz203d.map,27,15,116,7,3,19,11,94,6,10,20,4,1,7,8,9,9
23,orz203d.map,27,15,266,17,3,9,11,212,14,12,12,2,3,9,12,13,13
24,orz203d.map,27,15,318,21,11,5,3,262,17,7,9,7,4,-4,8,9,9
25,orz203d.map,27,15,202,13,7,13,7,292,19,7,7,7,-6,0,6,7,7
26,orz203d.map,27,15,368,24,6,2,8,349,23,10,3,4,1,4,5,6,6
27,orz203d.map,27,15,352,23,7,3,7,191,12,3,14,11,11,-4,15,16,16
28,orz203d.map,27,15,124,8,10,18,4,94,6,10,20,4,2,0,2,3,3
29,orz203d.map,27,15,69,4,5,22,9,142,9,7,17,7,-5,2,7,8,8
30,orz203d.map,27,15,339,22,5,4,9,182,12,12,14,2,10,7,17,18,18
31,orz203d.map,27,15,155,10,9,16,5,109,7,10,19,4,3,1,4,5,5
32,orz203d.map,27,15,147,9,2,17,12,365,24,9,2,5,-15,7,22,23,23
33,orz203d.map,27,15,81,5,8,21,6,188,12,6,14,8,-7,-2,9,10,10
34,orz203d.map,27,15,147,9,2,17,12,191,12,3,14,11,-3,1,4,5,5
35,orz203d.map,27,15,240,16,14,10,0,176,11,3,15,11,5,-11,16,17,17
36,orz203d.map,27,15,203,13,6,13,8,167,11,12,15,2,2,6,8,9,9
37,orz203d.map,27,15,233,15,6,11,8,370,24,4,2,10,-9,-2,11,12,12
38,orz203d.map,27,15,312,20,2,6,12,351,23,8,3,6,-3,6,9,10,10
39,orz203d.map,27,15,354,23,5,3,9,306,20,8,6,6,3,3,6,7,7
40,orz203d.map,27,15,350,23,9,3,5,335,22,9,4,5,1,0,1,2,2
41,orz203d.map,27,15,232,15,7,11,7,294,19,5,7,9,-4,-2,6,7,7
42,orz203d.map,27,15,123,8,11,18,3,343,22,1,4,13,-14,-10,24,35,25
43,orz203d.map,27,15,290,19,9,7,5,44,2,0,24,14,17,-9,26,27,27
44,orz203d.map,27,15,172,11,7,15,7,118,7,1,19,13,4,-6,10,11,11
45,orz203d.map,27,15,170,11,9,15,5,154,10,10,16,4,1,1,2,3,3
46,orz203d.map,27,15,217,14,7,12,7,319,21,10,5,4,-7,3,10,11,11
47,orz203d.map,27,15,259,17,10,9,4,291,19,8,7,6,-2,-2,4,5,5
48,orz203d.map,27,15,137,9,12,17,2,289,19,10,7,4,-10,-2,12,13,13
49,orz203d.map,27,15,184,12,10,14,4,134,8,0,18,14,4,-10,14,15,15
50,orz203d.map,27,15,168,11,11,15,3,350,23,9,3,5,-12,-2,14,15,15
51,orz203d.map,27,15,73,4,1,22,13,217,14,7,12,7,-10,6,16,17,17
52,orz203d.map,27,15,168,11,11,15,3,58,3,1,23,13,8,-10,18,19,19
53,orz203d.map,27,15,309,20,5,6,9,342,22,2,4,12,-2,-3,5,6,6
54,orz203d.map,27,15,381,25,8,1,6,70,4,4,22,10,21,-4,25,26,26
55,orz203d.map,27,15,116,7,3,19,11,205,13,4,13,10,-6,1,7,8,8
56,orz203d.map,27,15,281,18,3,8,11,101,6,3,20,11,12,0,12,15,15
57,orz203d.map,27,15,198,13,11,13,3,191,12,3,14,11,1,-8,9,10,10
58,orz203d.map,27,15,354,23,5,3,9,333,22,11,4,3,1,6,7,8,8
59,orz203d.map,27,15,291,19,8,7,6,159,10,5,16,9,9,-3,12,13,13
60,orz203d.map,27,15,83,5,6,21,8,155,10,9,16,5,-5,3,8,9,9
61,orz203d.map,27,15,280,18,4,8,10,309,20,5,6,9,-2,1,3,4,4
62,orz203d.map,27,15,81,5,8,21,6,289,19,10,7,4,-14,2,16,17,17
63,orz203d.map,27,15,137,9,12,17,2,265,17,4,9,10,-8,-8,16,17,17
64,orz203d.map,27,15,104,6,0,20,14,98,6,6,20,8,0,6,6,7,7
65,orz203d.map,27,15,381,25,8,1,6,293,19,6,7,8,6,-2,8,9,9
66,orz203d.map,27,15,220,14,4,12,10,189,12,5,14,9,2,1,3,4,4
67,orz203d.map,27,15,355,23,4,3,10,12,0,2,26,12,23,-2,25,26,26
68,orz203d.map,27,15,288,19,11,7,3,145,9,4,17,10,10,-7,17,18,18
69,orz203d.map,27,15,280,18,4,8,10,354,23,5,3,9,-5,1,6,7,7
70,orz203d.map,27,15,42,2,2,24,12,231,15,8,11,6,-13,6,19,20,20
71,orz203d.map,27,15,218,14,6,12,8,267,17,2,9,12,-3,-4,7,8,8
72,orz203d.map,27,15,370,24,4,2,10,86,5,3,21,11,19,-1,20,21,21
73,orz203d.map,27,15,112,7,7,19,7,161,10,3,16,11,-3,-4,7,8,8
74,orz203d.map,27,15,382,25,7,1,7,262,17,7,9,7,8,0,8,9,9
75,orz203d.map,27,15,64,4,10,22,4,87,5,2,21,12,-1,-8,9,10,10
76,orz203d.map,27,15,160,10,4,16,10,256,17,13,9,1,-7,9,16,17,17
77,orz203d.map,27,15,112,7,7,19,7,79,5,10,21,4,2,3,5,6,6
78,orz203d.map,27,15,352,23,7,3,7,117,7,2,19,12,16,-5,21,22,22
79,orz203d.map,27,15,185,12,9,14,5,292,19,7,7,7,-7,-2,9,10,10
80,orz203d.map,27,15,112,7,7,19,7,143,9,6,17,8,-2,-1,3,4,4
81,orz203d.map,27,15,336,22,8,4,6,111,7,8,19,6,15,0,15,16,16
82,orz203d.map,27,15,42,2,2,24,12,139,9,10,17,4,-7,8,15,16,16
83,orz203d.map,27,15,168,11,11,15,3,319,21,10,5,4,-10,-1,11,12,12
84,orz203d.map,27,15,79,5,10,21,4,255,17,14,9,0,-12,4,16,17,17
85,orz203d.map,27,15,370,24,4,2,10,172,11,7,15,7,13,3,16,17,17
86,orz203d.map,27,15,397,26,7,0,7,278,18,6,8,8,8,-1,9,10,10
87,orz203d.map,27,15,248,16,6,10,8,111,7,8,19,6,9,2,11,12,12
88,orz203d.map,27,15,352,23,7,3,7,114,7,5,19,9,16,-2,18,19,19
89,orz203d.map,27,15,225,15,14,11,0,231,15,8,11,6,0,-6,6,7,7
90,orz203d.map,27,15,200,13,9,13,5,303,20,11,6,3,-7,2,9,10,10
91,orz203d.map,27,15,42,2,2,24,12,172,11,7,15,7,-9,5,14,15,15
92,orz203d.map,27,15,242,16,12,10,2,133,8,1,18,13,8,-11,19,20,20
93,orz203d.map,27,15,336,22,8,4,6,182,12,12,14,2,10,4,14,15,15
94,orz203d.map,27,15,27,1,2,25,12,95,6,9,20,5,-5,7,12,13,13
95,orz203d.map,27,15,321,21,8,5,6,98,6,6,20,8,15,-2,17,18,18
96,orz203d.map,27,15,307,20,7,6,7,262,17,7,9,7,3,0,3,4,4
97,orz203d.map,27,15,171,11,8,15,6,246,16,8,10,6,-5,0,5,6,6
98,orz203d.map,27,15,349,23,10,3,4,326,21,3,5,11,2,-7,9,10,10
99,orz203d.map,27,15,145,9,4,17,10,333,22,11,4,3,-13,7,20,21,21
0,orz300d.map,384,476,108136,227,391,156,84,87673,184,386,199,89,43,-5,48,25634,8598
1,orz300d.map,384,476,111448,234,411,149,64,170642,358,241,25,234,-124,-170,294,5331,646
2,orz300d.map,384,476,91905,193,438,190,37,99290,208,193,175,282,-15,-245,260,11138,15756
3,orz300d.map,384,476,51081,107,326,276,149,164007,344,212,39,263,-237,-114,351,22625,40707
4,orz300d.map,384,476,63865,134,394,249,81,176820,371,251,12,224,-237,-143,380,6637,17423
5,orz300d.map,384,476,75251,158,432,225,43,38757,81,274,302,201,77,-158,235,21553,25846
6,orz300d.map,384,476,174435,366,256,17,219,25813,54,366,329,109,312,110,422,34788,31373
7,orz300d.map,384,476,88334,185,201,198,274,1183,2,244,381,231,183,43,226,9517,7649
8,orz300d.map,384,476,106904,224,195,159,280,135949,285,186,98,289,-61,-9,70,8198,8536
9,orz300d.map,384,476,136220,286,391,97,84,163991,344,228,39,247,-58,-163,221,331,754
10,orz300d.map,384,476,83141,174,158,209,317,47615,100,460,283,15,74,302,376,29487,28982
11,orz300d.map,384,476,104130,218,113,165,362,38099,80,456,303,19,138,343,481,35817,16189
12,orz300d.map,384,476,103888,218,355,165,120,149996,315,419,68,56,-97,64,161,439,1443
13,orz300d.map,384,476,98817,207,190,176,285,130333,273,90,110,385,-66,-100,166,11269,13234
14,orz300d.map,384,476,129096,271,375,112,100,109896,230,59,153,416,41,-316,357,4639,474
15,orz300d.map,384,476,119544,251,407,132,68,79327,166,164,217,311,85,-243,328,6911,10768
16,orz300d.map,384,476,102992,216,299,167,176,99695,209,264,174,211,7,-35,42,3385,3193
17,orz300d.map,384,476,138105,290,410,93,65,84434,177,293,206,182,113,-117,230,29100,6175
18,orz300d.map,384,476,135328,284,331,99,144,117986,247,61,136,414,37,-270,307,2002,366
19,orz300d.map,384,476,70670,148,253,235,222,19535,41,456,342,19,107,203,310,8857,17136
20,orz300d.map,384,476,134992,283,191,100,284,106481,223,142,160,333,60,-49,109,11736,8843
21,orz300d.map,384,476,111776,234,83,149,392,138632,291,359,92,116,-57,276,333,449,3689
22,orz300d.map,384,476,5802,12,385,371,90,16718,35,417,348,58,-23,32,55,56,84
23,orz300d.map,384,476,147746,310,289,73,186,13421,28,382,355,93,282,93,375,28079,35930
24,orz300d.map,384,476,176833,371,238,12,237,124086,260,149,123,326,111,-89,200,624,1282
25,orz300d.map,384,476,139506,293,437,90,38,62107,130,248,253,227,163,-189,352,57993,20930
26,orz300d.map,384,476,48784,102,243,281,232,22886,48,437,335,38,54,194,248,12456,12341
27,orz300d.map,384,476,64401,135,334,248,141,57663,121,408,262,67,14,74,88,22426,25884
28,orz300d.map,384,476,11129,23,294,360,181,47683,100,392,283,83,-77,98,175,7187,8598
29,orz300d.map,384,476,25897,54,282,329,193,129717,272,230,111,245,-218,-52,270,19942,18757
30,orz300d.map,384,476,35273,74,426,309,49,13420,28,383,355,92,46,-43,89,1312,1212
31,orz300d.map,384,476,27392,57,215,326,260,120509,253,394,130,81,-196,179,375,26632,49138
32,orz300d.map,384,476,145394,305,261,78,214,112165,235,170,148,305,70,-91,161,18027,20900
33,orz300d.map,384,476,149708,314,231,69,244,98869,207,138,176,337,107,-93,200,18581,17550
34,orz300d.map,384,476,136303,286,308,97,167,85231,179,448,204,27,107,140,247,9706,344
35,orz300d.map,384,476,82969,174,330,209,145,83846,176,405,207,70,-2,75,77,8595,20889
36,orz300d.map,384,476,154440,324,259,59,216,166373,349,226,34,249,-25,-33,58,59,59
37,orz300d.map,384,476,155890,327,237,56,238,109551,230,404,153,71,97,167,264,741,5437
38,orz300d.map,384,476,84483,177,244,206,231,144982,304,197,79,278,-127,-47,174,10719,11063
39,orz300d.map,384,476,125819,264,320,119,155,50132,105,323,278,152,159,3,162,38491,17727
40,orz300d.map,384,476,91699,192,168,191,307,108805,228,198,155,277,-36,30,66,67,68
41,orz300d.map,384,476,89662,188,301,195,174,112662,236,149,147,326,-48,-152,200,729,350
42,orz300d.map,384,476,115963,243,180,140,295,17276,36,335,347,140,207,155,362,10395,2382
43,orz300d.map,384,476,145252,305,403,78,72,97278,204,301,179,174,101,-102,203,15883,1922
44,orz300d.map,384,476,123809,260,426,123,49,12419,26,432,357,43,234,6,240,6361,4675
45,orz300d.map,384,476,147317,309,242,74,233,119406,250,69,133,406,59,-173,232,1229,7987
46,orz300d.map,384,476,101716,213,147,170,328,122063,256,268,127,207,-43,121,164,4579,7243
47,orz300d.map,384,476,44891,94,328,289,147,77359,162,228,221,247,-68,-100,168,859,3930
48,orz300d.map,384,476,103432,217,335,166,140,59139,124,360,259,115,93,25,118,17594,8632
49,orz300d.map,384,476,139049,292,418,91,57,94978,199,221,184,254,93,-197,290,5292,1663
50,orz300d.map,384,476,145738,306,393,77,82,111708,234,151,149,324,72,-242,314,13639,2121
51,orz300d.map,384,476,4038,8,245,375,230,156790,329,289,54,186,-321,44,365,32447,44697
52,orz300d.map,384,476,80702,169,217,214,258,147799,310,236,73,239,-141,19,160,17602,12573
53,orz300d.map,384,476,138226,290,289,93,186,134147,281,84,102,391,9,-205,214,215,215
54,orz300d.map,384,476,140596,295,299,88,176,113446,238,317,145,158,57,18,75,76,76
55,orz300d.map,384,476,81633,171,238,212,237,58095,122,452,261,23,49,214,263,29625,28620
56,orz300d.map,384,476,133052,279,227,104,248,65270,137,417,246,58,142,190,332,13691,1040
57,orz300d.map,384,476,40128,84,331,299,144,22413,47,434,336,41,37,103,140,3997,6082
58,orz300d.map,384,476,26707,56,424,327,51,72404,152,423,231,52,-96,-1,97,2268,2446
59,orz300d.map,384,476,96931,203,172,180,303,160647,337,240,46,235,-134,68,202,17171,16188
60,orz300d.map,384,476,125563,263,100,120,375,136380,286,231,97,244,-23,131,154,155,155
61,orz300d.map,384,476,116212,244,407,139,68,159222,334,237,49,238,-90,-170,260,4402,1036
62,orz300d.map,384,476,103004,216,287,167,188,142598,299,201,84,274,-83,-86,169,2076,227
63,orz300d.map,384,476,20579,43,364,340,111,73071,153,232,230,243,-110,-132,242,3494,3058
64,orz300d.map,384,476,99605,209,354,174,121,139590,293,353,90,122,-84,-1,85,86,86
65,orz300d.map,384,476,60657,127,270,256,205,28783,60,252,323,223,67,-18,85,1550,412
66,orz300d.map,384,476,80082,168,361,215,114,62540,131,291,252,184,37,-70,107,8947,14586
67,orz300d.map,384,476,104896,220,299,163,176,146731,308,352,75,123,-88,53,141,1393,9454
68,orz300d.map,384,476,29566,62,421,321,54,85479,179,200,204,275,-117,-221,338,19793,22459
69,orz300d.map,384,476,137667,289,372,94,103,157300,330,255,53,220,-41,-117,158,244,178
70,orz300d.map,384,476,128147,269,372,114,103,75877,159,282,224,193,110,-90,200,20773,6839
71,orz300d.map,384,476,35305,74,394,309,81,85979,180,176,203,299,-106,-218,324,12606,11860
72,orz300d.map,384,476,150075,315,340,68,135,108655,228,348,155,127,87,8,95,645,844
73,orz300d.map,384,476,96480,202,147,181,328,126300,265,315,118,160,-63,168,231,1119,5057
74,orz300d.map,384,476,39748,83,235,300,240,148558,312,429,71,46,-229,194,423,22674,55189
75,orz300d.map,384,476,5306,11,405,372,70,53959,113,304,270,171,-102,-101,203,5010,1487
76,orz300d.map,384,476,112745,236,66,147,409,135252,284,407,99,68,-48,341,389,505,4528
77,orz300d.map,384,476,108596,228,407,155,68,122535,257,272,126,203,-29,-135,164,2924,1468
78,orz300d.map,384,476,118916,249,83,134,392,110150,231,281,152,194,18,198,216,2667,5424
79,orz300d.map,384,476,56664,119,455,264,20,136998,287,89,96,386,-168,-366,534,1300,6994
80,orz300d.map,384,476,96394,202,233,181,242,134012,281,219,102,256,-79,-14,93,6807,6862
81,orz300d.map,384,476,41128,86,283,297,192,129816,272,131,111,344,-186,-152,338,23996,26977
82,orz300d.map,384,476,140137,294,282,89,193,139668,293,275,90,200,1,-7,8,9,9
83,orz300d.map,384,476,116209,244,410,139,65,16798,35,337,348,138,209,-73,282,22128,16235
84,orz300d.map,384,476,54416,114,323,269,152,86527,181,104,202,371,-67,-219,286,5804,14383
85,orz300d.map,384,476,129434,271,37,112,438,33947,71,324,312,151,200,287,487,37950,24517
86,orz300d.map,384,476,1588,3,315,380,160,5277,11,434,372,41,-8,119,127,3804,12144
87,orz300d.map,384,476,135824,285,311,98,164,116387,244,232,139,243,41,-79,120,4970,531
88,orz300d.map,384,476,34938,73,285,310,190,64399,135,336,248,139,-62,51,113,1449,137
89,orz300d.map,384,476,57777,121,294,262,181,6236,13,427,370,48,108,133,241,1866,6773
90,orz300d.map,384,476,96826,203,277,180,198,121915,256,416,127,59,-53,139,192,6405,22596
91,orz300d.map,384,476,120573,253,330,130,145,139502,293,441,90,34,-40,111,151,169,472
92,orz300d.map,384,476,73970,155,285,228,190,37679,79,400,304,75,76,115,191,5514,6346
93,orz300d.map,384,476,135619,284,40,99,435,80556,169,363,214,112,115,323,438,15195,4263
94,orz300d.map,384,476,9706,20,289,363,186,82412,173,411,210,64,-153,122,275,29686,28787
95,orz300d.map,384,476,125115,262,72,121,403,11517,24,382,359,93,238,310,548,14705,16324
96,orz300d.map,384,476,126456,265,159,118,316,144925,304,254,79,221,-39,95,134,7181,1026
97,orz300d.map,384,476,136810,287,277,96,198,160663,337,224,46,251,-50,-53,103,1969,3885
98,orz300d.map,384,476,46331,97,316,286,159,105582,221,89,162,386,-124,-227,351,32260,22424
99,orz300d.map,384,476,135265,284,394,99,81,113507,238,256,145,219,46,-138,184,2194,252
0,orz301d.map,153,120,13723,114,76,38,43,16239,135,80,17,39,-21,4,25,304,108
1,orz301d.map,153,120,13564,113,115,39,4,17799,148,80,4,39,-35,-35,70,351,233
2,orz301d.map,153,120,2801,23,78,129,41,15876,132,83,20,36,-109,5,114,1523,1178
3,orz301d.map,153,120,14473,120,46,32,73,15638,130,81,22,38,-10,35,45,553,59
4,orz301d.map,153,120,13989,116,50,36,69,7023,58,56,94,63,58,6,64,194,188
5,orz301d.map,153,120,11457,95,62,57,57,2830,23,49,129,70,72,-13,85,86,149
6,orz301d.map,153,120,3069,25,50,127,69,4743,39,56,113,63,-14,6,20,21,21
7,orz301d.map,153,120,17241,143,38,9,81,17077,142,82,10,37,1,44,45,1141,1116
8,orz301d.map,153,120,2228,18,51,134,68,10381,86,58,66,61,-68,7,75,76,76
9,orz301d.map,153,120,15233,126,6,26,113,17331,144,68,8,51,-18,62,80,268,711
10,orz301d.map,153,120,12056,100,63,52,56,5580,46,59,106,60,54,-4,58,59,134
11,orz301d.map,153,120,15664,130,55,22,64,9659,80,60,72,59,50,5,55,60,96
12,orz301d.map,153,120,14409,120,110,32,9,14749,122,10,30,109,-2,-100,102,103,103
13,orz301d.map,153,120,9664,80,55,72,64,14475,120,44,32,75,-40,-11,51,132,340
14,orz301d.map,153,120,16030,133,49,19,70,14183,118,96,34,23,15,47,62,107,63
15,orz301d.map,153,120,2216,18,63,134,56,7864,65,55,87,64,-47,-8,55,130,56
16,orz301d.map,153,120,15877,132,82,20,37,11447,95,72,57,47,37,-10,47,412,660
17,orz301d.map,153,120,14086,117,73,35,46,13967,116,72,36,47,1,-1,2,3,3
18,orz301d.map,153,120,8224,68,55,84,64,14756,122,3,30,116,-54,-52,106,230,757
19,orz301d.map,153,120,13594,113,85,39,34,7495,62,64,90,55,51,-21,72,402,675
20,orz301d.map,153,120,14357,119,42,33,77,18279,152,80,0,39,-33,38,71,1159,241
21,orz301d.map,153,120,13613,113,66,39,53,7263,60,56,92,63,53,-10,63,79,187
22,orz301d.map,153,120,14614,121,25,31,94,11327,94,72,58,47,27,47,74,869,120
23,orz301d.map,153,120,9296,77,63,75,56,2223,18,56,134,63,59,-7,66,67,117
24,orz301d.map,153,120,13809,115,110,37,9,7019,58,60,94,59,57,-50,107,271,773
25,orz301d.map,153,120,15524,129,75,23,44,2205,18,74,134,45,111,-1,112,859,538
26,orz301d.map,153,120,1865,15,54,137,65,16254,135,65,17,54,-120,11,131,405,142
27,orz301d.map,153,120,16020,133,59,19,60,15447,128,32,24,87,5,-27,32,377,148
28,orz301d.map,153,120,12891,107,68,45,51,6419,53,60,99,59,54,-8,62,88,217
29,orz301d.map,153,120,13739,114,60,38,59,13687,114,112,38,7,0,52,52,279,163
30,orz301d.map,153,120,13263,110,56,42,63,5095,42,64,110,55,68,8,76,77,172
31,orz301d.map,153,120,2476,20,43,132,76,15654,130,65,22,54,-110,22,132,386,143
32,orz301d.map,153,120,17192,143,87,9,32,3063,25,56,127,63,118,-31,149,368,2015
33,orz301d.map,153,120,11097,92,62,60,57,14268,118,11,34,108,-26,-51,77,441,197
34,orz301d.map,153,120,4859,40,60,112,59,15511,129,88,23,31,-89,28,117,354,198
35,orz301d.map,153,120,15216,126,23,26,96,2347,19,52,133,67,107,29,136,719,575
36,orz301d.map,153,120,14878,123,1,29,118,17591,146,48,6,71,-23,47,70,375,227
37,orz301d.map,153,120,14201,118,78,34,41,2099,17,60,135,59,101,-18,119,165,604
38,orz301d.map,153,120,13397,111,42,41,77,13494,112,65,40,54,-1,23,24,25,25
39,orz301d.map,153,120,15193,126,46,26,73,8459,70,60,82,59,56,14,70,101,180
40,orz301d.map,153,120,2816,23,63,129,56,9773,81,66,71,53,-58,3,61,176,78
41,orz301d.map,153,120,14552,121,87,31,32,781,6,58,146,61,115,-29,144,228,690
42,orz301d.map,153,120,17227,143,52,9,67,8822,73,57,79,62,70,5,75,91,318
43,orz301d.map,153,120,14346,119,53,33,66,14930,124,69,28,50,-5,16,21,22,22
44,orz301d.map,153,120,14620,121,19,31,100,7503,62,56,90,63,59,37,96,535,230
45,orz301d.map,153,120,12753,106,86,46,33,11710,97,49,55,70,9,-37,46,260,413
46,orz301d.map,153,120,14697,122,62,30,57,12660,105,59,47,60,17,-3,20,21,21
47,orz301d.map,153,120,14715,122,44,30,75,15805,131,34,21,85,-9,-10,19,135,37
48,orz301d.map,153,120,7139,59,60,93,59,15415,128,64,24,55,-69,4,73,167,79
49,orz301d.map,153,120,15874,132,85,20,34,17107,142,52,10,67,-10,-33,43,388,644
50,orz301d.map,153,120,12913,107,46,45,73,3282,27,77,125,42,80,31,111,142,418
51,orz301d.map,153,120,13258,110,61,42,58,12302,102,57,50,62,8,-4,12,13,13
52,orz301d.map,153,120,14826,123,53,29,66,7500,62,59,90,60,61,6,67,80,188
53,orz301d.map,153,120,2688,22,71,130,48,14245,118,34,34,85,-96,-37,133,561,190
54,orz301d.map,153,120,3178,26,61,126,58,12181,101,58,51,61,-75,-3,78,79,79
55,orz301d.map,153,120,3408,28,71,124,48,14535,121,104,31,15,-93,33,126,506,1018
56,orz301d.map,153,120,5337,44,62,108,57,14372,119,27,33,92,-75,-35,110,321,177
57,orz301d.map,153,120,12768,106,71,46,48,10853,90,66,62,53,16,-5,21,94,65
58,orz301d.map,153,120,13682,114,117,38,2,16253,135,66,17,53,-21,-51,72,73,207
59,orz301d.map,153,120,14396,119,3,33,116,17469,145,50,7,69,-26,47,73,490,184
60,orz301d.map,153,120,17811,148,68,4,51,13358,111,81,41,38,37,13,50,197,389
61,orz301d.map,153,120,3434,28,45,124,74,14173,118,106,34,13,-90,61,151,1082,292
62,orz301d.map,153,120,8578,71,61,81,58,15795,131,44,21,75,-60,-17,77,182,109
63,orz301d.map,153,120,5339,44,60,108,59,8579,71,60,81,59,-27,0,27,28,28
64,orz301d.map,153,120,15064,125,55,27,64,4380,36,59,116,60,89,4,93,98,254
65,orz301d.map,153,120,13506,112,53,40,66,13682,114,117,38,2,-2,64,66,402,208
66,orz301d.map,153,120,14498,120,21,32,98,15413,128,66,24,53,-8,45,53,54,54
67,orz301d.map,153,120,11099,92,60,60,59,11934,99,65,53,54,-7,5,12,13,13
68,orz301d.map,153,120,2449,20,70,132,49,12549,104,50,48,69,-84,-20,104,1031,128
69,orz301d.map,153,120,3905,32,54,120,65,13397,111,42,41,77,-79,-12,91,325,272
70,orz301d.map,153,120,17674,147,85,5,34,4134,34,65,118,54,113,-20,133,808,1670
71,orz301d.map,153,120,15889,132,70,20,49,13989,116,50,36,69,16,-20,36,37,37
72,orz301d.map,153,120,14601,121,38,31,81,14115,117,44,35,75,4,6,10,11,11
73,orz301d.map,153,120,15633,130,86,22,33,12755,106,84,46,35,24,-2,26,814,453
74,orz301d.map,153,120,14626,121,13,31,106,13255,110,64,42,55,11,51,62,158,81
75,orz301d.map,153,120,12419,103,60,49,59,14831,123,48,29,71,-20,-12,32,33,56
76,orz301d.map,153,120,14401,120,118,32,1,4506,37,53,115,66,83,-65,148,359,387
77,orz301d.map,153,120,9538,79,61,73,58,3302,27,57,125,62,52,-4,56,57,57
78,orz301d.map,153,120,16044,133,35,19,84,5102,42,57,110,62,91,22,113,500,1231
79,orz301d.map,153,120,3427,28,52,124,67,18037,150,82,2,37,-122,30,152,2027,396
80,orz301d.map,153,120,13872,115,47,37,72,13749,114,50,38,69,1,3,4,5,5
81,orz301d.map,153,120,14600,121,39,31,80,16260,135,59,17,60,-14,20,34,35,35
82,orz301d.map,153,120,778,6,61,146,58,3663,30,56,122,63,-24,-5,29,30,30
83,orz301d.map,153,120,1253,10,66,142,53,16269,135,50,17,69,-125,-16,141,541,166
84,orz301d.map,153,120,15286,127,73,25,46,14663,122,96,30,23,5,23,28,60,42
85,orz301d.map,153,120,14664,122,95,30,24,13115,109,84,43,35,13,-11,24,938,229
86,orz301d.map,153,120,15083,125,36,27,83,12054,100,65,52,54,25,29,54,108,506
87,orz301d.map,153,120,2700,22,59,130,60,2445,20,74,132,45,2,15,17,18,18
88,orz301d.map,153,120,14242,118,37,34,82,13626,113,53,39,66,5,16,21,22,36
89,orz301d.map,153,120,14692,122,67,30,52,15205,126,34,26,85,-4,-33,37,38,38
90,orz301d.map,153,120,17330,144,69,8,50,4013,33,66,119,53,111,-3,114,306,543
91,orz301d.map,153,120,4382,36,57,116,62,13271,110,48,42,71,-74,-9,83,267,151
92,orz301d.map,153,120,12278,102,81,50,38,14471,120,48,32,71,-18,-33,51,74,623
93,orz301d.map,153,120,9778,81,61,71,58,15663,130,56,22,63,-49,-5,54,78,55
94,orz301d.map,153,120,4984,41,55,111,64,9417,78,62,74,57,-37,7,44,45,45
95,orz301d.map,153,120,11454,95,65,57,54,13111,109,88,43,31,-14,23,37,412,307
96,orz301d.map,153,120,5335,44,64,108,55,14919,124,80,28,39,-80,16,96,288,461
97,orz301d.map,153,120,16889,140,30,12,89,1254,10,65,142,54,130,35,165,367,2399
98,orz301d.map,153,120,14361,119,38,33,81,14151,117,8,35,111,2,-30,32,51,33
99,orz301d.map,153,120,15442,128,37,24,82,2093,17,66,135,53,111,29,140,204,1689
0,orz302d.map,140,137,5474,39,5,100,131,3939,28,33,111,103,11,28,39,51,60
1,orz302d.map,140,137,5465,39,14,100,122,8291,60,65,79,71,-21,51,72,73,117
2,orz302d.map,140,137,5819,42,71,97,65,8013,58,69,81,67,-16,-2,18,19,19
3,orz302d.map,140,137,4243,30,3,109,133,16679,121,34,18,102,-91,31,122,647,125
4,orz302d.map,140,137,11209,81,24,58,112,9143,66,35,73,101,15,11,26,27,27
5,orz302d.map,140,137,6506,47,69,92,67,10663,77,22,62,114,-30,-47,77,78,78
6,orz302d.map,140,137,16021,116,7,23,129,10487,76,61,63,75,40,54,94,1953,914
7,orz302d.map,140,137,15996,116,32,23,104,6533,47,42,92,94,69,10,79,282,649
8,orz302d.map,140,137,8507,62,123,77,13,7798,56,10,83,126,6,-113,119,1144,1610
9,orz302d.map,140,137,6000,43,27,96,109,12576,91,27,48,109,-48,0,48,180,72
10,orz302d.map,140,137,8101,59,118,80,18,16430,119,9,20,127,-60,-109,169,2102,2888
11,orz302d.map,140,137,10472,76,76,63,60,6906,50,80,89,56,26,4,30,179,97
12,orz302d.map,140,137,8700,63,67,76,69,13543,98,19,41,117,-35,-48,83,537,941
13,orz302d.map,140,137,8329,60,27,79,109,6726,49,123,90,13,11,96,107,1836,1407
14,orz302d.map,140,137,10588,77,97,62,39,15871,115,20,24,116,-38,-77,115,1195,1669
15,orz302d.map,140,137,10065,73,72,66,64,9454,69,135,70,1,4,63,67,572,171
16,orz302d.map,140,137,16161,117,4,22,132,383,2,27,137,109,115,23,138,142,741
17,orz302d.map,140,137,4346,31,37,108,99,5731,41,22,98,114,-10,-15,25,26,26
18,orz302d.map,140,137,8353,60,3,79,133,6314,46,124,93,12,14,121,135,2247,1431
19,orz302d.map,140,137,7928,57,17,82,119,6802,49,47,90,89,8,30,38,39,39
20,orz302d.map,140,137,11283,82,87,57,49,7069,51,54,88,82,31,-33,64,65,113
21,orz302d.map,140,137,8697,63,70,76,66,9161,66,17,73,119,-3,-53,56,411,553
22,orz302d.map,140,137,9098,66,80,73,56,6643,48,69,91,67,18,-11,29,30,88
23,orz302d.map,140,137,5036,36,32,103,104,7279,53,118,86,18,-17,86,103,1717,569
24,orz302d.map,140,137,1764,12,16,127,120,9302,67,13,72,123,-55,-3,58,184,153
25,orz302d.map,140,137,10451,76,97,63,39,10325,75,86,64,50,1,-11,12,13,13
26,orz302d.map,140,137,8473,61,20,78,116,14631,106,27,33,109,-45,7,52,161,53
27,orz302d.map,140,137,9784,71,79,68,57,6924,50,62,89,74,21,-17,38,39,78
28,orz302d.map,140,137,9056,66,122,73,14,7637,55,34,84,102,11,-88,99,928,780
29,orz302d.map,140,137,6272,45,29,94,107,10729,78,93,61,43,-33,64,97,230,98
30,orz302d.map,140,137,5170,37,35,102,101,6420,46,18,93,118,-9,-17,26,27,27
31,orz302d.map,140,137,7737,56,71,83,65,12073,88,119,51,17,-32,48,80,86,241
32,orz302d.map,140,137,4077,29,32,110,104,10005,73,132,66,4,-44,100,144,1779,738
33,orz302d.map,140,137,5969,43,58,96,78,7514,54,20,85,116,-11,-38,49,50,50
34,orz302d.map,140,137,7193,52,67,87,69,6238,45,63,94,73,7,-4,11,12,12
35,orz302d.map,140,137,18197,132,23,7,113,10567,77,118,62,18,55,95,150,1751,2503
36,orz302d.map,140,137,10625,77,60,62,76,3123,22,27,117,109,55,-33,88,850,1204
37,orz302d.map,140,137,6498,47,77,92,59,534,3,13,136,123,44,-64,108,179,174
38,orz302d.map,140,137,1753,12,27,127,109,13404,97,21,42,115,-85,-6,91,92,92
39,orz302d.map,140,137,10157,74,117,65,19,10862,79,97,60,39,-5,-20,25,79,47
40,orz302d.map,140,137,11011,80,85,59,51,17244,125,17,14,119,-45,-68,113,983,1747
41,orz302d.map,140,137,11524,84,120,55,16,9565,69,24,70,112,15,-96,111,1520,853
42,orz302d.map,140,137,8338,60,18,79,118,17655,128,17,11,119,-68,-1,69,70,70
43,orz302d.map,140,137,1753,12,27,127,109,4209,30,37,109,99,-18,10,28,60,117
44,orz302d.map,140,137,7635,55,36,84,100,15868,115,23,24,113,-60,-13,73,74,74
45,orz302d.map,140,137,10348,75,63,64,73,19015,138,27,1,109,-63,-36,99,1838,1801
46,orz302d.map,140,137,3674,26,24,113,112,5470,39,9,100,127,-13,-15,28,33,29
47,orz302d.map,140,137,11302,82,68,57,68,6943,50,43,89,93,32,-25,57,58,58
48,orz302d.map,140,137,18611,135,20,4,116,10703,78,119,61,17,57,99,156,1753,2143
49,orz302d.map,140,137,15459,112,21,27,115,8078,58,4,81,132,54,-17,71,72,72
50,orz302d.map,140,137,4484,32,36,107,100,16972,123,15,16,121,-91,-21,112,241,113
51,orz302d.map,140,137,7089,51,34,88,102,9934,72,66,67,70,-21,32,53,54,54
52,orz302d.map,140,137,9324,68,128,71,8,9029,65,12,74,124,3,-116,119,1640,1571
53,orz302d.map,140,137,8361,61,132,78,4,11671,85,110,54,26,-24,-22,46,47,95
54,orz302d.map,140,137,5600,40,16,99,120,659,4,25,135,111,36,9,45,46,56
55,orz302d.map,140,137,6769,49,80,90,56,19157,139,22,0,114,-90,-58,148,1457,224
56,orz302d.map,140,137,9601,70,125,69,11,11027,80,69,59,67,-10,-56,66,139,685
57,orz302d.map,140,137,8745,63,22,76,114,8044,58,38,81,98,5,16,21,22,22
58,orz302d.map,140,137,10587,77,98,62,38,668,4,16,135,120,73,-82,155,217,376
59,orz302d.map,140,137,10865,79,94,60,42,7677,56,131,83,5,23,37,60,125,65
60,orz302d.map,140,137,8502,62,128,77,8,4894,35,37,104,99,27,-91,118,677,1307
61,orz302d.map,140,137,6401,46,37,93,99,7922,57,23,82,113,-11,-14,25,26,26
62,orz302d.map,140,137,7696,56,112,83,24,7597,55,74,84,62,1,-38,39,529,549
63,orz302d.map,140,137,9626,70,100,69,36,6269,45,32,94,104,25,-68,93,94,226
64,orz302d.map,140,137,8616,62,14,77,122,9065,66,113,73,23,-4,99,103,1334,1214
65,orz302d.map,140,137,9520,69,69,70,67,18878,137,27,2,109,-68,-42,110,1887,1633
66,orz302d.map,140,137,8616,62,14,77,122,13267,96,21,43,115,-34,7,41,42,42
67,orz302d.map,140,137,9097,66,81,73,55,7251,52,9,87,127,14,-72,86,87,114
68,orz302d.map,140,137,9432,68,20,71,116,9876,72,124,67,12,-4,104,108,1778,1645
69,orz302d.map,140,137,5451,39,28,100,108,4644,33,13,106,123,6,-15,21,22,22
70,orz302d.map,140,137,13402,97,23,42,113,9435,68,17,71,119,29,-6,35,36,36
71,orz302d.map,140,137,6796,49,53,90,83,2036,14,18,125,118,35,-35,70,94,92
72,orz302d.map,140,137,9099,66,79,73,57,12077,88,115,51,21,-22,36,58,87,87
73,orz302d.map,140,137,9469,69,120,70,16,9605,70,121,69,15,-1,1,2,3,3
74,orz302d.map,140,137,19161,139,18,0,118,7099,51,24,88,112,88,6,94,95,95
75,orz302d.map,140,137,16539,120,37,19,99,6911,50,75,89,61,70,38,108,342,1653
76,orz302d.map,140,137,8698,63,69,76,67,10734,78,88,61,48,-15,19,34,35,35
77,orz302d.map,140,137,1762,12,18,127,118,6645,48,67,91,69,-36,49,85,115,137
78,orz302d.map,140,137,7179,52,81,87,55,16829,122,21,17,115,-70,-60,130,131,131
79,orz302d.map,140,137,9190,67,125,72,11,3271,23,16,116,120,44,-109,153,642,2125
80,orz302d.map,140,137,795,5,26,134,110,15325,111,18,28,118,-106,-8,114,115,115
81,orz302d.map,140,137,7466,54,68,85,68,11260,82,110,57,26,-28,42,70,84,105
82,orz302d.map,140,137,13947,101,26,38,110,5677,41,76,98,60,60,50,110,163,1386
83,orz302d.map,140,137,6864,50,122,89,14,391,2,19,137,117,48,-103,151,637,2549
84,orz302d.map,140,137,13536,98,26,41,110,2851,20,25,119,111,78,-1,79,87,261
85,orz302d.map,140,137,9148,66,30,73,106,10189,74,85,65,51,-8,55,63,455,827
86,orz302d.map,140,137,5604,40,12,99,124,8012,58,70,81,66,-18,58,76,77,131
87,orz302d.map,140,137,9664,70,62,69,74,7244,52,16,87,120,18,-46,64,110,627
88,orz302d.map,140,137,9236,67,79,72,57,10623,77,62,62,74,-10,-17,27,28,28
89,orz302d.map,140,137,13954,101,19,38,117,9077,66,101,73,35,35,82,117,1115,1126
90,orz302d.map,140,137,10441,76,107,63,29,8555,62,75,77,61,14,-32,46,51,47
91,orz302d.map,140,137,11762,85,19,54,117,8051,58,31,81,105,27,12,39,40,40
92,orz302d.map,140,137,5330,38,12,101,124,10707,78,115,61,21,-40,103,143,303,371
93,orz302d.map,140,137,6382,46,56,93,80,390,2,20,137,116,44,-36,80,110,150
94,orz302d.map,140,137,12991,94,23,45,113,9247,67,68,72,68,27,45,72,862,601
95,orz302d.map,140,137,10571,77,114,62,22,4635,33,22,106,114,44,-92,136,285,301
96,orz302d.map,140,137,6556,47,19,92,117,14501,105,20,34,116,-58,1,59,60,60
97,orz302d.map,140,137,13674,99,25,40,111,4621,33,36,106,100,66,11,77,91,559
98,orz302d.map,140,137,2178,15,13,124,123,9879,72,121,67,15,-57,108,165,346,552
99,orz302d.map,140,137,16547,120,29,19,107,14507,105,14,34,122,15,-15,30,31,37
0,orz303d.map,261,373,12941,34,113,226,259,15518,41,147,219,225,-7,34,41,42,95
1,orz303d.map,261,373,73275,196,205,64,167,58438,156,122,104,250,40,-83,123,5534,4015
2,orz303d.map,261,373,93043,249,206,11,166,21932,58,74,202,298,191,-132,323,705,6896
3,orz303d.map,261,373,40248,107,35,153,337,40595,108,61,152,311,-1,26,27,28,28
4,orz303d.map,261,373,20384,54,130,206,242,50113,134,241,126,131,-80,111,191,2438,1440
5,orz303d.map,261,373,13384,35,43,225,329,28112,75,235,185,137,-40,192,232,12030,2821
6,orz303d.map,261,373,26349,70,133,190,239,69174,185,203,75,169,-115,70,185,336,229
7,orz303d.map,261,373,89680,240,212,20,160,91527,245,230,15,142,-5,18,23,24,24
8,orz303d.map,261,373,41048,110,354,150,18,42953,115,314,145,58,-5,-40,45,46,46
9,orz303d.map,261,373,42121,112,27,148,345,16293,43,118,217,254,69,91,160,435,392
10,orz303d.map,261,373,16290,43,121,217,251,50444,135,283,125,89,-92,162,254,4378,2696
11,orz303d.map,261,373,54945,147,258,113,114,39511,105,26,155,346,42,-232,274,9235,6461
12,orz303d.map,261,373,42416,113,105,147,267,10697,28,119,232,253,85,14,99,100,523
13,orz303d.map,261,373,91169,244,215,16,157,79887,214,307,46,65,30,92,122,2858,4095
14,orz303d.map,261,373,30468,81,117,179,255,84828,227,215,33,157,-146,98,244,2751,2896
15,orz303d.map,261,373,78138,209,191,51,181,49506,132,102,128,270,77,-89,166,4771,5808
16,orz303d.map,261,373,15950,42,88,218,284,86607,232,301,28,71,-190,213,403,9126,8147
17,orz303d.map,261,373,56571,151,124,109,248,75039,201,306,59,66,-50,182,232,6961,9675
18,orz303d.map,261,373,49569,132,39,128,333,56806,152,262,108,110,-20,223,243,5520,6127
19,orz303d.map,261,373,60857,163,314,97,58,37801,101,244,159,128,62,-70,132,688,447
20,orz303d.map,261,373,63473,170,309,90,63,49151,131,84,129,288,39,-225,264,8196,4592
21,orz303d.map,261,373,45323,121,182,139,190,21195,56,65,204,307,65,-117,182,392,213
22,orz303d.map,261,373,47026,126,344,134,28,33717,90,225,170,147,36,-119,155,2573,3320
23,orz303d.map,261,373,49120,131,115,129,257,8460,22,118,238,254,109,3,112,113,113
24,orz303d.map,261,373,45008,120,124,140,248,38449,103,342,157,30,17,218,235,7849,8547
25,orz303d.map,261,373,52400,140,192,120,180,78397,210,305,50,67,-70,113,183,2279,983
26,orz303d.map,261,373,82600,221,205,39,167,44573,119,186,141,186,102,-19,121,151,330
27,orz303d.map,261,373,24524,65,93,195,279,47540,127,203,133,169,-62,110,172,201,243
28,orz303d.map,261,373,75794,203,297,57,75,80740,216,200,44,172,-13,-97,110,2382,4230
29,orz303d.map,261,373,28941,77,152,183,220,40254,107,29,153,343,-30,-123,153,2732,3202
30,orz303d.map,261,373,28629,76,91,184,281,35815,96,365,164,7,-20,274,294,7840,4408
31,orz303d.map,261,373,39796,106,114,154,258,57140,153,301,107,71,-47,187,234,3482,6318
32,orz303d.map,261,373,73532,197,321,63,51,52373,140,219,120,153,57,-102,159,447,295
33,orz303d.map,261,373,38512,103,279,157,93,39982,107,301,153,71,-4,22,26,89,50
34,orz303d.map,261,373,70204,188,292,72,80,83351,223,200,37,172,-35,-92,127,2389,4476
35,orz303d.map,261,373,27834,74,140,186,232,44062,118,324,142,48,-44,184,228,5976,3894
36,orz303d.map,261,373,40258,107,25,153,347,30731,82,227,178,145,25,202,227,12781,8077
37,orz303d.map,261,373,23747,63,124,197,248,37061,99,238,161,134,-36,114,150,6961,1906
38,orz303d.map,261,373,73158,196,322,64,50,14079,37,94,223,278,159,-228,387,2605,817
39,orz303d.map,261,373,31927,85,150,175,222,41071,110,331,150,41,-25,181,206,2378,3827
40,orz303d.map,261,373,38673,103,118,157,254,54169,145,288,115,84,-42,170,212,2940,5748
41,orz303d.map,261,373,50170,134,184,126,188,44204,118,182,142,190,16,-2,18,19,19
42,orz303d.map,261,373,17033,45,124,215,248,33581,90,361,170,11,-45,237,282,7820,6852
43,orz303d.map,261,373,87723,235,304,25,68,77743,208,213,52,159,27,-91,118,3947,3605
44,orz303d.map,261,373,31838,85,239,175,133,25502,68,234,192,138,17,-5,22,23,23
45,orz303d.map,261,373,51188,137,285,123,87,89318,239,201,21,171,-102,-84,186,3077,1536
46,orz303d.map,261,373,67577,181,308,79,64,24118,64,126,196,246,117,-182,299,2477,335
47,orz303d.map,261,373,40630,108,26,152,346,44303,118,83,142,289,-10,57,67,1178,250
48,orz303d.map,261,373,49099,131,136,129,236,44286,118,100,142,272,13,-36,49,50,50
49,orz303d.map,261,373,44400,119,359,141,13,78018,209,311,51,61,-90,-48,138,1878,2708
50,orz303d.map,261,373,29377,78,89,182,283,37259,99,40,161,332,-21,-49,70,384,1307
51,orz303d.map,261,373,21130,56,130,204,242,28221,75,126,185,246,-19,-4,23,24,24
52,orz303d.map,261,373,78497,210,205,50,167,46855,125,142,135,230,85,-63,148,6131,3933
53,orz303d.map,261,373,93411,250,211,10,161,49516,132,92,128,280,118,-119,237,5181,6691
54,orz303d.map,261,373,23020,61,105,199,267,50638,135,89,125,283,-74,-16,90,802,803
55,orz303d.map,261,373,36905,98,21,162,351,47020,126,350,134,22,-28,329,357,14051,12419
56,orz303d.map,261,373,46894,125,103,135,269,53199,142,139,118,233,-17,36,53,54,54
57,orz303d.map,261,373,51049,136,51,124,321,37012,99,287,161,85,37,236,273,11367,8050
58,orz303d.map,261,373,78386,210,316,50,56,46938,125,59,135,313,85,-257,342,10151,5473
59,orz303d.map,261,373,39981,107,302,153,70,37038,99,261,161,111,8,-41,49,2074,1321
60,orz303d.map,261,373,41106,110,296,150,76,50445,135,282,125,90,-25,-14,39,40,40
61,orz303d.map,261,373,34330,92,358,168,14,49764,133,217,127,155,-41,-141,182,2784,2888
62,orz303d.map,261,373,89690,240,202,20,170,90427,242,211,18,161,-2,9,11,12,12
63,orz303d.map,261,373,36186,97,367,163,5,45362,121,143,139,229,-24,-224,248,9757,8501
64,orz303d.map,261,373,16648,44,136,216,236,43965,117,48,143,324,-73,-88,161,3006,1916
65,orz303d.map,261,373,51737,138,109,122,263,38541,103,250,157,122,35,141,176,7998,6177
66,orz303d.map,261,373,47226,126,144,134,228,54046,144,38,116,334,-18,-106,124,126,324
67,orz303d.map,261,373,47187,126,183,134,189,47596,127,147,133,225,-1,-36,37,3257,3312
68,orz303d.map,261,373,41376,110,26,150,346,43442,116,198,144,174,-6,172,178,6120,4431
69,orz303d.map,261,373,22354,59,25,201,347,49693,133,288,127,84,-74,263,337,8513,2847
70,orz303d.map,261,373,34201,91,114,169,258,57693,154,121,106,251,-63,7,70,93,71
71,orz303d.map,261,373,16691,44,93,216,279,48246,129,243,131,129,-85,150,235,6807,5663
72,orz303d.map,261,373,48074,128,42,132,330,53571,143,140,117,232,-15,98,113,898,474
73,orz303d.map,261,373,48024,128,92,132,280,77271,207,312,53,60,-79,220,299,4440,8427
74,orz303d.map,261,373,39529,105,8,155,364,2116,5,121,255,251,100,113,213,861,4029
75,orz303d.map,261,373,43213,115,54,145,318,33967,91,348,169,24,24,294,318,12916,12116
76,orz303d.map,261,373,13288,35,139,225,233,48750,130,112,130,260,-95,-27,122,123,159
77,orz303d.map,261,373,53224,142,114,118,258,48730,130,132,130,240,12,18,30,129,105
78,orz303d.map,261,373,44403,119,356,141,16,90045,241,220,19,152,-122,-136,258,5727,5374
79,orz303d.map,261,373,51220,137,253,123,119,68429,183,202,77,170,-46,-51,97,791,326
80,orz303d.map,261,373,44636,119,123,141,249,36398,97,155,163,217,22,32,54,1554,850
81,orz303d.map,261,373,20050,53,91,207,281,84455,226,215,34,157,-173,124,297,1058,376
82,orz303d.map,261,373,45890,123,361,137,11,9207,24,117,236,255,99,-244,343,4578,9964
83,orz303d.map,261,373,21144,56,116,204,256,78025,209,304,51,68,-153,188,341,6492,3068
84,orz303d.map,261,373,27912,74,62,186,310,86604,232,304,28,68,-158,242,400,8169,9061
85,orz303d.map,261,373,28213,75,134,185,238,52878,141,87,119,285,-66,-47,113,321,124
86,orz303d.map,261,373,22641,60,111,200,261,25700,68,36,192,336,-8,-75,83,84,84
87,orz303d.map,261,373,44338,118,48,142,324,48730,130,132,130,240,-12,84,96,325,767
88,orz303d.map,261,373,55827,149,122,111,250,44294,118,92,142,280,31,-30,61,62,62
89,orz303d.map,261,373,48664,130,198,130,174,51420,137,53,123,319,-7,-145,152,2992,5145
90,orz303d.map,261,373,83739,224,185,36,187,43220,115,47,145,325,109,-138,247,7300,9786
91,orz303d.map,261,373,54504,146,326,114,46,22287,59,92,201,280,87,-234,321,2600,361
92,orz303d.map,261,373,33586,90,356,170,16,49475,132,133,128,239,-42,-223,265,9729,9079
93,orz303d.map,261,373,53811,144,273,116,99,37668,100,4,160,368,44,-269,313,10932,6499
94,orz303d.map,261,373,40594,108,62,152,310,36879,98,47,162,325,10,-15,25,37,32
95,orz303d.map,261,373,42976,115,291,145,81,43134,115,133,145,239,0,-158,158,8565,6633
96,orz303d.map,261,373,55160,147,43,113,329,15903,42,135,218,237,105,92,197,449,210
97,orz303d.map,261,373,42768,114,126,146,246,64329,172,199,88,173,-58,73,131,3553,3641
98,orz303d.map,261,373,81127,217,186,43,186,24503,65,114,195,258,152,-72,224,732,5087
99,orz303d.map,261,373,52392,140,200,120,172,82239,220,193,40,179,-80,-7,87,422,88
0,orz304d.map,150,64,3698,57,13,92,50,8573,133,2,16,61,-76,-11,87,1146,855
1,orz304d.map,150,64,4819,75,44,74,19,9055,141,32,8,31,-66,-12,78,439,660
2,orz304d.map,150,64,7011,109,28,40,35,5044,78,11,71,52,31,-17,48,277,148
3,orz304d.map,150,64,4172,65,51,84,12,8454,132,57,17,6,-67,6,73,981,916
4,orz304d.map,150,64,5496,85,7,64,56,3754,58,21,91,42,27,14,41,42,42
5,orz304d.map,150,64,4793,74,6,75,57,2919,45,24,104,39,29,18,47,56,188
6,orz304d.map,150,64,3850,60,53,89,10,1391,21,16,128,47,39,-37,76,174,298
7,orz304d.map,150,64,7241,113,54,36,9,7458,116,29,33,34,-3,-25,28,29,29
8,orz304d.map,150,64,8229,128,26,21,37,5215,81,32,68,31,47,6,53,54,100
9,orz304d.map,150,64,8620,134,19,15,44,5495,85,8,64,55,49,-11,60,1257,563
10,orz304d.map,150,64,8129,127,62,22,1,350,5,33,144,30,122,-29,151,389,1709
11,orz304d.map,150,64,9167,143,48,6,15,3311,51,16,98,47,92,-32,124,129,828
12,orz304d.map,150,64,2932,45,11,104,52,1245,19,34,130,29,26,23,49,50,187
13,orz304d.map,150,64,7009,109,30,40,33,8774,137,57,12,6,-28,27,55,183,56
14,orz304d.map,150,64,4456,69,23,80,40,2991,46,16,103,47,23,-7,30,31,31
15,orz304d.map,150,64,3251,50,12,99,51,7327,114,32,35,31,-64,20,84,85,85
16,orz304d.map,150,64,2743,42,8,107,55,8511,132,0,17,63,-90,-8,98,1460,932
17,orz304d.map,150,64,9040,141,47,8,16,9055,141,32,8,31,0,-15,15,18,18
18,orz304d.map,150,64,4044,63,51,86,12,2983,46,24,103,39,17,-27,44,50,137
19,orz304d.map,150,64,5345,83,30,66,33,3945,61,22,88,41,22,-8,30,31,31
20,orz304d.map,150,64,7369,115,54,34,9,5026,78,29,71,34,37,-25,62,65,289
21,orz304d.map,150,64,5004,78,51,71,12,7671,119,8,30,55,-41,-43,84,410,85
22,orz304d.map,150,64,2724,42,27,107,36,8103,126,24,23,39,-84,-3,87,440,256
23,orz304d.map,150,64,1616,25,47,124,16,7444,116,43,33,20,-91,-4,95,787,554
24,orz304d.map,150,64,7834,122,37,27,26,2805,43,10,106,53,79,-27,106,107,333
25,orz304d.map,150,64,9505,148,30,1,33,7563,118,52,31,11,30,22,52,54,103
26,orz304d.map,150,64,4969,77,22,72,41,4903,76,24,73,39,1,2,3,4,4
27,orz304d.map,150,64,3902,60,1,89,62,6239,97,32,52,31,-37,31,68,69,69
28,orz304d.map,150,64,5038,78,17,71,46,4695,73,40,76,23,5,23,28,29,29
29,orz304d.map,150,64,7843,122,28,27,35,7268,113,27,36,36,9,-1,10,11,11
30,orz304d.map,150,64,5166,80,17,69,46,6751,105,32,44,31,-25,15,40,49,267
31,orz304d.map,150,64,4187,65,36,84,27,4766,74,33,75,30,-9,-3,12,13,13
32,orz304d.map,150,64,1768,27,23,122,40,7252,113,43,36,20,-86,20,106,662,109
33,orz304d.map,150,64,6809,106,38,43,25,4774,74,25,75,38,32,-13,45,46,128
34,orz304d.map,150,64,8558,133,17,16,46,5854,91,33,58,30,42,16,58,59,224
35,orz304d.map,150,64,7770,121,37,28,26,3196,49,3,100,60,72,-34,106,107,303
36,orz304d.map,150,64,2808,43,7,106,56,8415,131,32,18,31,-88,25,113,846,728
37,orz304d.map,150,64,8592,134,47,15,16,2086,32,25,117,38,102,-22,124,127,819
38,orz304d.map,150,64,9121,142,30,7,33,7445,116,42,33,21,26,12,38,40,105
39,orz304d.map,150,64,7176,112,55,37,8,4739,74,60,75,3,38,5,43,550,545
40,orz304d.map,150,64,5241,81,6,68,57,3986,62,45,87,18,19,39,58,59,65
41,orz304d.map,150,64,6694,104,25,45,38,2790,43,25,106,38,61,0,61,160,404
42,orz304d.map,150,64,4243,66,44,83,19,3790,59,49,90,14,7,5,12,13,13
43,orz304d.map,150,64,4969,77,22,72,41,2789,43,26,106,37,34,4,38,39,64
44,orz304d.map,150,64,7538,117,13,32,50,4015,62,16,87,47,55,3,58,477,924
45,orz304d.map,150,64,6432,100,31,49,32,4555,71,52,78,11,29,21,50,63,51
46,orz304d.map,150,64,1308,20,35,129,28,4789,74,10,75,53,-54,-25,79,483,82
47,orz304d.map,150,64,9345,146,62,3,1,9121,142,30,7,33,4,-32,36,37,37
48,orz304d.map,150,64,7195,112,36,37,27,3053,47,18,102,45,65,-18,83,84,252
49,orz304d.map,150,64,2843,44,36,105,27,4103,64,56,85,7,-20,20,40,203,51
50,orz304d.map,150,64,3048,47,23,102,40,3418,53,37,96,26,-6,14,20,21,21
51,orz304d.map,150,64,8576,134,63,15,0,6965,108,10,41,53,26,-53,79,80,258
52,orz304d.map,150,64,2467,38,28,111,35,9542,149,57,0,6,-111,29,140,1542,154
53,orz304d.map,150,64,3241,50,22,99,41,3621,56,26,93,37,-6,4,10,11,11
54,orz304d.map,150,64,2912,45,31,104,32,5691,88,4,61,59,-43,-27,70,246,79
55,orz304d.map,150,64,7848,122,23,27,40,7379,115,44,34,19,7,21,28,29,29
56,orz304d.map,150,64,3108,48,27,101,36,7159,111,8,38,55,-63,-19,82,899,320
57,orz304d.map,150,64,2969,46,38,103,25,3164,49,35,100,28,-3,-3,6,7,7
58,orz304d.map,150,64,8068,126,59,23,4,1423,22,48,127,15,104,-11,115,923,1580
59,orz304d.map,150,64,7574,118,41,31,22,6119,95,24,54,39,23,-17,40,43,53
60,orz304d.map,150,64,8673,135,30,14,33,2774,43,41,106,22,92,11,103,421,662
61,orz304d.map,150,64,6580,102,11,47,52,2588,40,35,109,28,62,24,86,90,777
62,orz304d.map,150,64,4952,77,39,72,24,9236,144,43,5,20,-67,4,71,401,633
63,orz304d.map,150,64,6817,106,30,43,33,3941,61,26,88,37,45,-4,49,50,50
64,orz304d.map,150,64,4450,69,29,80,34,8756,136,11,13,52,-67,-18,85,585,341
65,orz304d.map,150,64,5088,79,31,70,32,4044,63,51,86,12,16,20,36,37,37
66,orz304d.map,150,64,3755,58,20,91,43,7477,116,10,33,53,-58,-10,68,1021,416
67,orz304d.map,150,64,4635,72,36,77,27,7567,118,48,31,15,-46,12,58,381,359
68,orz304d.map,150,64,6683,104,36,45,27,2847,44,32,105,31,60,-4,64,65,245
69,orz304d.map,150,64,5539,86,28,63,35,734,11,33,138,30,75,5,80,81,219
70,orz304d.map,150,64,4312,67,39,82,24,8193,128,62,21,1,-61,23,84,964,661
71,orz304d.map,150,64,1752,27,39,122,24,997,15,26,134,37,12,-13,25,26,26
72,orz304d.map,150,64,3560,55,23,94,40,4104,64,55,85,8,-9,32,41,42,51
73,orz304d.map,150,64,2812,43,3,106,60,3117,48,18,101,45,-5,15,20,21,21
74,orz304d.map,150,64,9224,144,55,5,8,8389,131,58,18,5,13,3,16,221,297
75,orz304d.map,150,64,9562,149,37,0,26,1126,17,25,132,38,132,-12,144,589,1049
76,orz304d.map,150,64,4688,73,47,76,16,2703,42,48,107,15,31,1,32,257,304
77,orz304d.map,150,64,2085,32,26,117,37,6615,103,40,46,23,-71,14,85,485,87
78,orz304d.map,150,64,6107,95,36,54,27,4829,75,34,74,29,20,-2,22,64,52
79,orz304d.map,150,64,7792,121,15,28,48,4375,68,40,81,23,53,25,78,79,393
80,orz304d.map,150,64,7400,115,23,34,40,7606,118,9,31,54,-3,-14,17,18,18
81,orz304d.map,150,64,6560,102,31,47,32,1815,28,40,121,23,74,9,83,84,84
82,orz304d.map,150,64,6586,102,5,47,58,2989,46,18,103,45,56,13,69,363,1153
83,orz304d.map,150,64,4820,75,43,74,20,7853,122,18,27,45,-47,-25,72,266,73
84,orz304d.map,150,64,6888,107,23,42,40,8327,130,56,19,7,-23,33,56,178,57
85,orz304d.map,150,64,8508,132,3,17,60,9181,143,34,6,29,-11,31,42,43,43
86,orz304d.map,150,64,2746,42,5,107,58,7100,110,3,39,60,-68,-2,70,1176,432
87,orz304d.map,150,64,8138,127,53,22,10,4742,74,57,75,6,53,4,57,927,643
88,orz304d.map,150,64,2818,44,61,105,2,4615,72,56,77,7,-28,-5,33,435,493
89,orz304d.map,150,64,8672,135,31,14,32,8673,135,30,14,33,0,-1,1,2,2
90,orz304d.map,150,64,6937,108,38,41,25,4030,62,1,87,62,46,-37,83,84,238
91,orz304d.map,150,64,1521,23,14,126,49,3859,60,44,89,19,-37,30,67,180,128
92,orz304d.map,150,64,8370,130,13,19,50,3018,47,53,102,10,83,40,123,124,853
93,orz304d.map,150,64,2706,42,45,107,18,8611,134,28,15,35,-92,-17,109,198,110
94,orz304d.map,150,64,5660,88,35,61,28,2087,32,24,117,39,56,-11,67,68,212
95,orz304d.map,150,64,4611,72,60,77,3,6965,108,10,41,53,-36,-50,86,322,90
96,orz304d.map,150,64,2986,46,21,103,42,5563,86,4,63,59,-40,-17,57,230,399
97,orz304d.map,150,64,9225,144,54,5,9,3238,50,25,99,38,94,-29,123,134,1160
98,orz304d.map,150,64,2722,42,29,107,34,1780,27,11,122,52,15,-18,33,34,34
99,orz304d.map,150,64,5009,78,46,71,17,3655,57,56,92,7,21,10,31,263,232
0,orz500d.map,332,271,50169,185,236,146,34,37215,137,182,194,88,48,-54,102,103,103
1,orz500d.map,332,271,37480,138,188,193,82,43474,160,156,171,114,-22,-32,54,55,76
2,orz500d.map,332,271,15770,58,218,273,52,1414,5,211,326,59,53,-7,60,61,81
3,orz500d.map,332,271,78700,290,160,41,110,36652,135,203,196,67,155,43,198,207,2143
4,orz500d.map,332,271,44333,163,110,168,160,66957,247,250,84,20,-84,140,224,5713,14442
5,orz500d.map,332,271,75945,280,205,51,65,78134,288,184,43,86,-8,-21,29,30,42
6,orz500d.map,332,271,43890,161,11,170,259,37876,139,63,192,207,22,52,74,75,75
7,orz500d.map,332,271,74640,275,155,56,115,40049,147,58,184,212,128,-97,225,14442,5713
8,orz500d.map,332,271,51248,189,241,142,29,41130,151,61,180,209,38,-180,218,14442,5713
9,orz500d.map,332,271,49123,181,198,150,72,8479,31,192,300,78,150,-6,156,268,690
10,orz500d.map,332,271,8204,30,196,301,74,42637,157,180,174,90,-127,-16,143,958,173
11,orz500d.map,332,271,50060,184,74,147,196,48813,180,237,151,33,4,163,167,5713,14442
12,orz500d.map,332,271,72160,266,196,65,74,75999,280,151,51,119,-14,-45,59,60,66
13,orz500d.map,332,271,48825,180,225,151,45,76191,281,230,50,40,-101,5,106,1443,1771
14,orz500d.map,332,271,78715,290,145,41,125,26357,97,200,234,70,193,55,248,1961,2524
15,orz500d.map,332,271,71088,262,184,69,86,49816,183,47,148,223,79,-137,216,14442,5713
16,orz500d.map,332,271,41188,151,3,180,267,42206,155,69,176,201,-4,66,70,71,71
17,orz500d.map,332,271,12064,44,130,287,140,53439,197,218,134,52,-153,88,241,911,288
18,orz500d.map,332,271,3608,13,185,318,85,81894,302,218,29,52,-289,33,322,3549,3187
19,orz500d.map,332,271,39808,146,28,185,242,75742,279,137,52,133,-133,109,242,5713,14442
20,orz500d.map,332,271,83001,306,195,25,75,77541,286,235,45,35,20,40,60,61,61
21,orz500d.map,332,271,21480,79,199,252,71,41292,152,170,179,100,-73,-29,102,280,132
22,orz500d.map,332,271,49528,182,64,149,206,55092,203,191,128,79,-21,127,148,5713,14442
23,orz500d.map,332,271,11978,44,216,287,54,49787,183,76,148,194,-139,-140,279,14442,5713
24,orz500d.map,332,271,39378,145,187,186,83,38839,143,184,188,86,2,-3,5,6,6
25,orz500d.map,332,271,14700,54,204,277,66,44860,165,125,166,145,-111,-79,190,14442,5713
26,orz500d.map,332,271,38424,141,57,190,213,30155,111,196,220,74,30,139,169,5713,14442
27,orz500d.map,332,271,40057,147,50,184,220,32050,118,198,213,72,29,148,177,5713,14442
28,orz500d.map,332,271,45026,166,230,165,40,70007,258,181,73,89,-92,-49,141,639,158
29,orz500d.map,332,271,4690,17,187,314,83,79731,294,213,37,57,-277,26,303,2858,2518
30,orz500d.map,332,271,37180,137,217,194,53,12550,46,186,285,84,91,-31,122,157,734
31,orz500d.map,332,271,44045,162,127,169,143,19869,73,184,258,86,89,57,146,5713,14442
32,orz500d.map,332,271,43369,160,261,171,9,14705,54,199,277,71,106,-62,168,361,728
33,orz500d.map,332,271,45912,169,157,162,113,39586,146,250,185,20,23,93,116,1420,125
34,orz500d.map,332,271,20128,74,196,257,74,43174,159,185,172,85,-85,-11,96,282,112
35,orz500d.map,332,271,51150,188,68,143,202,3046,11,205,320,65,177,137,314,5713,14442
36,orz500d.map,332,271,50617,186,59,145,211,81387,300,183,31,87,-114,124,238,5713,14442
37,orz500d.map,332,271,53461,197,196,134,74,50758,187,189,144,81,10,-7,17,18,18
38,orz500d.map,332,271,17419,64,195,267,75,39926,147,181,184,89,-83,-14,97,421,126
39,orz500d.map,332,271,32315,119,204,212,66,45398,167,129,164,141,-48,-75,123,14442,5713
40,orz500d.map,332,271,49433,182,159,149,111,79219,292,183,39,87,-110,24,134,857,1799
41,orz500d.map,332,271,75707,279,172,52,98,77325,285,180,46,90,-6,8,14,15,15
42,orz500d.map,332,271,47897,176,69,155,201,13411,49,138,282,132,127,69,196,5713,14442
43,orz500d.map,332,271,7404,27,183,304,87,76796,283,167,48,103,-256,-16,272,3210,2143
44,orz500d.map,332,271,69176,255,199,76,71,41362,152,100,179,170,103,-99,202,14442,5713
45,orz500d.map,332,271,74838,276,228,55,42,47663,175,32,156,238,101,-196,297,14442,5713
46,orz500d.map,332,271,76820,283,143,48,127,69396,256,250,75,20,27,107,134,484,148
47,orz500d.map,332,271,43881,161,20,170,250,76566,282,126,49,144,-121,106,227,5713,14442
48,orz500d.map,332,271,23105,85,200,246,70,38589,142,163,189,107,-57,-37,94,769,134
49,orz500d.map,332,271,8472,31,199,300,71,49542,182,50,149,220,-151,-149,300,14442,5713
50,orz500d.map,332,271,38553,142,199,189,71,41114,151,77,180,193,-9,-122,131,14442,5713
51,orz500d.map,332,271,74027,273,226,58,44,48174,177,63,154,207,96,-163,259,14442,5713
52,orz500d.map,332,271,16580,61,221,270,49,59964,221,197,110,73,-160,-24,184,909,1489
53,orz500d.map,332,271,57794,213,199,118,71,43907,162,265,169,5,51,66,117,194,124
54,orz500d.map,332,271,42077,155,198,176,72,12270,45,195,286,75,110,-3,113,116,418
55,orz500d.map,332,271,70760,261,241,70,29,19599,72,183,259,87,189,-58,247,2132,4940
56,orz500d.map,332,271,40196,148,182,183,88,58343,215,192,116,78,-67,10,77,729,122
57,orz500d.map,332,271,74568,275,227,56,43,39682,146,154,185,116,129,-73,202,206,1541
58,orz500d.map,332,271,72410,267,217,64,53,42479,156,67,175,203,111,-150,261,14442,5713
59,orz500d.map,332,271,50185,185,220,146,50,81100,299,199,32,71,-114,-21,135,503,1154
60,orz500d.map,332,271,17683,65,202,266,68,42756,157,61,174,209,-92,-141,233,14442,5713
61,orz500d.map,332,271,11712,43,211,288,59,36255,133,58,198,212,-90,-153,243,14442,5713
62,orz500d.map,332,271,77824,287,223,44,47,44750,165,235,166,35,122,12,134,1948,2077
63,orz500d.map,332,271,43917,162,255,169,15,82471,304,183,27,87,-142,-72,214,663,294
64,orz500d.map,332,271,45518,167,9,164,261,38990,143,33,188,237,24,24,48,49,49
65,orz500d.map,332,271,42328,156,218,175,52,25006,92,196,239,74,64,-22,86,133,214
66,orz500d.map,332,271,53188,196,198,135,72,75446,278,162,53,108,-82,-36,118,254,127
67,orz500d.map,332,271,22560,83,203,248,67,67766,250,254,81,16,-167,51,218,5784,1005
68,orz500d.map,332,271,86826,320,164,11,106,46547,171,64,160,206,149,-100,249,14442,5713
69,orz500d.map,332,271,43955,162,217,169,53,46443,171,168,160,102,-9,-49,58,59,313
70,orz500d.map,332,271,76489,282,203,49,67,41948,154,56,177,214,128,-147,275,14442,5713
71,orz500d.map,332,271,44544,164,170,167,100,43794,161,107,170,163,3,-63,66,14442,5713
72,orz500d.map,332,271,12011,44,183,287,87,16309,60,221,271,49,-16,38,54,55,55
73,orz500d.map,332,271,49632,183,231,148,39,39875,147,232,184,38,36,1,37,38,38
74,orz500d.map,332,271,57259,211,192,120,78,10661,39,178,292,92,172,-14,186,1196,1154
75,orz500d.map,332,271,45164,166,92,165,178,43020,158,68,173,202,8,-24,32,33,33
76,orz500d.map,332,271,10944,40,166,291,104,72435,267,192,64,78,-227,26,253,1446,2168
77,orz500d.map,332,271,48729,179,50,152,220,49785,183,78,148,192,-4,28,32,33,33
78,orz500d.map,332,271,38008,140,202,191,68,33922,125,223,206,47,15,21,36,52,39
79,orz500d.map,332,271,17165,63,178,268,92,75919,280,231,51,39,-217,53,270,3085,3063
80,orz500d.map,332,271,41643,153,90,178,180,44974,165,11,166,259,-12,-79,91,92,92
81,orz500d.map,332,271,39824,146,12,185,258,19053,70,187,261,83,76,175,251,5713,14442
82,orz500d.map,332,271,37061,136,65,195,205,49895,184,239,147,31,-48,174,222,5713,14442
83,orz500d.map,332,271,13602,50,218,281,52,71029,262,243,69,27,-212,25,237,4275,2302
84,orz500d.map,332,271,10345,38,223,293,47,75143,277,194,54,76,-239,-29,268,1671,2670
85,orz500d.map,332,271,49556,182,36,149,234,42596,157,221,174,49,25,185,210,5713,14442
86,orz500d.map,332,271,43398,160,232,171,38,11254,41,127,290,143,119,-105,224,415,948
87,orz500d.map,332,271,46384,171,227,160,43,38848,143,175,188,95,28,-52,80,81,81
88,orz500d.map,332,271,46066,169,3,162,267,11252,41,129,290,141,128,126,254,5713,14442
89,orz500d.map,332,271,50480,186,196,145,74,10374,38,194,293,76,148,-2,150,167,380
90,orz500d.map,332,271,76832,283,131,48,139,16611,61,190,270,80,222,59,281,1954,2675
91,orz500d.map,332,271,10130,37,167,294,103,70259,259,200,72,70,-222,33,255,1678,2338
92,orz500d.map,332,271,45611,168,187,163,83,42725,157,92,174,178,11,-95,106,14442,5713
93,orz500d.map,332,271,48753,179,26,152,244,77855,287,192,44,78,-108,166,274,5713,14442
94,orz500d.map,332,271,9849,36,177,295,93,47267,174,157,157,113,-138,-20,158,1639,1833
95,orz500d.map,332,271,42691,157,126,174,144,83807,309,202,22,68,-152,76,228,5713,14442
96,orz500d.map,332,271,39128,144,166,187,104,45637,168,161,163,109,-24,-5,29,75,128
97,orz500d.map,332,271,80534,297,223,34,47,77831,287,216,44,54,10,-7,17,18,18
98,orz500d.map,332,271,69979,258,209,73,61,50661,186,15,145,255,72,-194,266,14442,5713
99,orz500d.map,332,271,43795,161,106,170,164,13644,50,176,281,94,111,70,181,5713,14442
0,orz601d.map,41,101,1408,13,5,27,95,1690,16,26,24,74,-3,21,24,45,100
1,orz601d.map,41,101,873,8,35,32,65,442,4,62,36,38,4,27,31,168,218
2,orz601d.map,41,101,3304,32,28,8,72,2623,25,2,15,98,7,-26,33,207,255
3,orz601d.map,41,101,3698,36,38,4,62,317,3,86,37,14,33,48,81,280,938
4,orz601d.map,41,101,2484,24,40,16,60,3453,34,81,6,19,-10,41,51,52,52
5,orz601d.map,41,101,3193,31,38,9,62,2364,23,59,17,41,8,21,29,59,224
6,orz601d.map,41,101,923,9,86,31,14,2821,27,6,13,94,-18,-80,98,111,199
7,orz601d.map,41,101,953,9,56,31,44,2329,23,94,17,6,-14,38,52,63,122
8,orz601d.map,41,101,3600,35,35,5,65,2375,23,48,17,52,12,13,25,62,92
9,orz601d.map,41,101,2115,20,5,20,95,2331,23,92,17,8,-3,87,90,91,91
10,orz601d.map,41,101,368,3,35,37,65,1618,16,98,24,2,-13,63,76,372,627
11,orz601d.map,41,101,3705,36,31,4,69,3356,33,77,7,23,3,46,49,346,189
12,orz601d.map,41,101,1865,18,53,22,47,265,2,37,38,63,16,-16,32,253,79
13,orz601d.map,41,101,2366,23,57,17,43,871,8,37,32,63,15,-20,35,404,66
14,orz601d.map,41,101,2308,22,14,18,86,566,5,39,35,61,17,25,42,51,82
15,orz601d.map,41,101,3756,37,81,3,19,2356,23,67,17,33,14,-14,28,29,29
16,orz601d.map,41,101,1668,16,48,24,52,1788,17,29,23,71,-1,-19,20,21,21
17,orz601d.map,41,101,1368,13,45,27,55,3556,35,79,5,21,-22,34,56,439,112
18,orz601d.map,41,101,123,1,78,39,22,1975,19,44,21,56,-18,-34,52,108,355
19,orz601d.map,41,101,167,1,34,39,66,2431,24,93,16,7,-23,59,82,126,600
20,orz601d.map,41,101,2795,27,32,13,68,2742,27,85,13,15,0,53,53,61,79
21,orz601d.map,41,101,3907,38,31,2,69,141,1,60,39,40,37,29,66,158,139
22,orz601d.map,41,101,1955,19,64,21,36,1892,18,26,22,74,1,-38,39,40,40
23,orz601d.map,41,101,1849,18,69,22,31,2051,20,69,20,31,-2,0,2,3,3
24,orz601d.map,41,101,2209,21,12,19,88,1507,14,7,26,93,7,-5,12,40,16
25,orz601d.map,41,101,1864,18,54,22,46,2350,23,73,17,27,-5,19,24,25,25
26,orz601d.map,41,101,1768,17,49,23,51,3401,33,32,7,68,-16,-17,33,34,34
27,orz601d.map,41,101,2648,26,78,14,22,2781,27,46,13,54,-1,-32,33,41,39
28,orz601d.map,41,101,2392,23,31,17,69,3908,38,30,2,70,-15,-1,16,25,27
29,orz601d.map,41,101,2034,20,86,20,14,2523,24,1,16,99,-4,-85,89,90,90
30,orz601d.map,41,101,2681,26,45,14,55,883,8,25,32,75,18,-20,38,45,55
31,orz601d.map,41,101,1904,18,14,22,86,2063,20,57,20,43,-2,43,45,46,46
32,orz601d.map,41,101,1786,17,31,23,69,531,5,74,35,26,12,43,55,697,107
33,orz601d.map,41,101,3606,35,29,5,71,2583,25,42,15,58,10,13,23,24,30
34,orz601d.map,41,101,3353,33,80,7,20,172,1,29,39,71,32,-51,83,275,135
35,orz601d.map,41,101,2200,21,21,19,79,326,3,77,37,23,18,56,74,796,128
36,orz601d.map,41,101,2690,26,36,14,64,2563,25,62,15,38,1,26,27,28,28
37,orz601d.map,41,101,3296,32,36,8,64,3909,38,29,2,71,-6,-7,13,14,14
38,orz601d.map,41,101,928,9,81,31,19,2494,24,30,16,70,-15,-51,66,79,142
39,orz601d.map,41,101,427,4,77,36,23,147,1,54,39,46,3,-23,26,185,248
40,orz601d.map,41,101,1897,18,21,22,79,2372,23,51,17,49,-5,30,35,36,36
41,orz601d.map,41,101,1850,18,68,22,32,47,0,53,40,47,18,-15,33,38,85
42,orz601d.map,41,101,526,5,79,35,21,679,6,27,34,73,-1,-52,53,275,290
43,orz601d.map,41,101,1733,17,84,23,16,2031,20,89,20,11,-3,5,8,9,9
44,orz601d.map,41,101,1740,17,77,23,23,22,0,78,40,22,17,1,18,35,55
45,orz601d.map,41,101,2380,23,43,17,57,348,3,55,37,45,20,12,32,142,78
46,orz601d.map,41,101,776,7,31,33,69,670,6,36,34,64,1,5,6,7,7
47,orz601d.map,41,101,3963,39,76,1,24,2447,24,77,16,23,15,1,16,58,49
48,orz601d.map,41,101,2017,19,2,21,98,529,5,76,35,24,14,74,88,869,138
49,orz601d.map,41,101,2047,20,73,20,27,3855,38,83,2,17,-18,10,28,47,29
50,orz601d.map,41,101,1874,18,44,22,56,1926,19,93,21,7,-1,49,50,51,55
51,orz601d.map,41,101,2577,25,48,15,52,2620,25,5,15,95,0,-43,43,210,69
52,orz601d.map,41,101,1484,14,30,26,70,2046,20,74,20,26,-6,44,50,51,71
53,orz601d.map,41,101,960,9,49,31,51,2004,19,15,21,85,-10,-34,44,81,612
54,orz601d.map,41,101,769,7,38,33,62,2510,24,14,16,86,-17,-24,41,68,50
55,orz601d.map,41,101,1578,15,37,25,63,1869,18,49,22,51,-3,12,15,16,16
56,orz601d.map,41,101,269,2,33,38,67,23,0,77,40,23,2,44,46,438,304
57,orz601d.map,41,101,1320,13,93,27,7,3548,35,87,5,13,-22,-6,28,199,95
58,orz601d.map,41,101,1705,16,11,24,89,2573,25,52,15,48,-9,41,50,51,51
59,orz601d.map,41,101,3558,35,77,5,23,679,6,27,34,73,29,-50,79,238,839
60,orz601d.map,41,101,2171,21,50,19,50,3294,32,38,8,62,-11,-12,23,199,57
61,orz601d.map,41,101,858,8,50,32,50,1892,18,26,22,74,-10,-24,34,75,416
62,orz601d.map,41,101,226,2,76,38,24,318,3,85,37,15,-1,9,10,11,11
63,orz601d.map,41,101,748,7,59,33,41,2493,24,31,16,69,-17,-28,45,72,97
64,orz601d.map,41,101,419,4,85,36,15,1419,14,95,26,5,-10,10,20,157,142
65,orz601d.map,41,101,3201,31,30,9,70,1957,19,62,21,38,12,32,44,45,61
66,orz601d.map,41,101,1912,18,6,22,94,3350,33,83,7,17,-15,77,92,113,164
67,orz601d.map,41,101,1649,16,67,24,33,1503,14,11,26,89,2,-56,58,92,59
68,orz601d.map,41,101,1049,10,61,30,39,2092,20,28,20,72,-10,-33,43,49,74
69,orz601d.map,41,101,648,6,58,34,42,2593,25,32,15,68,-19,-26,45,79,104
70,orz601d.map,41,101,1577,15,38,25,62,3246,32,86,8,14,-17,48,65,133,66
71,orz601d.map,41,101,369,3,34,37,66,2475,24,49,16,51,-21,15,36,75,185
72,orz601d.map,41,101,1881,18,37,22,63,1966,19,53,21,47,-1,16,17,18,18
73,orz601d.map,41,101,170,1,31,39,69,1493,14,21,26,79,-13,-10,23,89,36
74,orz601d.map,41,101,3448,34,86,6,14,1492,14,22,26,78,20,-64,84,124,152
75,orz601d.map,41,101,1960,19,59,21,41,2591,25,34,15,66,-6,-25,31,32,32
76,orz601d.map,41,101,3705,36,31,4,69,1806,17,11,23,89,19,-20,39,80,215
77,orz601d.map,41,101,348,3,55,37,45,2532,25,93,15,7,-22,38,60,105,175
78,orz601d.map,41,101,2442,24,82,16,18,1468,14,46,26,54,10,-36,46,71,47
79,orz601d.map,41,101,1400,13,13,27,87,226,2,76,38,24,11,63,74,557,207
80,orz601d.map,41,101,656,6,50,34,50,2581,25,44,15,56,-19,-6,25,74,228
81,orz601d.map,41,101,2013,19,6,21,94,366,3,37,37,63,16,31,47,70,99
82,orz601d.map,41,101,1584,15,31,25,69,2528,25,97,15,3,-10,66,76,77,109
83,orz601d.map,41,101,2200,21,21,19,79,2621,25,4,15,96,-4,-17,21,22,22
84,orz601d.map,41,101,1542,15,73,25,27,3551,35,84,5,16,-20,11,31,74,32
85,orz601d.map,41,101,1952,19,67,21,33,1406,13,7,27,93,6,-60,66,350,69
86,orz601d.map,41,101,1508,14,6,26,94,2070,20,50,20,50,-6,44,50,52,236
87,orz601d.map,41,101,1619,16,97,24,3,1782,17,35,23,65,-1,-62,63,92,227
88,orz601d.map,41,101,2040,20,80,20,20,2456,24,68,16,32,-4,-12,16,17,17
89,orz601d.map,41,101,1564,15,51,25,49,1799,17,18,23,82,-2,-33,35,36,36
90,orz601d.map,41,101,3092,30,38,10,62,2046,20,74,20,26,10,36,46,72,487
91,orz601d.map,41,101,2417,23,6,17,94,2249,22,73,18,27,1,67,68,71,135
92,orz601d.map,41,101,1696,16,20,24,80,2997,29,32,11,68,-13,12,25,26,26
93,orz601d.map,41,101,523,5,82,35,18,3204,31,27,9,73,-26,-55,81,181,219
94,orz601d.map,41,101,1904,18,14,22,86,2438,24,86,16,14,-6,72,78,79,79
95,orz601d.map,41,101,776,7,31,33,69,3757,37,80,3,20,-30,49,79,102,185
96,orz601d.map,41,101,1572,15,43,25,57,1878,18,40,22,60,-3,-3,6,7,7
97,orz601d.map,41,101,4057,40,83,0,17,1751,17,66,23,34,23,-17,40,41,65
98,orz601d.map,41,101,1785,17,32,23,68,2622,25,3,15,97,-8,-29,37,38,46
99,orz601d.map,41,101,728,7,79,33,21,1586,15,29,25,71,-8,-50,58,87,173
0,orz700d.map,796,896,240616,268,407,527,488,548081,611,270,184,625,-343,-137,480,14453,12074
1,orz700d.map,796,896,356212,397,395,398,500,631863,705,712,90,183,-308,317,625,34617,50827
2,orz700d.map,796,896,667826,745,589,50,306,665059,742,668,53,227,3,79,82,134,83
3,orz700d.map,796,896,292513,326,478,469,417,311941,348,762,447,133,-22,284,306,2769,4061
4,orz700d.map,796,896,234481,261,270,534,625,264246,294,73,501,822,-33,-197,230,5188,7675
5,orz700d.map,796,896,164682,183,181,612,714,269174,300,521,495,374,-117,340,457,2564,11058
6,orz700d.map,796,896,447248,499,751,296,144,422601,471,310,324,585,28,-441,469,45090,31828
7,orz700d.map,796,896,246921,275,374,520,521,301485,336,466,459,429,-61,92,153,166,570
8,orz700d.map,796,896,688680,768,343,27,552,300101,334,58,461,837,434,-285,719,73022,53147
9,orz700d.map,796,896,683307,762,340,33,555,45292,50,403,745,492,712,63,775,58923,68709
10,orz700d.map,796,896,583860,651,331,144,564,486740,543,683,252,212,108,352,460,19066,31365
11,orz700d.map,796,896,458969,512,678,283,217,292943,326,48,469,847,186,-630,816,50519,26648
12,orz700d.map,796,896,537796,600,699,195,196,319012,356,859,439,36,244,160,404,11693,11939
13,orz700d.map,796,896,652489,728,694,67,201,207597,231,274,564,621,497,-420,917,41037,26194
14,orz700d.map,796,896,321187,358,476,437,419,327117,365,818,430,77,-7,342,349,4360,13377
15,orz700d.map,796,896,250298,279,581,516,314,380469,424,330,371,565,-145,-251,396,9763,1905
16,orz700d.map,796,896,633861,707,506,88,389,194294,216,137,579,758,491,-369,860,67128,62193
17,orz700d.map,796,896,289437,323,866,472,29,451342,503,241,292,654,-180,-625,805,28906,16322
18,orz700d.map,796,896,525249,586,702,209,193,259390,289,449,506,446,297,-253,550,14193,13725
19,orz700d.map,796,896,144995,161,156,634,739,170876,190,259,605,636,-29,103,132,1903,1532
20,orz700d.map,796,896,61563,68,260,727,635,65885,73,418,722,477,-5,158,163,2900,2376
21,orz700d.map,796,896,509103,568,720,227,175,256863,286,288,509,607,282,-432,714,12784,17040
22,orz700d.map,796,896,529320,590,215,205,680,317619,354,460,441,435,236,245,481,8193,7603
23,orz700d.map,796,896,521736,582,631,213,264,43481,48,422,747,473,534,-209,743,20473,13878
24,orz700d.map,796,896,42616,47,391,748,504,266081,296,30,499,865,-249,-361,610,7291,9073
25,orz700d.map,796,896,677826,756,445,39,450,258354,288,589,507,306,468,144,612,31617,43182
26,orz700d.map,796,896,328833,367,894,428,1,115076,128,507,667,388,239,-387,626,15541,2735
27,orz700d.map,796,896,534229,596,682,199,213,220310,245,105,550,790,351,-577,928,37393,27232
28,orz700d.map,796,896,598152,667,375,128,520,675815,754,664,41,231,-87,289,376,1763,13448
29,orz700d.map,796,896,589107,657,460,138,435,295220,329,459,466,436,328,-1,329,19579,25810
30,orz700d.map,796,896,438281,489,758,306,137,679373,758,690,37,205,-269,-68,337,9006,5952
31,orz700d.map,796,896,356192,397,415,398,480,376930,420,285,375,610,-23,-130,153,917,796
32,orz700d.map,796,896,260765,291,866,504,29,349871,390,464,405,431,-99,-402,501,15269,10768
33,orz700d.map,796,896,317321,354,758,441,137,327050,365,885,430,10,-11,127,138,139,166
34,orz700d.map,796,896,259449,289,390,506,505,299315,334,844,461,51,-45,454,499,8282,4410
35,orz700d.map,796,896,435177,485,278,310,617,284939,318,884,477,11,167,606,773,15716,28087
36,orz700d.map,796,896,266928,297,79,498,816,270969,302,518,493,377,-5,439,444,8721,19436
37,orz700d.map,796,896,291646,325,449,470,446,407902,455,673,340,222,-130,224,354,11803,5498
38,orz700d.map,796,896,259296,289,543,506,352,243707,271,4,524,891,18,-539,557,20867,8703
39,orz700d.map,796,896,352169,393,854,402,41,488958,545,257,250,638,-152,-597,749,40235,16399
40,orz700d.map,796,896,493000,550,695,245,200,260194,290,541,505,354,260,-154,414,8391,7687
41,orz700d.map,796,896,258937,288,6,507,889,500171,558,692,237,203,-270,686,956,27470,46183
42,orz700d.map,796,896,476776,532,791,263,104,622059,694,660,101,235,-162,-131,293,2148,952
43,orz700d.map,796,896,600549,670,666,125,229,65973,73,330,722,565,597,-336,933,46393,33751
44,orz700d.map,796,896,608520,679,759,116,136,73864,82,503,713,392,597,-256,853,34220,31997
45,orz700d.map,796,896,527075,588,668,207,227,556918,621,393,174,502,-33,-275,308,19232,20454
46,orz700d.map,796,896,292945,326,46,469,849,186661,208,602,587,293,118,556,674,15128,26887
47,orz700d.map,796,896,577457,644,462,151,433,437471,488,672,307,223,156,210,366,14320,19662
48,orz700d.map,796,896,519408,579,271,216,624,668706,746,605,49,290,-167,334,501,5609,8012
49,orz700d.map,796,896,321756,359,803,436,92,526565,587,282,208,613,-228,-521,749,43902,17275
50,orz700d.map,796,896,647040,722,767,73,128,306571,342,756,453,139,380,-11,391,17962,22271
51,orz700d.map,796,896,128499,143,524,652,371,497447,555,728,240,167,-412,204,616,9177,18921
52,orz700d.map,796,896,303953,339,686,456,209,358588,400,707,395,188,-61,21,82,770,445
53,orz700d.map,796,896,680318,759,641,36,254,640094,714,545,81,350,45,-96,141,1479,152
54,orz700d.map,796,896,666056,743,567,52,328,393574,439,665,356,230,304,98,402,10164,9954
55,orz700d.map,796,896,303694,338,49,457,846,368686,411,465,384,430,-73,416,489,8757,20845
56,orz700d.map,796,896,432916,483,747,312,148,646199,721,712,74,183,-238,-35,273,9818,5644
57,orz700d.map,796,896,560587,625,308,170,587,440047,491,784,304,111,134,476,610,15126,32100
58,orz700d.map,796,896,496572,554,707,241,188,370236,413,707,382,188,141,0,141,4179,1455
59,orz700d.map,796,896,690174,770,641,25,254,460743,514,696,281,199,256,55,311,13002,5122
60,orz700d.map,796,896,505498,564,741,231,154,468703,523,800,272,95,41,59,100,101,101
61,orz700d.map,796,896,273330,305,845,490,50,318294,355,681,440,214,-50,-164,214,215,482
62,orz700d.map,796,896,183088,204,591,591,304,530141,591,290,204,605,-387,-301,688,19935,16327
63,orz700d.map,796,896,570425,636,326,159,569,293227,327,660,468,235,309,334,643,19020,33539
64,orz700d.map,796,896,294131,328,652,467,243,143197,159,162,636,733,169,-490,659,14369,2585
65,orz700d.map,796,896,379559,423,344,372,551,564167,629,312,166,583,-206,-32,238,4621,4647
66,orz700d.map,796,896,213238,237,9,558,886,309335,345,680,450,215,-108,671,779,8914,29334
67,orz700d.map,796,896,458845,512,802,283,93,176374,196,137,599,758,316,-665,981,33571,36506
68,orz700d.map,796,896,74009,82,358,713,537,569156,635,699,160,196,-553,341,894,15659,35422
69,orz700d.map,796,896,65827,73,476,722,419,314924,351,467,444,428,-278,-9,287,6663,10637
70,orz700d.map,796,896,13172,14,267,781,628,502847,561,704,234,191,-547,437,984,29269,14283
71,orz700d.map,796,896,250464,279,415,516,480,264781,295,434,500,461,-16,19,35,36,95
72,orz700d.map,796,896,285395,318,428,477,467,340613,380,762,415,133,-62,334,396,12696,5057
73,orz700d.map,796,896,274594,306,477,489,418,280686,313,657,482,238,-7,180,187,1382,1019
74,orz700d.map,796,896,639955,714,684,81,211,68613,76,378,719,517,638,-306,944,50844,21090
75,orz700d.map,796,896,656229,732,538,63,357,334383,373,720,422,175,359,182,541,19134,14069
76,orz700d.map,796,896,602313,672,694,123,201,548550,612,697,183,198,60,3,63,2139,2907
77,orz700d.map,796,896,339602,379,877,416,18,492117,549,682,246,213,-170,-195,365,8808,11685
78,orz700d.map,796,896,193393,215,142,580,753,127860,142,267,653,628,73,125,198,2591,1937
79,orz700d.map,796,896,677617,756,654,39,241,535060,597,747,198,148,159,93,252,9328,751
80,orz700d.map,796,896,462561,516,670,279,225,39155,43,268,752,627,473,-402,875,7743,27437
81,orz700d.map,796,896,310216,346,695,449,200,603292,673,611,122,284,-327,-84,411,13544,16292
82,orz700d.map,796,896,51706,57,261,738,634,647350,722,457,73,438,-665,196,861,51631,26599
83,orz700d.map,796,896,243320,271,391,524,504,666826,744,693,51,202,-473,302,775,23141,32888
84,orz700d.map,796,896,474144,529,735,266,160,597166,666,465,129,430,-137,-270,407,19673,4621
85,orz700d.map,796,896,558794,623,309,172,586,450852,503,731,292,164,120,422,542,13671,32122
86,orz700d.map,796,896,510032,569,687,226,208,529702,591,729,204,166,-22,42,64,106,623
87,orz700d.map,796,896,521187,581,284,214,611,286971,320,644,475,251,261,360,621,14563,24582
88,orz700d.map,796,896,81019,90,516,705,379,100733,112,514,683,381,-22,-2,24,43,32
89,orz700d.map,796,896,153033,170,182,625,713,506422,565,713,230,182,-395,531,926,22781,30205
90,orz700d.map,796,896,248106,276,85,519,810,631044,704,635,91,260,-428,550,978,36623,70485
91,orz700d.map,796,896,527969,589,670,206,225,358043,399,356,396,539,190,-314,504,30555,21360
92,orz700d.map,796,896,358419,400,876,395,19,682327,761,424,34,471,-361,-452,813,40896,36455
93,orz700d.map,796,896,639880,714,759,81,136,304866,340,669,455,226,374,-90,464,22012,17324
94,orz700d.map,796,896,590130,658,333,137,562,343215,383,848,412,47,275,515,790,47499,63684
95,orz700d.map,796,896,533291,595,724,200,171,336051,375,844,420,51,220,120,340,13854,11946
96,orz700d.map,796,896,676028,754,451,41,444,183406,204,273,591,622,550,-178,728,29532,49467
97,orz700d.map,796,896,182633,203,150,592,745,262190,292,337,503,558,-89,187,276,3668,5543
98,orz700d.map,796,896,672259,750,636,45,259,670645,748,458,47,437,2,-178,180,4816,1684
99,orz700d.map,796,896,125011,139,428,656,467,275051,306,20,489,875,-167,-408,575,10205,17502
0,orz701d.map,561,561,31713,56,263,504,297,131341,234,493,326,67,-178,230,408,8051,12626
1,orz701d.map,561,561,1262,2,420,558,140,293382,522,20,38,540,-520,-400,920,38554,26942
2,orz701d.map,561,561,71252,127,555,433,5,2382,4,422,556,138,123,-133,256,618,349
3,orz701d.map,561,561,85676,152,156,408,404,133540,238,538,322,22,-86,382,468,18617,22646
4,orz701d.map,561,561,196001,349,348,211,212,92606,165,519,395,41,184,171,355,1090,685
5,orz701d.map,561,561,88408,157,229,403,331,297305,529,24,31,536,-372,-205,577,23521,13262
6,orz701d.map,561,561,102953,183,270,377,290,88678,158,520,402,40,25,250,275,14463,19489
7,orz701d.map,561,561,102396,182,266,378,294,107934,192,338,368,222,-10,72,82,83,94
8,orz701d.map,561,561,285530,508,18,52,542,221981,395,174,165,386,113,156,269,4578,3880
9,orz701d.map,561,561,120172,214,442,346,118,42508,75,127,485,433,139,-315,454,26774,14568
10,orz701d.map,561,561,204420,364,344,196,216,17038,30,352,530,208,334,8,342,21152,9535
11,orz701d.map,561,561,101057,180,483,380,77,83596,149,553,411,7,31,70,101,104,294
12,orz701d.map,561,561,91762,163,241,397,319,188157,335,338,225,222,-172,97,269,7681,6300
13,orz701d.map,561,561,210031,374,343,186,217,107751,192,521,368,39,182,178,360,1095,627
14,orz701d.map,561,561,39564,70,266,490,294,215038,383,385,177,175,-313,119,432,9642,18953
15,orz701d.map,561,561,156883,279,196,281,364,254111,452,21,108,539,-173,-175,348,20751,10319
16,orz701d.map,561,561,73523,131,528,429,32,209989,374,385,186,175,-243,-143,386,9183,2642
17,orz701d.map,561,561,249618,444,26,116,534,15309,27,398,533,162,417,372,789,28671,39194
18,orz701d.map,561,561,101819,181,282,379,278,86308,153,85,407,475,28,-197,225,1043,2067
19,orz701d.map,561,561,187342,333,31,227,529,92023,164,541,396,19,169,510,679,6783,21916
20,orz701d.map,561,561,260587,464,277,96,283,259573,462,169,98,391,2,-108,110,177,259
21,orz701d.map,561,561,137291,244,153,316,407,44710,79,169,481,391,165,16,181,7411,8632
22,orz701d.map,561,561,11896,21,445,539,115,302901,539,38,21,522,-518,-407,925,38705,22747
23,orz701d.map,561,561,220160,392,312,168,248,83592,149,557,411,3,243,245,488,1228,1604
24,orz701d.map,561,561,90346,161,535,399,25,69231,123,332,437,228,38,-203,241,14187,5195
25,orz701d.map,561,561,258385,460,235,100,325,134447,239,192,321,368,221,-43,264,4525,5715
26,orz701d.map,561,561,84728,151,543,409,17,19763,35,432,525,128,116,-111,227,312,279
27,orz701d.map,561,561,95392,170,538,390,22,262290,467,257,93,303,-297,-281,578,1582,1372
28,orz701d.map,561,561,81546,145,359,415,201,27611,49,438,511,122,96,79,175,3705,5372
29,orz701d.map,561,561,86432,154,522,406,38,219331,390,19,170,541,-236,-503,739,24534,7740
30,orz701d.map,561,561,311896,555,19,5,541,2380,4,424,556,136,551,405,956,26514,38540
31,orz701d.map,561,561,234752,418,306,142,254,13595,24,429,536,131,394,123,517,13589,9624
32,orz701d.map,561,561,55237,98,301,462,259,158054,281,147,279,413,-183,-154,337,7085,7686
33,orz701d.map,561,561,33920,60,300,500,260,260609,464,255,96,305,-404,-45,449,11753,21878
34,orz701d.map,561,561,38008,67,139,493,421,116751,208,497,352,63,-141,358,499,15225,28529
35,orz701d.map,561,561,218985,390,365,170,195,35615,63,288,497,272,327,-77,404,19417,9537
36,orz701d.map,561,561,218441,389,348,171,212,69236,123,327,437,233,266,-21,287,15598,6427
37,orz701d.map,561,561,174241,310,229,250,331,89690,159,69,401,491,151,-160,311,4820,4574
38,orz701d.map,561,561,289450,515,25,45,535,213363,380,377,180,183,135,352,487,8437,13697
39,orz701d.map,561,561,88001,156,75,404,485,237506,423,357,137,203,-267,282,549,6437,10487
40,orz701d.map,561,561,90127,160,193,400,367,108559,193,274,367,286,-33,81,114,168,1297
41,orz701d.map,561,561,134480,239,159,321,401,27058,48,430,512,130,191,271,462,15815,22243
42,orz701d.map,561,561,205169,365,156,195,404,127802,227,105,333,455,138,-51,189,23124,17934
43,orz701d.map,561,561,118433,211,498,349,62,62305,111,526,449,34,100,28,128,205,310
44,orz701d.map,561,561,102553,182,109,378,451,146789,261,192,299,368,-79,83,162,3714,5479
45,orz701d.map,561,561,206867,368,141,192,419,135972,242,350,318,210,126,209,335,3385,10249
46,orz701d.map,561,561,201332,358,66,202,494,7988,14,426,546,134,344,360,704,24637,34419
47,orz701d.map,561,561,72976,130,514,430,46,121791,217,506,343,54,-87,-8,95,126,97
48,orz701d.map,561,561,47978,85,267,475,293,237127,422,175,138,385,-337,-92,429,19670,23162
49,orz701d.map,561,561,79555,141,106,419,454,123502,220,478,340,82,-79,372,451,14325,22081
50,orz701d.map,561,561,207995,370,135,190,425,164740,293,193,267,367,77,58,135,7417,15237
51,orz701d.map,561,561,93585,166,101,394,459,103847,185,498,375,62,-19,397,416,16171,25147
52,orz701d.map,561,561,132050,235,345,325,215,100707,179,272,381,288,56,-73,129,14035,12250
53,orz701d.map,561,561,120168,214,446,346,114,259599,462,143,98,417,-248,-303,551,1333,2298
54,orz701d.map,561,561,292816,521,25,39,535,161383,287,184,273,376,234,159,393,10323,20644
55,orz701d.map,561,561,239936,427,171,133,389,16465,29,364,531,196,398,193,591,29261,32676
56,orz701d.map,561,561,40100,71,291,489,269,67775,120,105,440,455,-49,-186,235,5392,9378
57,orz701d.map,561,561,34634,61,147,499,413,165899,295,156,265,404,-234,9,243,5819,6895
58,orz701d.map,561,561,86968,155,547,405,13,187031,333,342,227,218,-178,-205,383,876,1118
59,orz701d.map,561,561,18634,33,439,527,121,231934,413,319,147,241,-380,-120,500,9150,12882
60,orz701d.map,561,561,195768,348,20,212,540,257249,458,249,102,311,-110,229,339,708,799
61,orz701d.map,561,561,23815,42,307,518,253,77311,137,106,423,454,-95,-201,296,5645,9671
62,orz701d.map,561,561,190716,339,23,221,537,261966,466,20,94,540,-127,-3,130,131,131
63,orz701d.map,561,561,141769,252,163,308,397,129665,231,486,329,74,21,323,344,12011,12232
64,orz701d.map,561,561,254553,453,140,107,420,33377,59,282,501,278,394,142,536,22126,17199
65,orz701d.map,561,561,204633,364,131,196,429,214483,382,379,178,181,-18,248,266,3221,8437
66,orz701d.map,561,561,110887,197,190,363,370,259023,461,158,99,402,-264,-32,296,10688,10046
67,orz701d.map,561,561,137259,244,185,316,375,19867,35,328,525,232,209,143,352,8103,3974
68,orz701d.map,561,561,274306,488,22,72,538,90755,161,126,399,434,327,104,431,16540,23448
69,orz701d.map,561,561,260121,463,182,97,378,174243,310,227,250,333,153,45,198,4585,4210
70,orz701d.map,561,561,87928,156,148,404,412,124876,222,226,338,334,-66,78,144,1133,201
71,orz701d.map,561,561,87425,155,90,405,470,205756,366,130,194,430,-211,40,251,17914,15733
72,orz701d.map,561,561,245129,436,27,124,533,103279,184,505,376,55,252,478,730,8846,23150
73,orz701d.map,561,561,61960,110,310,450,250,255092,454,162,106,398,-344,-148,492,14722,20176
74,orz701d.map,561,561,193284,344,260,216,300,90806,161,75,399,485,183,-185,368,5684,5117
75,orz701d.map,561,561,93744,167,503,393,57,151841,270,189,290,371,-103,-314,417,11079,10788
76,orz701d.map,561,561,212587,378,31,182,529,62278,111,553,449,7,267,522,789,7708,28539
77,orz701d.map,561,561,82873,147,154,413,406,52446,93,287,467,273,54,133,187,7862,4480
78,orz701d.map,561,561,220659,393,374,167,186,76860,137,557,423,3,256,183,439,3029,8918
79,orz701d.map,561,561,89792,160,528,400,32,296167,527,40,33,520,-367,-488,855,25592,9421
80,orz701d.map,561,561,130194,232,518,328,42,116739,208,509,352,51,24,-9,33,34,34
81,orz701d.map,561,561,144533,257,204,303,356,126278,225,507,335,53,32,303,335,11925,9858
82,orz701d.map,561,561,147334,262,208,298,352,63286,112,106,448,454,150,-102,252,1950,3852
83,orz701d.map,561,561,205202,365,123,195,437,152427,271,164,289,396,94,41,135,8934,14450
84,orz701d.map,561,561,14752,26,394,534,166,81378,145,527,415,33,-119,133,252,302,254
85,orz701d.map,561,561,14216,25,369,535,191,118420,211,511,349,49,-186,142,328,3439,4482
86,orz701d.map,561,561,263416,469,253,91,307,123609,220,371,340,189,249,118,367,440,1149
87,orz701d.map,561,561,232465,414,349,146,211,33919,60,301,500,259,354,-48,402,21509,9545
88,orz701d.map,561,561,245682,437,35,123,525,126933,226,413,334,147,211,378,589,14998,18114
89,orz701d.map,561,561,84608,150,102,410,458,106481,189,108,371,452,-39,6,45,59,46
90,orz701d.map,561,561,60475,107,112,453,448,76342,136,514,424,46,-29,402,431,19323,25618
91,orz701d.map,561,561,301220,536,36,24,524,46855,83,268,477,292,453,232,685,26303,29950
92,orz701d.map,561,561,269112,479,167,81,393,91818,163,185,397,375,316,18,334,9737,11292
93,orz701d.map,561,561,262352,467,195,93,365,66211,118,547,442,13,349,352,701,2014,1921
94,orz701d.map,561,561,44717,79,162,481,398,59487,106,539,454,21,-27,377,404,19808,29242
95,orz701d.map,561,561,129674,231,477,329,83,149031,265,194,295,366,-34,-283,317,8452,12432
96,orz701d.map,561,561,114481,204,523,356,37,104619,186,287,374,273,18,-236,254,23045,15651
97,orz701d.map,561,561,47970,85,275,475,285,58597,104,307,456,253,-19,32,51,52,66
98,orz701d.map,561,561,203904,363,299,197,261,226064,402,18,158,542,-39,-281,320,13795,7838
99,orz701d.map,561,561,123003,219,416,341,144,258420,460,200,100,360,-241,-216,457,4865,814
0,orz702d.map,803,699,269169,385,644,417,54,386899,553,346,249,352,-168,-298,466,26198,50929
1,orz702d.map,803,699,484880,693,225,109,473,291812,417,369,385,329,276,144,420,19821,26910
2,orz702d.map,803,699,235105,336,457,466,241,245641,351,406,451,292,-15,-51,66,3538,3347
3,orz702d.map,803,699,271964,389,645,413,53,467397,668,233,134,465,-279,-412,691,54962,66510
4,orz702d.map,803,699,276484,395,319,407,379,355461,508,329,294,369,-113,10,123,1043,493
5,orz702d.map,803,699,69342,99,557,703,141,434542,621,235,181,463,-522,-322,844,55007,29800
6,orz702d.map,803,699,375353,536,9,266,689,257650,368,280,434,418,168,271,439,24405,41237
7,orz702d.map,803,699,187131,267,200,535,498,232174,332,592,470,106,-65,392,457,44621,29293
8,orz702d.map,803,699,171522,245,431,557,267,197599,282,217,520,481,-37,-214,251,10684,2727
9,orz702d.map,803,699,362414,518,366,284,332,454206,649,143,153,555,-131,-223,354,19210,19559
10,orz702d.map,803,699,193392,276,230,526,468,114092,163,543,639,155,113,313,426,15874,18968
11,orz702d.map,803,699,289016,413,369,389,329,272928,390,380,412,318,23,11,34,35,35
12,orz702d.map,803,699,4957,7,634,795,64,456294,652,152,150,546,-645,-482,1127,56694,31245
13,orz702d.map,803,699,556041,795,362,7,336,261070,373,355,429,343,422,-7,429,5839,9901
14,orz702d.map,803,699,214234,306,358,496,340,200242,286,370,516,328,20,12,32,33,33
15,orz702d.map,803,699,496065,709,224,93,474,442233,632,233,170,465,77,9,86,424,170
16,orz702d.map,803,699,83352,119,527,683,171,401147,573,78,229,620,-454,-449,903,60022,31000
17,orz702d.map,803,699,277817,397,384,405,314,293635,420,643,382,55,-23,259,282,50022,10666
18,orz702d.map,803,699,149932,214,352,588,346,151933,217,448,585,250,-3,96,99,815,962
19,orz702d.map,803,699,493252,705,241,97,457,440191,629,178,173,520,76,-63,139,1147,786
20,orz702d.map,803,699,159020,227,351,575,347,497445,711,242,91,456,-484,-109,593,31965,21837
21,orz702d.map,803,699,240082,343,373,459,325,383044,547,7,255,691,-204,-366,570,41764,22009
22,orz702d.map,803,699,233017,333,448,469,250,296724,424,350,378,348,-91,-98,189,2297,3993
23,orz702d.map,803,699,275011,393,394,409,304,349134,499,365,303,333,-106,-29,135,3747,2162
24,orz702d.map,803,699,245619,351,428,451,270,289022,413,363,389,335,-62,-65,127,666,3276
25,orz702d.map,803,699,426851,610,237,192,461,459691,657,250,145,448,-47,13,60,61,61
26,orz702d.map,803,699,481465,688,145,114,553,243500,348,450,454,248,340,305,645,19543,32166
27,orz702d.map,803,699,489044,699,255,103,443,440215,629,154,173,544,70,-101,171,2131,818
28,orz702d.map,803,699,253864,363,571,439,127,470232,672,194,130,504,-309,-377,686,58583,63231
29,orz702d.map,803,699,379913,543,342,259,356,279229,399,370,403,328,144,28,172,1607,1096
30,orz702d.map,803,699,237914,340,444,462,254,508492,727,379,75,319,-387,-65,452,12454,3264
31,orz702d.map,803,699,260353,372,373,430,325,261764,374,360,428,338,-2,-13,15,16,16
32,orz702d.map,803,699,437392,625,181,177,517,421151,602,345,200,353,23,164,187,16036,13936
33,orz702d.map,803,699,182024,260,414,542,284,495435,708,155,94,543,-448,-259,707,38150,22644
34,orz702d.map,803,699,250490,358,450,444,248,146795,210,693,592,5,148,243,391,28347,25199
35,orz702d.map,803,699,403220,576,102,226,596,422014,603,181,199,517,-27,79,106,1413,1126
36,orz702d.map,803,699,477872,683,243,119,455,94429,135,634,667,64,548,391,939,48199,54936
37,orz702d.map,803,699,131021,187,390,615,308,428302,612,184,190,514,-425,-206,631,40974,31422
38,orz702d.map,803,699,484169,692,237,110,461,443021,633,144,169,554,59,-93,152,1231,3928
39,orz702d.map,803,699,255265,365,568,437,130,272903,390,405,412,293,-25,-163,188,16946,45037
40,orz702d.map,803,699,456899,653,246,149,452,386887,553,358,249,340,100,112,212,17648,12701
41,orz702d.map,803,699,349179,499,320,303,378,275068,393,337,409,361,106,17,123,249,1780
42,orz702d.map,803,699,449970,643,185,159,513,70059,100,539,702,159,543,354,897,30727,56495
43,orz702d.map,803,699,488419,698,181,104,517,309006,442,650,360,48,256,469,725,66568,55225
44,orz702d.map,803,699,107200,153,445,649,253,78428,112,558,690,140,41,113,154,294,157
45,orz702d.map,803,699,540001,772,325,30,373,232174,332,592,470,106,440,267,707,63059,47273
46,orz702d.map,803,699,157995,226,677,576,21,293159,419,420,383,278,-193,-257,450,18318,30002
47,orz702d.map,803,699,170578,244,676,558,22,539950,772,376,30,322,-528,-300,828,37306,45490
48,orz702d.map,803,699,153814,220,664,582,34,396959,567,72,235,626,-347,-592,939,60034,56419
49,orz702d.map,803,699,521777,746,375,56,323,370467,529,2,273,696,217,-373,590,12492,16355
50,orz702d.map,803,699,182061,260,377,542,321,153814,220,664,582,34,40,287,327,14205,11883
51,orz702d.map,803,699,267328,382,388,420,310,217681,311,406,491,292,71,18,89,97,148
52,orz702d.map,803,699,188806,270,622,532,76,346982,496,420,306,278,-226,-202,428,21371,43034
53,orz702d.map,803,699,377800,540,358,262,340,200954,287,357,515,341,253,-1,254,1890,4758
54,orz702d.map,803,699,443605,634,259,168,439,230774,330,594,472,104,304,335,639,63168,54970
55,orz702d.map,803,699,257672,368,258,434,440,172303,246,349,556,349,122,91,213,2927,1070
56,orz702d.map,803,699,454811,650,237,152,461,212854,304,340,498,358,346,103,449,19681,35183
57,orz702d.map,803,699,300152,429,417,373,281,284188,406,304,396,394,23,-113,136,1106,2324
58,orz702d.map,803,699,327185,468,645,334,53,181793,260,645,542,53,208,0,208,3457,1915
59,orz702d.map,803,699,432451,618,229,184,469,58158,83,557,719,141,535,328,863,29887,55016
60,orz702d.map,803,699,9851,14,633,788,65,452133,646,119,156,579,-632,-514,1146,56934,31243
61,orz702d.map,803,699,401128,573,97,229,601,390704,558,36,244,662,15,-61,76,113,77
62,orz702d.map,803,699,356808,510,380,292,318,32239,46,613,756,85,464,233,697,10477,21592
63,orz702d.map,803,699,42722,61,615,741,83,237399,339,260,463,438,-278,-355,633,21471,1878
64,orz702d.map,803,699,240778,344,376,458,322,538555,770,373,32,325,-426,-3,429,10310,5660
65,orz702d.map,803,699,295353,422,323,380,375,486820,696,382,106,316,-274,59,333,2301,370
66,orz702d.map,803,699,261667,374,457,428,241,447228,639,131,163,567,-265,-326,591,35960,20301
67,orz702d.map,803,699,138433,198,667,604,31,415554,594,350,208,348,-396,-317,713,27112,37673
68,orz702d.map,803,699,234553,335,310,467,388,465996,666,236,136,462,-331,-74,405,33187,16227
69,orz702d.map,803,699,354669,507,422,295,276,180621,258,419,544,279,249,-3,252,4942,3910
70,orz702d.map,803,699,419178,599,221,203,477,199487,285,426,517,272,314,205,519,24126,37540
71,orz702d.map,803,699,321200,459,339,343,359,251771,360,567,442,131,99,228,327,46568,13252
72,orz702d.map,803,699,254108,363,327,439,371,426725,610,363,192,335,-247,36,283,2853,303
73,orz702d.map,803,699,98032,140,526,662,172,258162,369,467,433,231,-229,-59,288,13096,6694
74,orz702d.map,803,699,235116,336,446,466,252,98620,141,637,661,61,195,191,386,15597,26536
75,orz702d.map,803,699,200197,286,415,516,283,268095,383,320,419,378,-97,-95,192,390,1670
76,orz702d.map,803,699,88946,127,525,675,173,390031,557,10,245,688,-430,-515,945,60142,30990
77,orz702d.map,803,699,471656,674,168,128,530,387924,554,20,248,678,120,-148,268,553,562
78,orz702d.map,803,699,197426,282,390,520,308,101619,145,434,657,264,137,44,181,1634,746
79,orz702d.map,803,699,185515,265,418,537,280,204397,292,409,510,289,-27,-9,36,37,37
80,orz702d.map,803,699,305825,437,336,365,362,275078,393,327,409,371,44,-9,53,54,54
81,orz702d.map,803,699,348472,498,328,304,370,247518,354,626,448,72,144,298,442,49941,28514
82,orz702d.map,803,699,432514,618,166,184,532,448501,641,256,161,442,-23,90,113,115,114
83,orz702d.map,803,699,81259,116,523,686,175,400879,573,346,229,352,-457,-177,634,15161,11225
84,orz702d.map,803,699,302008,432,658,370,40,177115,253,430,549,268,179,-228,407,9253,43960
85,orz702d.map,803,699,93219,133,446,669,252,186980,267,351,535,347,-134,-95,229,1165,807
86,orz702d.map,803,699,139122,199,677,603,21,155886,223,689,579,9,-24,12,36,37,37
87,orz702d.map,803,699,279969,400,329,402,369,421997,603,198,199,500,-203,-131,334,34253,17423
88,orz702d.map,803,699,129588,185,425,617,273,128935,184,379,618,319,1,-46,47,68,48
89,orz702d.map,803,699,289653,414,431,388,267,318406,455,337,347,361,-41,-94,135,1537,1855
90,orz702d.map,803,699,459553,657,388,145,310,245645,351,402,451,296,306,14,320,5267,10989
91,orz702d.map,803,699,283478,405,315,397,383,240750,344,404,458,294,61,89,150,152,201
92,orz702d.map,803,699,209344,299,355,503,343,203687,291,420,511,278,8,65,73,610,502
93,orz702d.map,803,699,274365,392,341,410,357,86815,124,559,678,139,268,218,486,1027,2733
94,orz702d.map,803,699,406473,581,344,221,354,268741,384,373,418,325,197,29,226,2344,1831
95,orz702d.map,803,699,162878,233,687,569,11,268798,384,316,418,382,-151,-371,522,10706,31838
96,orz702d.map,803,699,205836,294,368,508,330,45543,65,590,737,108,229,222,451,874,1232
97,orz702d.map,803,699,302317,432,349,370,349,109230,156,512,646,186,276,163,439,17688,3311
98,orz702d.map,803,699,384094,549,355,253,343,441615,631,152,171,546,-82,-203,285,17697,19436
99,orz702d.map,803,699,445811,637,150,165,548,525263,751,384,51,314,-114,234,348,13111,5179
0,orz703d.map,502,652,307201,471,542,30,109,194226,297,69,204,582,174,-473,647,61958,578
1,orz703d.map,502,652,61848,94,91,407,560,217142,333,625,168,26,-239,534,773,903,20854
2,orz703d.map,502,652,36089,55,422,446,229,116927,179,432,322,219,-124,10,134,3715,2444
3,orz703d.map,502,652,188228,288,199,213,452,18469,28,438,473,213,260,239,499,1973,1143
4,orz703d.map,502,652,142490,218,297,283,354,108611,166,272,335,379,52,-25,77,78,78
5,orz703d.map,502,652,76669,117,266,384,385,322262,494,477,7,174,-377,211,588,61958,2086
6,orz703d.map,502,652,127042,194,97,307,554,192791,295,200,206,451,-101,103,204,3513,3754
7,orz703d.map,502,652,88370,135,301,366,350,124258,190,273,311,378,-55,-28,83,84,84
8,orz703d.map,502,652,180426,276,177,225,474,126779,194,360,307,291,82,183,265,580,61958
9,orz703d.map,502,652,100568,154,491,347,160,217538,333,229,168,422,-179,-262,441,2105,61958
10,orz703d.map,502,652,35436,54,423,447,228,117863,180,148,321,503,-126,-275,401,518,1986
11,orz703d.map,502,652,186574,286,549,215,102,180734,277,521,224,130,9,-28,37,38,38
12,orz703d.map,502,652,187402,287,373,214,278,306463,470,628,31,23,-183,255,438,1813,813
13,orz703d.map,502,652,194736,298,211,203,440,152365,233,202,268,449,65,-9,74,81,183
14,orz703d.map,502,652,168356,258,511,243,140,185942,285,529,216,122,-27,18,45,57,46
15,orz703d.map,502,652,186922,286,201,215,450,111716,171,427,330,224,115,226,341,1294,637
16,orz703d.map,502,652,119921,183,46,318,605,285082,437,493,64,158,-254,447,701,702,1960
17,orz703d.map,502,652,103308,158,359,343,292,83885,128,222,373,429,30,-137,167,168,168
18,orz703d.map,502,652,146668,224,31,277,620,161647,247,48,254,603,-23,17,40,581,61958
19,orz703d.map,502,652,209697,321,246,180,405,194026,297,269,204,382,24,23,47,48,48
20,orz703d.map,502,652,318342,488,485,13,166,180103,276,500,225,151,212,15,227,2086,61958
21,orz703d.map,502,652,199276,305,235,196,416,243862,374,637,127,14,-69,402,471,61958,580
22,orz703d.map,502,652,137994,211,229,290,422,34781,53,426,448,225,158,197,355,1686,382
23,orz703d.map,502,652,166870,255,41,246,610,124175,190,356,311,295,65,315,380,2083,6773
24,orz703d.map,502,652,302046,463,481,38,170,193191,296,452,205,199,167,-29,196,2086,61958
25,orz703d.map,502,652,140458,215,373,286,278,172053,263,74,238,577,-48,-299,347,580,578
26,orz703d.map,502,652,245810,377,645,124,6,99444,152,311,349,340,225,-334,559,580,61958
27,orz703d.map,502,652,143076,219,363,282,288,113812,174,287,327,364,45,-76,121,122,122
28,orz703d.map,502,652,205412,315,619,186,32,303348,465,483,36,168,-150,-136,286,61958,2086
29,orz703d.map,502,652,199043,305,468,196,183,217132,333,635,168,16,-28,167,195,2403,3322
30,orz703d.map,502,652,131850,202,505,299,146,71478,109,241,392,410,93,-264,357,2012,416
31,orz703d.map,502,652,118459,181,204,320,447,96263,147,232,354,419,34,28,62,63,113
32,orz703d.map,502,652,122697,188,530,313,121,97558,149,241,352,410,39,-289,328,2105,61958
33,orz703d.map,502,652,170968,262,507,239,144,111135,170,356,331,295,92,-151,243,765,246
34,orz703d.map,502,652,243986,374,513,127,138,13867,21,476,480,175,353,-37,390,61958,594
35,orz703d.map,502,652,111696,171,447,330,204,225333,345,258,156,393,-174,-189,363,61958,578
36,orz703d.map,502,652,243963,374,536,127,115,140470,215,361,286,290,159,-175,334,9942,2068
37,orz703d.map,502,652,121434,186,489,315,162,202378,310,393,191,258,-124,-96,220,2946,2612
38,orz703d.map,502,652,135891,208,376,293,275,294229,451,474,50,177,-243,98,341,580,2086
39,orz703d.map,502,652,42600,65,431,436,220,117906,180,105,321,546,-115,-326,441,558,2172
40,orz703d.map,502,652,146676,224,23,277,628,203438,312,637,189,14,-88,614,702,581,591
41,orz703d.map,502,652,220196,337,179,164,472,115879,177,176,324,475,160,-3,163,4048,1917
42,orz703d.map,502,652,87683,134,336,367,315,117708,180,303,321,348,-46,-33,79,80,80
43,orz703d.map,502,652,106002,162,273,339,378,130022,199,377,302,274,-37,104,141,61958,580
44,orz703d.map,502,652,34786,53,421,448,230,214983,329,176,172,475,-276,-245,521,1375,2015
45,orz703d.map,502,652,64161,98,386,403,265,200185,307,630,194,21,-209,244,453,61958,591
46,orz703d.map,502,652,201720,309,399,192,252,194522,298,425,203,226,11,26,37,38,38
47,orz703d.map,502,652,41936,64,443,437,208,303929,466,554,35,97,-402,111,513,6563,17501
48,orz703d.map,502,652,96254,147,241,354,410,195134,299,465,202,186,-152,224,376,20834,4343
49,orz703d.map,502,652,186401,285,70,216,581,79886,122,309,379,342,163,239,402,578,61958
50,orz703d.map,502,652,189996,291,387,210,264,101495,155,216,346,435,136,-171,307,4436,33413
51,orz703d.map,502,652,124818,191,365,310,286,115893,177,162,324,489,14,-203,217,600,218
52,orz703d.map,502,652,186090,285,381,216,270,95605,146,238,355,413,139,-143,282,4423,34094
53,orz703d.map,502,652,112507,172,288,329,363,47523,72,72,429,579,100,-216,316,5976,3120
54,orz703d.map,502,652,885,1,418,500,233,188823,289,256,212,395,-288,-162,450,578,61958
55,orz703d.map,502,652,169323,259,196,242,455,224013,343,274,158,377,-84,78,162,61958,578
56,orz703d.map,502,652,255742,392,493,109,158,200582,307,233,194,418,85,-260,345,17590,12297
57,orz703d.map,502,652,115752,177,303,324,348,89011,136,312,365,339,41,9,50,51,51
58,orz703d.map,502,652,4778,7,437,494,214,135783,208,484,293,167,-201,47,248,61958,191
59,orz703d.map,502,652,126202,193,285,308,366,305247,468,540,33,111,-275,255,530,5737,10694
60,orz703d.map,502,652,110553,169,286,332,365,230215,353,592,148,59,-184,306,490,525,1012
61,orz703d.map,502,652,315717,484,502,17,149,185311,284,508,217,143,200,6,206,2086,61958
62,orz703d.map,502,652,165760,254,499,247,152,301297,462,578,39,73,-208,79,287,2947,288
63,orz703d.map,502,652,164251,251,52,250,599,212055,325,496,176,155,-74,444,518,5484,9917
64,orz703d.map,502,652,132695,203,312,298,339,266815,409,504,92,147,-206,192,398,2756,9556
65,orz703d.map,502,652,116562,178,145,323,506,98826,151,277,350,374,27,132,159,271,1904
66,orz703d.map,502,652,78682,120,209,381,442,211932,325,619,176,32,-205,410,615,569,61958
67,orz703d.map,502,652,244001,374,498,127,153,182972,280,239,221,412,94,-259,353,19008,12083
68,orz703d.map,502,652,115138,176,265,325,386,109173,167,362,334,289,9,97,106,107,107
69,orz703d.map,502,652,317666,487,509,14,142,118461,181,202,320,449,306,-307,613,2086,61958
70,orz703d.map,502,652,56640,86,83,415,568,245943,377,512,124,139,-291,429,720,1800,12740
71,orz703d.map,502,652,112589,172,206,329,445,89614,137,361,364,290,35,155,190,195,61958
72,orz703d.map,502,652,164910,252,45,249,606,300015,460,556,41,95,-208,511,719,7840,15371
73,orz703d.map,502,652,156416,239,63,262,588,116359,178,348,323,303,61,285,346,440,744
74,orz703d.map,502,652,215409,330,402,171,249,153853,235,18,266,633,95,-384,479,61958,581
75,orz703d.map,502,652,121028,185,243,316,408,76054,116,229,385,422,69,-14,83,84,84
76,orz703d.map,502,652,193569,296,74,205,577,300671,461,552,40,99,-165,478,643,578,61958
77,orz703d.map,502,652,88453,135,218,366,433,4150,6,413,495,238,129,195,324,61958,578
78,orz703d.map,502,652,301348,462,527,39,124,314407,482,508,19,143,-20,-19,39,61958,2086
79,orz703d.map,502,652,185622,284,197,217,454,145735,223,312,278,339,61,115,176,177,177
80,orz703d.map,502,652,236169,362,506,139,145,203485,312,590,189,61,50,84,134,2240,2150
81,orz703d.map,502,652,72040,110,331,391,320,189585,290,146,211,505,-180,-185,365,61958,580
82,orz703d.map,502,652,183195,280,16,221,635,161653,247,42,254,609,33,26,59,60,60
83,orz703d.map,502,652,216193,331,270,170,381,95534,146,309,355,342,185,39,224,578,61958
84,orz703d.map,502,652,199040,305,471,196,180,105535,161,88,340,563,144,-383,527,7662,20020
85,orz703d.map,502,652,124739,191,444,310,207,123084,188,143,313,508,3,-301,304,417,417
86,orz703d.map,502,652,285744,438,483,63,168,94927,145,264,356,387,293,-219,512,2086,61958
87,orz703d.map,502,652,128697,197,398,304,253,239428,367,507,134,144,-170,109,279,255,61958
88,orz703d.map,502,652,74737,114,242,387,409,68202,104,257,397,394,10,15,25,26,26
89,orz703d.map,502,652,220866,338,161,163,490,222123,340,208,161,443,-2,47,49,562,61958
90,orz703d.map,502,652,144528,221,215,280,436,183970,282,545,219,106,-61,330,391,9463,7762
91,orz703d.map,502,652,92882,142,353,359,298,227574,349,625,152,26,-207,272,479,542,1082
92,orz703d.map,502,652,97938,150,513,351,138,125957,193,530,308,121,-43,17,60,61,61
93,orz703d.map,502,652,41941,64,438,437,213,137479,210,92,291,559,-146,-346,492,609,2333
94,orz703d.map,502,652,173230,265,201,236,450,250511,384,508,117,143,-119,307,426,14055,12945
95,orz703d.map,502,652,185923,285,548,216,103,184622,283,545,218,106,2,-3,5,6,6
96,orz703d.map,502,652,206408,316,275,185,376,4115,6,448,495,203,310,173,483,61958,594
97,orz703d.map,502,652,26937,41,446,460,205,47783,73,464,428,187,-32,18,50,61958,580
98,orz703d.map,502,652,210977,323,270,178,381,124430,190,101,311,550,133,-169,302,10607,7263
99,orz703d.map,502,652,167528,256,35,245,616,193387,296,256,205,395,-40,221,261,10627,11039
0,orz704d.map,40,80,2937,36,22,3,57,2306,28,13,11,66,8,-9,17,19,26
1,orz704d.map,40,80,2829,35,50,4,29,1887,23,32,16,47,12,-18,30,31,31
2,orz704d.map,40,80,1993,24,6,15,73,2221,27,18,12,61,-3,12,15,16,16
3,orz704d.map,40,80,992,12,47,27,32,1850,23,69,16,10,-11,22,33,34,39
4,orz704d.map,40,80,1385,17,54,22,25,1215,15,64,24,15,2,10,12,13,13
5,orz704d.map,40,80,2072,25,7,14,72,2137,26,22,13,57,-1,15,16,17,17
6,orz704d.map,40,80,2204,27,35,12,44,143,1,16,38,63,26,-19,45,46,46
7,orz704d.map,40,80,2464,30,15,9,64,1991,24,8,15,71,6,-7,13,14,14
8,orz704d.map,40,80,2156,26,3,13,76,1636,20,43,19,36,6,40,46,52,47
9,orz704d.map,40,80,986,12,53,27,26,3188,39,11,0,68,-27,-42,69,106,70
10,orz704d.map,40,80,592,7,47,32,32,2304,28,15,11,64,-21,-32,53,68,55
11,orz704d.map,40,80,2600,32,39,7,40,447,5,32,34,47,27,-7,34,35,35
12,orz704d.map,40,80,2385,29,14,10,65,201,2,38,37,41,27,24,51,53,120
13,orz704d.map,40,80,1717,21,42,18,37,2437,30,42,9,37,-9,0,9,10,10
14,orz704d.map,40,80,213,2,26,37,53,1038,12,1,27,78,-10,-25,35,36,36
15,orz704d.map,40,80,2114,26,45,13,34,1919,23,0,16,79,3,-45,48,49,49
16,orz704d.map,40,80,2288,28,31,11,48,2445,30,34,9,45,-2,3,5,6,6
17,orz704d.map,40,80,1216,15,63,24,16,1453,18,66,21,13,-3,3,6,7,7
18,orz704d.map,40,80,2200,27,39,12,40,295,3,24,36,55,24,-15,39,40,40
19,orz704d.map,40,80,597,7,42,32,37,1607,20,72,19,7,-13,30,43,46,55
20,orz704d.map,40,80,2361,29,38,10,41,1434,17,5,22,74,12,-33,45,46,46
21,orz704d.map,40,80,1274,15,5,24,74,148,1,11,38,68,14,6,20,21,21
22,orz704d.map,40,80,3026,37,13,2,66,2996,37,43,2,36,0,30,30,31,31
23,orz704d.map,40,80,377,4,22,35,57,1014,12,25,27,54,-8,3,11,12,12
24,orz704d.map,40,80,3018,37,21,2,58,2771,34,28,5,51,3,7,10,11,11
25,orz704d.map,40,80,2133,26,26,13,53,1477,18,42,21,37,8,16,24,25,25
26,orz704d.map,40,80,1216,15,63,24,16,3020,37,19,2,60,-22,-44,66,124,67
27,orz704d.map,40,80,2385,29,14,10,65,1474,18,45,21,34,11,31,42,43,43
28,orz704d.map,40,80,1453,18,66,21,13,366,4,33,35,46,14,-33,47,48,51
29,orz704d.map,40,80,966,12,73,27,6,1399,17,40,22,39,-5,-33,38,39,82
30,orz704d.map,40,80,273,3,46,36,33,1125,14,74,25,5,-11,28,39,43,55
31,orz704d.map,40,80,986,12,53,27,26,1364,17,75,22,4,-5,22,27,28,44
32,orz704d.map,40,80,1188,14,11,25,68,1661,20,18,19,61,-6,7,13,14,14
33,orz704d.map,40,80,2056,25,23,14,56,2020,25,59,14,20,0,36,36,37,37
34,orz704d.map,40,80,1297,16,62,23,17,676,8,43,31,36,8,-19,27,28,29
35,orz704d.map,40,80,1923,24,76,15,3,518,6,41,33,38,18,-35,53,70,57
36,orz704d.map,40,80,2523,31,36,8,43,2671,33,48,6,31,-2,12,14,15,15
37,orz704d.map,40,80,280,3,39,36,40,2119,26,40,13,39,-23,1,24,25,25
38,orz704d.map,40,80,982,12,57,27,22,1062,13,57,26,22,-1,0,1,2,2
39,orz704d.map,40,80,1109,13,10,26,69,958,11,1,28,78,2,-9,11,12,12
40,orz704d.map,40,80,2170,27,69,12,10,3093,38,26,1,53,-11,-43,54,57,324
41,orz704d.map,40,80,2601,32,38,7,41,2930,36,29,3,50,-4,-9,13,14,14
42,orz704d.map,40,80,304,3,15,36,64,1854,23,65,16,14,-20,50,70,74,71
43,orz704d.map,40,80,2309,28,10,11,69,2687,33,32,6,47,-5,22,27,28,28
44,orz704d.map,40,80,1227,15,52,24,27,831,10,48,29,31,5,-4,9,10,10
45,orz704d.map,40,80,2514,31,45,8,34,1378,17,61,22,18,14,16,30,31,31
46,orz704d.map,40,80,434,5,45,34,34,194,2,45,37,34,3,0,3,4,4
47,orz704d.map,40,80,368,4,31,35,48,3091,38,28,1,51,-34,-3,37,38,38
48,orz704d.map,40,80,3009,37,30,2,49,1075,13,44,26,35,24,14,38,39,39
49,orz704d.map,40,80,948,11,11,28,68,2070,25,9,14,70,-14,-2,16,49,41
50,orz704d.map,40,80,3168,39,31,0,48,1532,19,67,20,12,20,36,56,57,57
51,orz704d.map,40,80,2449,30,30,9,49,790,9,9,30,70,21,-21,42,60,43
52,orz704d.map,40,80,2116,26,43,13,36,1781,22,58,17,21,4,15,19,20,20
53,orz704d.map,40,80,770,9,29,30,50,1946,24,53,15,26,-15,24,39,40,40
54,orz704d.map,40,80,836,10,43,29,36,2518,31,41,8,38,-21,-2,23,24,24
55,orz704d.map,40,80,1928,24,71,15,8,1299,16,60,23,19,8,-11,19,20,20
56,orz704d.map,40,80,1985,24,14,15,65,2762,34,37,5,42,-10,23,33,34,34
57,orz704d.map,40,80,1564,19,35,20,44,1390,17,49,22,30,2,14,16,17,17
58,orz704d.map,40,80,1986,24,13,15,66,2684,33,35,6,44,-9,22,31,32,32
59,orz704d.map,40,80,450,5,29,34,50,2759,34,40,5,39,-29,11,40,41,41
60,orz704d.map,40,80,2138,26,21,13,58,3015,37,24,2,55,-11,3,14,15,15
61,orz704d.map,40,80,1443,18,76,21,3,1965,24,34,15,45,-6,-42,48,49,49
62,orz704d.map,40,80,2074,25,5,14,74,1995,24,4,15,75,1,-1,2,3,3
63,orz704d.map,40,80,2172,27,67,12,12,1501,18,18,21,61,9,-49,58,59,59
64,orz704d.map,40,80,984,12,55,27,24,1656,20,23,19,56,-8,-32,40,41,41
65,orz704d.map,40,80,2067,25,12,14,67,1950,24,49,15,30,1,37,38,39,39
66,orz704d.map,40,80,1724,21,35,18,44,2348,29,51,10,28,-8,16,24,25,25
67,orz704d.map,40,80,2170,27,69,12,10,757,9,42,30,37,18,-27,45,51,46
68,orz704d.map,40,80,49,0,30,39,49,2076,25,3,14,76,-25,-27,52,83,64
69,orz704d.map,40,80,2116,26,43,13,36,1711,21,48,18,31,5,5,10,11,11
70,orz704d.map,40,80,2990,37,49,2,30,1207,15,72,24,7,22,23,45,46,46
71,orz704d.map,40,80,385,4,14,35,65,2371,29,28,10,51,-25,14,39,40,40
72,orz704d.map,40,80,921,11,38,28,41,1991,24,8,15,71,-13,-30,43,107,44
73,orz704d.map,40,80,3025,37,14,2,65,1774,22,65,17,14,15,51,66,67,67
74,orz704d.map,40,80,372,4,27,35,52,2694,33,25,6,54,-29,-2,31,32,32
75,orz704d.map,40,80,696,8,23,31,56,1662,20,17,19,62,-12,-6,18,19,20
76,orz704d.map,40,80,1107,13,12,26,67,1356,16,3,23,76,-3,-9,12,13,13
77,orz704d.map,40,80,1240,15,39,24,40,1615,20,64,19,15,-5,25,30,31,31
78,orz704d.map,40,80,1437,17,2,22,77,670,8,49,31,30,9,47,56,95,57
79,orz704d.map,40,80,1285,16,74,23,5,1373,17,66,22,13,-1,-8,9,10,10
80,orz704d.map,40,80,2205,27,34,12,45,1686,21,73,18,6,6,39,45,46,46
81,orz704d.map,40,80,1601,20,78,19,1,994,12,45,27,34,8,-33,41,58,42
82,orz704d.map,40,80,954,11,5,28,74,2180,27,59,12,20,-16,54,70,71,71
83,orz704d.map,40,80,2595,32,44,7,35,1307,16,52,23,27,16,8,24,25,25
84,orz704d.map,40,80,1954,24,45,15,34,442,5,37,34,42,19,-8,27,28,28
85,orz704d.map,40,80,1033,12,6,27,73,60,0,19,39,60,12,13,25,28,26
86,orz704d.map,40,80,2832,35,47,4,32,2757,34,42,5,37,1,-5,6,7,7
87,orz704d.map,40,80,1002,12,37,27,42,1626,20,53,19,26,-8,16,24,25,25
88,orz704d.map,40,80,299,3,20,36,59,214,2,25,37,54,1,5,6,7,7
89,orz704d.map,40,80,1993,24,6,15,73,2615,32,24,7,55,-8,18,26,27,27
90,orz704d.map,40,80,2588,32,51,7,28,1095,13,24,26,55,19,-27,46,47,47
91,orz704d.map,40,80,1892,23,27,16,52,2765,34,34,5,45,-11,7,18,19,19
92,orz704d.map,40,80,1640,20,39,19,40,1256,15,23,24,56,5,-16,21,22,22
93,orz704d.map,40,80,1785,22,54,17,25,1385,17,54,22,25,5,0,5,6,6
94,orz704d.map,40,80,296,3,23,36,56,2175,27,64,12,15,-24,41,65,69,66
95,orz704d.map,40,80,2299,28,20,11,59,766,9,33,30,46,19,13,32,33,33
96,orz704d.map,40,80,1655,20,24,19,55,1407,17,32,22,47,3,8,11,12,12
97,orz704d.map,40,80,2515,31,44,8,35,139,1,20,38,59,30,-24,54,57,55
98,orz704d.map,40,80,1074,13,45,26,34,2917,36,42,3,37,-23,-3,26,27,27
99,orz704d.map,40,80,1498,18,21,21,58,508,6,51,33,28,12,30,42,43,43
0,orz800d.map,844,867,625099,720,7,123,859,653084,753,633,90,233,-33,626,659,660,4876
1,orz800d.map,844,867,684008,788,54,55,812,130487,150,429,693,437,638,375,1013,39563,17110
2,orz800d.map,844,867,136545,157,440,686,426,217314,250,302,593,564,-93,-138,231,1969,1920
3,orz800d.map,844,867,330829,381,364,462,502,642118,740,328,103,538,-359,-36,395,8077,19244
4,orz800d.map,844,867,567451,654,433,189,433,656436,757,749,86,117,-103,316,419,420,744
5,orz800d.map,844,867,127009,146,439,697,427,691027,797,838,46,28,-651,399,1050,11816,39795
6,orz800d.map,844,867,656138,756,180,87,686,591291,681,2,162,864,75,-178,253,341,254
7,orz800d.map,844,867,651353,751,630,92,236,662422,764,832,79,34,-13,202,215,216,216
8,orz800d.map,844,867,678885,783,842,60,24,430607,496,291,347,575,287,-551,838,28874,2130
9,orz800d.map,844,867,624688,720,418,123,448,212134,244,280,599,586,476,-138,614,16317,7898
10,orz800d.map,844,867,615576,710,860,133,6,603883,696,415,147,451,14,-445,459,4913,5661
11,orz800d.map,844,867,218251,251,232,592,634,649044,748,338,95,528,-497,106,603,11811,18446
12,orz800d.map,844,867,655571,756,747,87,119,632437,729,472,114,394,27,-275,302,621,303
13,orz800d.map,844,867,651525,751,458,92,408,87125,100,441,743,425,651,-17,668,27263,11390
14,orz800d.map,844,867,621691,717,814,126,52,719595,829,14,14,852,-112,-800,912,913,8577
15,orz800d.map,844,867,632000,728,42,115,824,138286,159,433,684,433,569,391,960,39486,22713
16,orz800d.map,844,867,637253,735,858,108,8,649815,749,434,94,432,-14,-424,438,439,1193
17,orz800d.map,844,867,683196,788,866,55,0,9126,10,410,833,456,778,-456,1234,40682,11835
18,orz800d.map,844,867,585201,674,23,169,843,146965,169,424,674,442,505,401,906,39445,24594
19,orz800d.map,844,867,613785,707,50,136,816,203396,234,348,609,518,473,298,771,35009,21460
20,orz800d.map,844,867,179029,206,439,637,427,282319,325,322,518,544,-119,-117,236,3877,4350
21,orz800d.map,844,867,646740,745,41,98,825,634135,731,508,112,358,14,467,481,4015,1422
22,orz800d.map,844,867,681505,786,823,57,43,411498,474,326,369,540,312,-497,809,3153,1481
23,orz800d.map,844,867,642922,741,391,102,475,658091,759,828,84,38,-18,437,455,456,2396
24,orz800d.map,844,867,543170,626,438,217,428,500691,577,434,266,432,49,-4,53,54,136
25,orz800d.map,844,867,640241,738,471,105,395,658927,760,859,83,7,-22,388,410,411,1027
26,orz800d.map,844,867,679787,784,807,59,59,702246,809,23,34,843,-25,-784,809,2443,4784
27,orz800d.map,844,867,415872,479,287,364,579,580036,669,853,174,13,-190,566,756,12242,15481
28,orz800d.map,844,867,655515,756,803,87,63,218164,251,319,592,547,505,-484,989,34264,7539
29,orz800d.map,844,867,693577,799,22,44,844,582193,671,430,172,436,128,408,536,2658,537
30,orz800d.map,844,867,604290,696,8,147,858,652565,752,285,91,581,-56,277,333,334,589
31,orz800d.map,844,867,642561,741,752,102,114,639543,737,302,106,564,4,-450,454,3263,1518
32,orz800d.map,844,867,303154,349,295,494,571,669310,771,13,72,853,-422,-282,704,10435,28472
33,orz800d.map,844,867,410658,473,299,370,567,663332,765,789,78,77,-292,490,782,1454,2051
34,orz800d.map,844,867,725691,837,854,6,12,416589,480,437,363,429,357,-417,774,16779,1515
35,orz800d.map,844,867,656792,757,393,86,473,690108,795,23,48,843,-38,-370,408,853,2635
36,orz800d.map,844,867,429786,495,245,348,621,646282,745,499,98,367,-250,254,504,2225,19497
37,orz800d.map,844,867,613010,707,825,136,41,369895,426,313,417,553,281,-512,793,24272,12088
38,orz800d.map,844,867,632122,729,787,114,79,623781,719,458,124,408,10,-329,339,1001,1912
39,orz800d.map,844,867,642768,741,545,102,321,639833,737,12,106,854,4,-533,537,2270,3917
40,orz800d.map,844,867,216523,249,226,594,640,660740,762,780,81,86,-513,554,1067,6350,26405
41,orz800d.map,844,867,214728,247,287,596,579,212935,245,346,598,520,2,59,61,115,67
42,orz800d.map,844,867,186915,215,356,628,510,571779,659,440,184,426,-444,84,528,8275,18021
43,orz800d.map,844,867,649731,749,518,94,348,656694,757,491,86,375,-8,-27,35,36,36
44,orz800d.map,844,867,661138,762,382,81,484,660214,761,439,82,427,1,57,58,59,59
45,orz800d.map,844,867,94068,108,434,735,432,677095,780,31,63,835,-672,-403,1075,17125,39714
46,orz800d.map,844,867,654033,754,551,89,315,163502,188,360,655,506,566,-191,757,24589,9269
47,orz800d.map,844,867,451308,520,398,323,468,656566,757,619,86,247,-237,221,458,1079,593
48,orz800d.map,844,867,590440,681,853,162,13,652117,752,733,91,133,-71,-120,191,192,195
49,orz800d.map,844,867,645193,744,721,99,145,663219,764,35,79,831,-20,-686,706,707,1489
50,orz800d.map,844,867,399403,460,283,383,583,616030,710,406,133,460,-250,123,373,3197,5527
51,orz800d.map,844,867,613024,707,811,136,55,413222,476,336,367,530,231,-475,706,3784,9795
52,orz800d.map,844,867,450395,519,444,324,422,16053,18,419,825,447,501,-25,526,14501,11695
53,orz800d.map,844,867,219093,252,257,591,609,688374,793,23,50,843,-541,-234,775,12161,29216
54,orz800d.map,844,867,665864,768,858,75,8,634238,731,405,112,461,37,-453,490,4909,491
55,orz800d.map,844,867,643048,741,265,102,601,660674,762,846,81,20,-21,581,602,603,2558
56,orz800d.map,844,867,654964,755,487,88,379,555319,640,427,203,439,115,-60,175,176,176
57,orz800d.map,844,867,652116,752,734,91,132,438407,505,294,338,572,247,-440,687,20663,1960
58,orz800d.map,844,867,640232,738,480,105,386,658519,759,400,84,466,-21,-80,101,102,310
59,orz800d.map,844,867,597798,689,431,154,435,667614,770,842,73,24,-81,411,492,493,2527
60,orz800d.map,844,867,676260,780,866,63,0,212926,245,355,598,511,535,-511,1046,36921,8453
61,orz800d.map,844,867,643408,742,772,101,94,246050,283,177,560,689,459,-595,1054,32136,7003
62,orz800d.map,844,867,240852,277,173,566,693,586974,677,851,166,15,-400,678,1078,20934,37504
63,orz800d.map,844,867,653101,753,616,90,250,145214,167,441,676,425,586,-175,761,31565,11355
64,orz800d.map,844,867,623308,718,64,125,802,620813,716,825,127,41,2,761,763,8060,8919
65,orz800d.map,844,867,654601,755,850,88,16,641341,739,238,104,628,16,-612,628,3456,629
66,orz800d.map,844,867,627275,723,432,120,434,642179,740,267,103,599,-17,-165,182,183,279
67,orz800d.map,844,867,626409,722,431,121,435,407241,469,248,374,618,253,-183,436,11683,1514
68,orz800d.map,844,867,20393,23,414,820,452,457363,527,412,316,454,-504,-2,506,10500,13993
69,orz800d.map,844,867,655395,755,56,88,810,4803,5,398,838,468,750,342,1092,40453,17075
70,orz800d.map,844,867,686684,792,846,51,20,612054,705,47,138,819,87,-799,886,9450,887
71,orz800d.map,844,867,642025,740,421,103,445,579594,668,428,175,438,72,7,79,80,80
72,orz800d.map,844,867,645216,744,698,99,168,651028,750,88,93,778,-6,-610,616,617,1293
73,orz800d.map,844,867,638169,736,809,107,57,634268,731,375,112,491,5,-434,439,2031,2288
74,orz800d.map,844,867,366426,422,314,421,552,718724,828,18,15,848,-406,-296,702,8374,26445
75,orz800d.map,844,867,611665,705,436,138,430,648774,748,608,95,258,-43,172,215,216,318
76,orz800d.map,844,867,654366,754,218,89,648,662319,763,68,80,798,-9,-150,159,160,160
77,orz800d.map,844,867,649651,749,598,94,268,577428,666,860,177,6,83,262,345,562,346
78,orz800d.map,844,867,147827,170,429,673,437,654924,755,527,88,339,-585,98,683,11214,28264
79,orz800d.map,844,867,704017,812,853,31,13,216469,249,280,594,586,563,-573,1136,35555,6102
80,orz800d.map,844,867,648648,748,734,95,132,574394,662,426,181,440,86,-308,394,701,395
81,orz800d.map,844,867,628552,724,22,119,844,146081,168,441,675,425,556,419,975,39629,23288
82,orz800d.map,844,867,662362,763,25,80,841,312676,360,310,483,556,403,285,688,27613,10415
83,orz800d.map,844,867,638633,736,345,107,521,623311,718,61,125,805,18,-284,302,662,1262
84,orz800d.map,844,867,659306,760,480,83,386,395935,456,283,387,583,304,-197,501,14226,2004
85,orz800d.map,844,867,344745,397,320,446,546,684989,790,807,53,59,-393,487,880,2167,24981
86,orz800d.map,844,867,565706,652,444,191,422,651099,750,17,93,849,-98,-427,525,8526,3962
87,orz800d.map,844,867,641760,740,686,103,180,5653,6,415,837,451,734,-271,1005,37456,11607
88,orz800d.map,844,867,219017,252,333,591,533,148701,171,422,672,444,81,89,170,1619,1234
89,orz800d.map,844,867,656952,757,233,86,633,605618,698,414,145,452,59,181,240,394,241
90,orz800d.map,844,867,629426,725,15,118,851,649886,749,363,94,503,-24,348,372,373,858
91,orz800d.map,844,867,616896,711,407,132,459,240750,277,275,566,591,434,-132,566,13841,8079
92,orz800d.map,844,867,641088,739,491,104,375,642748,741,565,102,301,-2,74,76,77,91
93,orz800d.map,844,867,632001,728,41,115,825,606470,699,429,144,437,29,388,417,2551,3437
94,orz800d.map,844,867,633361,730,415,113,451,609094,702,406,141,460,28,-9,37,38,38
95,orz800d.map,844,867,636017,733,360,110,506,600812,692,18,151,848,41,-342,383,854,3499
96,orz800d.map,844,867,642364,740,82,103,784,643046,741,267,102,599,-1,185,186,187,187
97,orz800d.map,844,867,593445,684,449,159,417,666703,768,19,75,847,-84,-430,514,515,2623
98,orz800d.map,844,867,611633,705,468,138,398,642319,740,127,103,739,-35,-341,376,377,683
99,orz800d.map,844,867,652667,752,183,91,683,648155,747,360,96,506,5,177,182,183,183
0,orz900d.map,633,1397,116627,83,720,549,676,675423,483,724,149,672,-400,4,404,8823,13168
1,orz900d.map,633,1397,843429,603,358,29,1038,541526,387,509,245,887,216,151,367,4339,10418
2,orz900d.map,633,1397,505680,361,33,271,1363,504453,361,1260,271,136,0,1227,1227,79248,89754
3,orz900d.map,633,1397,437654,313,1003,319,393,574814,411,749,221,647,-98,-254,352,17598,17229
4,orz900d.map,633,1397,662584,474,990,158,406,752556,538,426,94,970,-64,-564,628,67755,70403
5,orz900d.map,633,1397,461451,330,955,302,441,257812,184,632,448,764,146,-323,469,38749,44415
6,orz900d.map,633,1397,555033,397,972,235,424,872510,624,614,8,782,-227,-358,585,56703,73335
7,orz900d.map,633,1397,139073,99,626,533,770,497475,356,1253,276,143,-257,627,884,41083,44604
8,orz900d.map,633,1397,115336,82,614,550,782,413922,296,986,336,410,-214,372,586,40879,39153
9,orz900d.map,633,1397,447940,320,496,312,900,653166,467,629,165,767,-147,133,280,27340,22360
10,orz900d.map,633,1397,545953,390,273,242,1123,320319,229,990,403,406,161,717,878,73433,80202
11,orz900d.map,633,1397,589940,422,990,210,406,512822,367,1273,265,123,55,283,338,4054,3097
12,orz900d.map,633,1397,589066,421,467,211,929,358055,256,973,376,423,165,506,671,76281,70497
13,orz900d.map,633,1397,568074,406,504,226,892,517669,370,617,262,779,36,113,149,28778,23295
14,orz900d.map,633,1397,824976,590,650,42,746,437904,313,753,319,643,277,103,380,39546,35557
15,orz900d.map,633,1397,115227,82,723,550,673,577605,413,752,219,644,-331,29,360,4089,11401
16,orz900d.map,633,1397,561387,401,206,231,1190,514261,368,1231,264,165,33,1025,1058,79957,83063
17,orz900d.map,633,1397,720986,516,1262,116,134,500475,358,1047,274,349,158,-215,373,2234,5590
18,orz900d.map,633,1397,700880,501,413,131,983,675164,483,983,149,413,18,570,588,70804,64432
19,orz900d.map,633,1397,119387,85,754,547,642,565628,404,156,228,1240,-319,-598,917,61188,41695
20,orz900d.map,633,1397,420904,301,989,331,407,412887,295,624,337,772,6,-365,371,48272,45827
21,orz900d.map,633,1397,601691,430,415,202,981,554725,397,1280,235,116,33,865,898,80874,70970
22,orz900d.map,633,1397,519577,371,106,261,1290,196339,140,637,492,759,231,531,762,40304,63767
23,orz900d.map,633,1397,604475,432,425,200,971,139079,99,620,533,776,333,195,528,33815,37822
24,orz900d.map,633,1397,586233,419,506,213,890,523125,374,749,258,647,45,243,288,53510,66574
25,orz900d.map,633,1397,505953,362,1157,270,239,732142,524,1282,108,114,-162,125,287,4613,2822
26,orz900d.map,633,1397,182393,130,613,502,783,109634,78,728,554,668,52,115,167,4054,1742
27,orz900d.map,633,1397,81829,58,593,574,803,777511,556,617,76,779,-498,24,522,13964,9054
28,orz900d.map,633,1397,618440,442,430,190,966,442328,316,520,316,876,126,90,216,329,2036
29,orz900d.map,633,1397,736334,527,1281,105,115,543559,389,1270,243,126,138,-11,149,1868,2820
30,orz900d.map,633,1397,420113,300,383,332,1013,174020,124,604,508,792,176,221,397,38200,48674
31,orz900d.map,633,1397,481466,344,498,288,898,383679,274,495,358,901,70,-3,73,74,74
32,orz900d.map,633,1397,333272,238,610,394,786,344439,246,619,386,777,-8,9,17,18,19
33,orz900d.map,633,1397,624856,447,999,185,397,554601,396,7,236,1389,51,-992,1043,90119,73221
34,orz900d.map,633,1397,806829,577,636,55,760,762334,545,427,87,969,32,-209,241,8417,4085
35,orz900d.map,633,1397,707020,506,1258,126,138,508492,363,15,269,1381,143,-1243,1386,89484,86256
36,orz900d.map,633,1397,201953,144,611,488,785,661298,473,879,159,517,-329,268,597,29983,20021
37,orz900d.map,633,1397,516864,369,25,263,1371,608164,435,927,197,469,-66,902,968,70579,89164
38,orz900d.map,633,1397,799968,572,512,60,884,435439,311,424,321,972,261,-88,349,9169,15727
39,orz900d.map,633,1397,854342,611,621,21,775,591847,423,480,209,916,188,-141,329,12789,9786
40,orz900d.map,633,1397,582361,416,187,216,1209,673757,482,993,150,403,-66,806,872,71876,80497
41,orz900d.map,633,1397,312265,223,662,409,734,491181,351,562,281,834,-128,-100,228,42890,31604
42,orz900d.map,633,1397,537686,384,158,248,1238,460255,329,754,303,642,55,596,651,53140,82247
43,orz900d.map,633,1397,257627,184,817,448,579,410293,293,424,339,972,-109,-393,502,66206,47721
44,orz900d.map,633,1397,457790,327,425,305,971,848711,607,664,25,732,-280,239,519,16068,22220
45,orz900d.map,633,1397,418714,299,385,333,1011,671111,480,845,152,551,-181,460,641,61526,75065
46,orz900d.map,633,1397,553201,395,10,237,1386,539236,385,5,247,1391,10,-5,15,16,16
47,orz900d.map,633,1397,60864,43,603,589,793,419754,300,742,332,654,-257,139,396,17353,14683
48,orz900d.map,633,1397,260619,186,619,446,777,838998,600,598,32,798,-414,-21,435,8327,11098
49,orz900d.map,633,1397,111040,79,719,553,677,608588,435,503,197,893,-356,-216,572,48068,41552
50,orz900d.map,633,1397,513339,367,756,265,640,547612,391,11,241,1385,-24,-745,769,88286,53039
51,orz900d.map,633,1397,388761,278,1001,354,395,473206,338,376,294,1020,-60,-625,685,74467,73395
52,orz900d.map,633,1397,509136,364,768,268,628,512238,366,460,266,936,-2,-308,310,68647,55564
53,orz900d.map,633,1397,559248,400,948,232,448,549916,393,501,239,895,7,-447,454,70714,77130
54,orz900d.map,633,1397,520325,372,755,260,641,215950,154,584,478,812,218,-171,389,15730,16128
55,orz900d.map,633,1397,293955,210,811,422,585,520591,372,489,260,907,-162,-322,484,59498,47910
56,orz900d.map,633,1397,194969,139,610,493,786,560035,400,161,232,1235,-261,-449,710,57971,40513
57,orz900d.map,633,1397,686072,491,1251,141,145,854311,611,652,21,744,-120,-599,719,55557,80480
58,orz900d.map,633,1397,577088,413,1269,219,127,432438,309,631,323,765,104,-638,742,48824,57258
59,orz900d.map,633,1397,711994,509,475,123,921,98563,70,623,562,773,439,148,587,27398,20549
60,orz900d.map,633,1397,257811,184,633,448,763,588903,421,630,211,766,-237,-3,240,1487,3490
61,orz900d.map,633,1397,475365,340,1011,292,385,370838,265,763,367,633,75,-248,323,21448,19177
62,orz900d.map,633,1397,548284,392,736,240,660,570380,408,992,224,404,-16,256,272,15377,14816
63,orz900d.map,633,1397,714781,511,482,121,914,861597,616,351,16,1045,-105,-131,236,401,1876
64,orz900d.map,633,1397,676304,484,1240,148,156,583748,417,197,215,1199,67,-1043,1110,80488,84734
65,orz900d.map,633,1397,651523,466,875,166,521,773307,553,630,79,766,-87,-245,332,47935,53383
66,orz900d.map,633,1397,846214,605,367,27,1029,714607,511,656,121,740,94,289,383,6131,10096
67,orz900d.map,633,1397,422864,302,426,330,970,313335,224,989,408,407,78,563,641,73437,75079
68,orz900d.map,633,1397,510272,365,1029,267,367,499377,357,748,275,648,8,-281,289,18640,17230
69,orz900d.map,633,1397,640293,458,929,174,467,522398,373,79,259,1317,85,-850,935,89647,71490
70,orz900d.map,633,1397,151494,108,778,524,618,427006,305,475,327,921,-197,-303,500,49867,44716
71,orz900d.map,633,1397,383180,274,994,358,402,518982,371,701,261,695,-97,-293,390,18120,18753
72,orz900d.map,633,1397,467027,334,967,298,429,781699,559,620,73,776,-225,-347,572,55873,70656
73,orz900d.map,633,1397,636155,455,876,177,520,496127,355,1204,277,192,100,328,428,2340,14130
74,orz900d.map,633,1397,590424,422,506,210,890,312313,223,614,409,782,199,108,307,30135,36901
75,orz900d.map,633,1397,496345,355,986,277,410,428438,306,440,326,956,49,-546,595,74780,73300
76,orz900d.map,633,1397,428050,306,828,326,568,855802,612,558,20,838,-306,-270,576,35495,46631
77,orz900d.map,633,1397,340245,243,622,389,774,402742,288,990,344,406,-45,368,413,44444,46094
78,orz900d.map,633,1397,658390,471,993,161,403,599487,429,1222,203,174,42,229,271,11840,7965
79,orz900d.map,633,1397,509529,364,375,268,1021,485157,347,998,285,398,17,623,640,73320,73540
80,orz900d.map,633,1397,699512,500,384,132,1012,488420,349,529,283,867,151,145,296,598,2421
81,orz900d.map,633,1397,519360,371,323,261,1073,548286,392,734,240,662,-21,411,432,54560,76319
82,orz900d.map,633,1397,738522,528,490,104,906,565900,405,1281,227,115,123,791,914,79971,63048
83,orz900d.map,633,1397,584083,418,1259,214,137,429796,307,479,325,917,111,-780,891,72584,80854
84,orz900d.map,633,1397,781721,559,598,73,798,839243,600,353,32,1043,-41,-245,286,8471,5523
85,orz900d.map,633,1397,551961,395,1250,237,146,187773,134,821,498,575,261,-429,690,30824,30741
86,orz900d.map,633,1397,526166,376,502,256,894,579238,414,516,218,880,-38,14,52,53,53
87,orz900d.map,633,1397,481458,344,506,288,890,623581,446,877,186,519,-102,371,473,68670,70768
88,orz900d.map,633,1397,508076,363,431,269,965,669812,479,747,153,649,-116,316,432,55214,70860
89,orz900d.map,633,1397,154325,110,741,522,655,582702,417,1243,215,153,-307,502,809,46562,42751
90,orz900d.map,633,1397,443514,317,731,315,665,507483,363,1024,269,372,-46,293,339,18243,18663
91,orz900d.map,633,1397,537624,384,220,248,1176,506699,362,411,270,985,22,191,213,4515,3712
92,orz900d.map,633,1397,507010,362,100,270,1296,406035,290,491,342,905,72,391,463,8044,17263
93,orz900d.map,633,1397,24499,17,646,615,750,158565,113,692,519,704,-96,46,142,5436,6471
94,orz900d.map,633,1397,685147,490,779,142,617,91565,65,636,567,760,425,-143,568,19714,26046
95,orz900d.map,633,1397,699517,500,379,132,1017,734326,525,495,107,901,-25,116,141,142,340
96,orz900d.map,633,1397,679564,486,774,146,622,516486,369,403,263,993,117,-371,488,71546,57693
97,orz900d.map,633,1397,561721,402,1269,230,127,589685,422,1245,210,151,-20,-24,44,45,45
98,orz900d.map,633,1397,429441,307,834,325,562,509277,364,627,268,769,-57,-207,264,25349,24721
99,orz900d.map,633,1397,527611,377,454,255,942,517862,370,424,262,972,7,-30,37,103,52
0,orz901d.map,620,567,120872,213,465,406,101,167804,295,27,324,539,-82,-438,520,21419,39706
1,orz901d.map,620,567,137738,242,42,377,524,114908,202,192,417,374,40,150,190,1365,1258
2,orz901d.map,620,567,92752,163,235,456,331,279393,492,137,127,429,-329,-98,427,13695,15018
3,orz901d.map,620,567,27504,48,278,571,288,76706,135,405,484,161,-87,127,214,4804,1348
4,orz901d.map,620,567,282208,497,157,122,409,24075,42,305,577,261,455,148,603,27313,19993
5,orz901d.map,620,567,127108,224,466,395,100,271951,479,208,140,358,-255,-258,513,27748,39716
6,orz901d.map,620,567,40939,72,451,547,115,317343,559,176,60,390,-487,-275,762,27795,33563
7,orz901d.map,620,567,148461,261,92,358,474,137597,242,183,377,383,19,91,110,454,111
8,orz901d.map,620,567,269772,475,119,144,447,140525,247,90,372,476,228,-29,257,10240,8984
9,orz901d.map,620,567,23477,41,336,578,230,110671,195,460,424,106,-154,124,278,13785,11464
10,orz901d.map,620,567,144449,254,135,365,431,36963,65,458,554,108,189,323,512,18586,21116
11,orz901d.map,620,567,188800,332,10,287,556,277094,488,168,131,398,-156,158,314,439,797
12,orz901d.map,620,567,134275,236,103,383,463,216549,381,44,238,522,-145,-59,204,2035,2348
13,orz901d.map,620,567,106653,188,509,431,57,30734,54,450,565,116,134,-59,193,2218,5667
14,orz901d.map,620,567,138185,243,162,376,404,48860,86,468,533,98,157,306,463,18177,20939
15,orz901d.map,620,567,285618,503,149,116,417,260123,458,129,161,437,45,-20,65,66,66
16,orz901d.map,620,567,54442,96,556,523,10,39797,70,459,549,107,26,-97,123,124,129
17,orz901d.map,620,567,73880,130,396,489,170,103575,182,185,437,381,-52,-211,263,14747,16744
18,orz901d.map,620,567,48776,86,552,533,14,300942,530,134,89,432,-444,-418,862,32231,36870
19,orz901d.map,620,567,36538,64,316,555,250,87701,154,183,465,383,-90,-133,223,10124,6379
20,orz901d.map,620,567,97323,171,200,448,366,257781,454,203,165,363,-283,3,286,9203,14714
21,orz901d.map,620,567,253290,446,158,173,408,96727,170,229,449,337,276,71,347,14412,9039
22,orz901d.map,620,567,19120,33,157,586,409,192198,338,14,281,552,-305,-143,448,5567,13835
23,orz901d.map,620,567,277116,488,146,131,420,78638,138,174,481,392,350,28,378,18323,13249
24,orz901d.map,620,567,253286,446,162,173,404,188782,332,28,287,538,114,-134,248,731,257
25,orz901d.map,620,567,240251,423,156,196,410,288996,509,173,110,393,-86,17,103,104,104
26,orz901d.map,620,567,20720,36,258,583,308,66577,117,328,502,238,-81,70,151,497,390
27,orz901d.map,620,567,282225,497,140,122,426,107798,190,498,429,68,307,358,665,39771,31723
28,orz901d.map,620,567,43209,76,449,543,117,213086,375,105,244,461,-299,-344,643,28339,33536
29,orz901d.map,620,567,18234,32,476,587,90,13938,24,236,595,330,8,-240,248,5593,8209
30,orz901d.map,620,567,264072,465,149,154,417,139020,245,461,374,105,220,312,532,39742,30509
31,orz901d.map,620,567,143952,253,65,366,501,274842,484,152,135,414,-231,87,318,5997,9197
32,orz901d.map,620,567,298681,526,127,93,439,38106,67,449,552,117,459,322,781,33567,32644
33,orz901d.map,620,567,270857,477,168,142,398,61807,109,562,510,4,368,394,762,36625,27705
34,orz901d.map,620,567,27668,48,114,571,452,81460,143,187,476,379,-95,73,168,1025,1187
35,orz901d.map,620,567,36920,65,501,554,65,25409,44,105,575,461,21,-396,417,9368,11419
36,orz901d.map,620,567,225640,397,25,222,541,66140,116,198,503,368,281,173,454,4052,6080
37,orz901d.map,620,567,23057,40,189,579,377,227910,401,23,218,543,-361,-166,527,10466,16270
38,orz901d.map,620,567,66345,117,560,502,6,59938,105,163,514,403,12,-397,409,17865,18580
39,orz901d.map,620,567,95268,168,554,451,12,312238,550,178,69,388,-382,-376,758,27788,36671
40,orz901d.map,620,567,18587,32,123,587,443,280483,494,181,125,385,-462,58,520,17226,23772
41,orz901d.map,620,567,304857,537,188,82,378,178569,314,35,305,531,223,-153,376,8366,515
42,orz901d.map,620,567,13713,24,461,595,105,93966,165,155,454,411,-141,-306,447,19572,16617
43,orz901d.map,620,567,292417,515,154,104,412,27889,49,460,570,106,466,306,772,33596,27613
44,orz901d.map,620,567,112349,198,483,421,83,142142,250,174,369,392,-52,-309,361,20586,34708
45,orz901d.map,620,567,224936,396,162,223,404,92228,162,192,457,374,234,30,264,11739,9060
46,orz901d.map,620,567,152496,268,26,351,540,110938,195,193,424,373,73,167,240,1505,405
47,orz901d.map,620,567,55825,98,307,521,259,97372,171,151,448,415,-73,-156,229,10798,7357
48,orz901d.map,620,567,334368,589,161,30,405,136461,240,185,379,381,349,24,373,14698,15021
49,orz901d.map,620,567,145592,256,126,363,440,147343,259,76,360,490,-3,-50,53,94,72
50,orz901d.map,620,567,257220,453,197,166,369,55141,97,424,522,142,356,227,583,33511,27711
51,orz901d.map,620,567,20627,36,351,583,215,143351,252,99,367,467,-216,-252,468,11823,11736
52,orz901d.map,620,567,57945,102,455,517,111,134819,237,126,382,440,-135,-329,464,22852,18739
53,orz901d.map,620,567,288408,508,194,111,372,21630,38,482,581,84,470,288,758,33720,27763
54,orz901d.map,620,567,157027,276,31,343,535,61068,107,167,512,399,169,136,305,5325,2853
55,orz901d.map,620,567,71248,125,193,494,373,272532,480,194,139,372,-355,1,356,9812,14978
56,orz901d.map,620,567,217142,382,18,237,548,20070,35,341,584,225,347,323,670,19136,16005
57,orz901d.map,620,567,17657,31,486,588,80,112866,199,533,420,33,-168,47,215,2850,3765
58,orz901d.map,620,567,289009,509,160,110,406,143895,253,122,366,444,256,-38,294,14117,4758
59,orz901d.map,620,567,209733,369,56,250,510,287887,507,148,112,418,-138,92,230,1880,2710
60,orz901d.map,620,567,280529,494,135,125,431,38020,67,535,552,31,427,400,827,33736,32117
61,orz901d.map,620,567,286700,505,201,114,365,108094,190,202,429,364,315,1,316,15140,9107
62,orz901d.map,620,567,112372,198,460,421,106,281596,496,202,123,364,-298,-258,556,27759,39696
63,orz901d.map,620,567,53989,95,442,524,124,1439,2,261,617,305,93,-181,274,5030,7022
64,orz901d.map,620,567,89601,158,551,461,15,31431,55,320,564,246,103,-231,334,10509,9467
65,orz901d.map,620,567,72809,128,333,491,233,294701,519,138,100,428,-391,-195,586,27516,26258
66,orz901d.map,620,567,214314,377,11,242,555,292438,515,133,104,433,-138,122,260,3810,3861
67,orz901d.map,620,567,213700,376,58,243,508,126540,223,467,396,99,153,409,562,40850,26880
68,orz901d.map,620,567,246450,434,194,185,372,270291,476,167,143,399,-42,-27,69,70,91
69,orz901d.map,620,567,210883,371,40,248,526,349702,616,136,3,430,-245,96,341,8773,1368
70,orz901d.map,620,567,138264,243,83,376,483,211436,372,54,247,512,-129,-29,158,1828,1950
71,orz901d.map,620,567,14376,25,365,594,201,7680,13,257,606,309,12,-108,120,491,610
72,orz901d.map,620,567,291256,513,181,106,385,132788,234,456,385,110,279,275,554,39751,27754
73,orz901d.map,620,567,38443,67,112,552,454,92596,163,391,456,175,-96,279,375,5660,4940
74,orz901d.map,620,567,99008,174,216,445,350,13155,23,452,596,114,151,236,387,16832,18287
75,orz901d.map,620,567,141034,248,148,371,418,142190,250,126,369,440,-2,-22,24,25,25
76,orz901d.map,620,567,95012,167,243,452,323,25797,45,284,574,282,122,41,163,7396,9320
77,orz901d.map,620,567,143283,252,167,367,399,35275,62,445,557,121,190,278,468,18179,20734
78,orz901d.map,620,567,342314,603,153,16,413,215379,379,80,240,486,224,-73,297,6340,5695
79,orz901d.map,620,567,39770,70,486,549,80,189925,334,19,285,547,-264,-467,731,21865,31006
80,orz901d.map,620,567,245921,433,156,186,410,45588,80,338,539,228,353,182,535,28594,20538
81,orz901d.map,620,567,74442,131,401,488,165,63510,112,560,507,6,19,159,178,2755,1747
82,orz901d.map,620,567,281658,496,140,123,426,93382,164,172,455,394,332,32,364,18528,13440
83,orz901d.map,620,567,91721,161,132,458,434,85428,150,188,469,378,11,56,67,130,406
84,orz901d.map,620,567,113498,200,468,419,98,291834,514,170,105,396,-314,-298,612,27744,39690
85,orz901d.map,620,567,95458,168,364,451,202,328685,579,174,40,392,-411,-190,601,27813,26546
86,orz901d.map,620,567,230054,405,147,214,419,94471,166,217,453,349,239,70,309,12226,12388
87,orz901d.map,620,567,280528,494,136,125,430,52283,92,447,527,119,402,311,713,33539,32033
88,orz901d.map,620,567,44372,78,420,541,146,109503,193,494,426,72,-115,74,189,6324,3766
89,orz901d.map,620,567,13816,24,358,595,208,25729,45,352,574,214,-21,-6,27,30,28
90,orz901d.map,620,567,33733,59,286,560,280,40877,72,513,547,53,-13,227,240,8968,5901
91,orz901d.map,620,567,282218,497,147,122,419,142173,250,143,369,423,247,-4,251,13714,8625
92,orz901d.map,620,567,140450,247,165,372,401,346861,611,142,8,424,-364,-23,387,16712,13870
93,orz901d.map,620,567,92432,163,555,456,11,21856,38,256,581,310,125,-299,424,9436,10457
94,orz901d.map,620,567,312788,551,195,68,371,137694,242,86,377,480,309,-109,418,13707,4806
95,orz901d.map,620,567,38021,67,534,552,32,14254,25,487,594,79,42,-47,89,693,537
96,orz901d.map,620,567,36744,64,110,555,456,35276,62,444,557,122,2,334,336,12304,9399
97,orz901d.map,620,567,112370,198,462,421,104,24651,43,296,576,270,155,-166,321,9571,13941
98,orz901d.map,620,567,314504,554,180,65,386,225061,396,37,223,529,158,-143,301,11856,1596
99,orz901d.map,620,567,241952,426,156,193,410,133344,235,467,384,99,191,311,502,40862,27526
0,orz999d.map,693,630,403667,640,162,52,467,332294,527,345,165,284,113,183,296,5369,857
1,orz999d.map,693,630,169913,269,186,423,443,210727,334,322,358,307,-65,136,201,20419,10346
2,orz999d.map,693,630,405826,644,523,48,106,217502,345,477,347,152,299,-46,345,10762,6147
3,orz999d.map,693,630,246794,391,165,301,464,354260,562,429,130,200,-171,264,435,540,951
4,orz999d.map,693,630,223492,354,157,338,472,415693,659,106,33,523,-305,-51,356,1607,1366
5,orz999d.map,693,630,262546,416,163,276,466,409350,649,149,43,480,-233,-14,247,1189,248
6,orz999d.map,693,630,208077,330,452,362,177,256255,406,154,286,475,-76,-298,374,6150,15081
7,orz999d.map,693,630,269952,428,317,264,312,411891,653,128,39,501,-225,-189,414,903,4872
8,orz999d.map,693,630,238573,378,196,314,433,72903,115,176,577,453,263,-20,283,297,745
9,orz999d.map,693,630,406372,645,607,47,22,273727,434,322,258,307,211,-285,496,7859,7810
10,orz999d.map,693,630,172448,273,171,419,458,82363,130,166,562,463,143,-5,148,149,149
11,orz999d.map,693,630,342526,543,193,149,436,388111,616,598,76,31,-73,405,478,3853,6415
12,orz999d.map,693,630,319829,507,210,185,419,306502,486,307,206,322,21,97,118,1221,418
13,orz999d.map,693,630,244128,387,311,305,318,186318,295,161,397,468,92,-150,242,4927,16048
14,orz999d.map,693,630,409434,649,65,43,564,117069,185,110,507,519,464,45,509,6777,3025
15,orz999d.map,693,630,336849,534,200,158,429,358275,568,194,124,435,-34,-6,40,41,41
16,orz999d.map,693,630,107562,170,167,522,462,311627,494,222,198,407,-324,55,379,5304,390
17,orz999d.map,693,630,391306,621,553,71,76,329958,523,161,169,468,98,-392,490,7296,5924
18,orz999d.map,693,630,237186,376,323,316,306,108182,171,177,521,452,205,-146,351,10490,18779
19,orz999d.map,693,630,201841,320,388,372,241,225373,357,166,335,463,-37,-222,259,6187,16376
20,orz999d.map,693,630,89289,141,170,551,459,251821,399,178,293,451,-258,8,266,1515,267
21,orz999d.map,693,630,320491,508,178,184,451,320375,508,294,184,335,0,116,116,1191,206
22,orz999d.map,693,630,383785,609,514,83,115,249932,396,177,296,452,213,-337,550,1143,10190
23,orz999d.map,693,630,385011,611,548,81,81,313581,497,158,195,471,114,-390,504,1113,604
24,orz999d.map,693,630,290872,461,187,231,442,292149,463,170,229,459,-2,-17,19,20,20
25,orz999d.map,693,630,297821,472,168,220,461,140949,223,170,469,459,249,2,251,252,252
26,orz999d.map,693,630,177497,281,162,411,467,200748,318,221,374,408,-37,59,96,97,97
27,orz999d.map,693,630,200153,317,186,375,443,307887,488,182,204,447,-171,-4,175,229,892
28,orz999d.map,693,630,384375,610,554,82,75,314175,498,194,194,435,112,-360,472,1086,7428
29,orz999d.map,693,630,370251,587,188,105,441,198204,314,245,378,384,273,57,330,5171,3778
30,orz999d.map,693,630,334374,530,155,162,474,261911,415,168,277,461,115,13,128,129,129
31,orz999d.map,693,630,201858,320,371,372,258,153559,243,160,449,469,77,-211,288,6317,18734
32,orz999d.map,693,630,266800,423,319,269,310,238568,378,201,314,428,45,-118,163,7733,12249
33,orz999d.map,693,630,364593,578,176,114,453,244750,388,319,304,310,190,143,333,2237,489
34,orz999d.map,693,630,415699,659,100,33,529,379726,602,163,90,466,57,63,120,204,132
35,orz999d.map,693,630,402585,639,614,53,15,322403,511,156,181,473,128,-458,586,1188,690
36,orz999d.map,693,630,14952,23,167,669,462,406851,645,128,47,501,-622,-39,661,3186,685
37,orz999d.map,693,630,205652,326,357,366,272,378447,600,182,92,447,-274,-175,449,875,2353
38,orz999d.map,693,630,307880,488,189,204,440,329207,522,282,170,347,-34,93,127,128,128
39,orz999d.map,693,630,82357,130,172,562,457,369014,585,165,107,464,-455,-7,462,463,463
40,orz999d.map,693,630,366852,582,437,110,192,303983,482,306,210,323,100,-131,231,3342,462
41,orz999d.map,693,630,3624,5,155,687,474,413132,655,147,37,482,-650,-8,658,3592,4263
42,orz999d.map,693,630,220957,350,172,342,457,297671,472,318,220,311,-122,146,268,11292,3051
43,orz999d.map,693,630,278293,441,166,251,463,196389,311,170,381,459,130,4,134,135,135
44,orz999d.map,693,630,385096,611,463,81,166,412499,654,150,38,479,-43,-313,356,6387,7922
45,orz999d.map,693,630,208313,330,216,362,413,14957,23,162,669,467,307,-54,361,362,786
46,orz999d.map,693,630,203298,322,191,370,438,168654,267,185,425,444,55,-6,61,178,177
47,orz999d.map,693,630,225363,357,176,335,453,128358,203,161,489,468,154,-15,169,170,784
48,orz999d.map,693,630,395081,627,558,65,71,323020,512,169,180,460,115,-389,504,1020,604
49,orz999d.map,693,630,387545,615,534,77,95,265684,421,175,271,454,194,-359,553,1187,653
50,orz999d.map,693,630,216875,344,474,348,155,334948,531,211,161,418,-187,-263,450,841,6654
51,orz999d.map,693,630,357024,566,185,126,444,262530,416,179,276,450,150,-6,156,553,1009
52,orz999d.map,693,630,205616,326,393,366,236,144092,228,177,464,452,98,-216,314,11238,18759
53,orz999d.map,693,630,234201,371,158,321,471,328507,521,352,171,277,-150,194,344,756,662
54,orz999d.map,693,630,221574,351,185,341,444,157318,249,181,443,448,102,-4,106,215,669
55,orz999d.map,693,630,347971,552,418,140,211,309741,491,218,201,411,61,-200,261,767,264
56,orz999d.map,693,630,211456,335,223,357,406,394832,626,177,66,452,-291,-46,337,4260,5514
57,orz999d.map,693,630,387627,615,452,77,177,203660,323,459,369,170,292,7,299,8075,6070
58,orz999d.map,693,630,383751,609,548,83,81,335615,532,174,160,455,77,-374,451,4501,7904
59,orz999d.map,693,630,273108,433,311,259,318,213374,338,195,354,434,95,-116,211,7592,13281
60,orz999d.map,693,630,268847,426,162,266,467,209975,333,444,359,185,93,282,375,14578,6122
61,orz999d.map,693,630,403681,640,148,52,481,298459,473,160,219,469,167,12,179,181,953
62,orz999d.map,693,630,186928,296,181,396,448,328615,521,244,171,385,-225,63,288,4376,4382
63,orz999d.map,693,630,233520,370,209,322,420,225685,358,484,334,145,12,275,287,21671,10609
64,orz999d.map,693,630,310393,492,196,200,433,390028,619,571,73,58,-127,375,502,602,1177
65,orz999d.map,693,630,324843,515,236,177,393,378191,600,438,92,191,-85,202,287,385,436
66,orz999d.map,693,630,345440,548,429,144,200,217742,345,237,347,392,203,-192,395,11137,3461
67,orz999d.map,693,630,204395,324,354,368,275,57789,91,170,601,459,233,-184,417,6459,19691
68,orz999d.map,693,630,211306,335,373,357,256,217819,345,160,347,469,-10,-213,223,6214,16225
69,orz999d.map,693,630,207537,329,362,363,267,197636,313,183,379,446,16,-179,195,10106,16745
70,orz999d.map,693,630,213965,339,234,353,395,364350,578,419,114,210,-239,185,424,10981,11438
71,orz999d.map,693,630,320425,508,244,184,385,349435,554,214,138,415,-46,-30,76,77,77
72,orz999d.map,693,630,118956,188,113,504,516,340398,540,431,152,198,-352,318,670,6486,1319
73,orz999d.map,693,630,142840,226,169,466,460,360195,571,164,121,465,-345,-5,350,351,351
74,orz999d.map,693,630,363080,576,429,116,200,209978,333,441,359,188,243,12,255,5824,5906
75,orz999d.map,693,630,299049,474,200,218,429,169927,269,172,423,457,205,-28,233,1707,2660
76,orz999d.map,693,630,200798,318,171,374,458,200783,318,186,374,443,0,15,15,16,16
77,orz999d.map,693,630,392584,623,535,69,94,210092,333,327,359,302,290,-208,498,8018,6158
78,orz999d.map,693,630,176873,280,156,412,473,219686,348,183,344,446,-68,27,95,612,96
79,orz999d.map,693,630,237941,377,198,315,431,396253,628,16,64,613,-251,-182,433,10030,1135
80,orz999d.map,693,630,202681,321,178,371,451,331631,526,378,166,251,-205,200,405,3573,7410
81,orz999d.map,693,630,89298,141,161,551,468,187583,297,156,395,473,-156,-5,161,359,661
82,orz999d.map,693,630,388856,617,483,75,146,343154,544,195,148,434,73,-288,361,4294,3626
83,orz999d.map,693,630,119584,189,115,503,514,251203,398,166,294,463,-209,51,260,261,317
84,orz999d.map,693,630,390156,619,443,73,186,336862,534,187,158,442,85,-256,341,3398,3536
85,orz999d.map,693,630,12441,19,158,673,471,47075,74,174,618,455,-55,16,71,72,77
86,orz999d.map,693,630,405724,644,625,48,4,327870,520,359,172,270,124,-266,390,643,492
87,orz999d.map,693,630,93062,147,177,545,452,203791,323,328,369,301,-176,151,327,19649,11221
88,orz999d.map,693,630,205157,325,222,367,407,331215,525,164,167,465,-200,-58,258,259,363
89,orz999d.map,693,630,322792,512,397,180,232,23763,37,176,655,453,475,-221,696,6365,13616
90,orz999d.map,693,630,331163,525,216,167,413,204503,324,246,368,383,201,30,231,4517,3952
91,orz999d.map,693,630,206904,328,365,364,264,235425,373,194,319,435,-45,-171,216,9575,15036
92,orz999d.map,693,630,149145,236,164,456,465,163626,259,173,433,456,-23,9,32,33,33
93,orz999d.map,693,630,14325,22,164,670,465,77319,122,170,570,459,-100,6,106,107,107
94,orz999d.map,693,630,303474,481,185,211,444,190668,302,221,390,408,179,36,215,689,2825
95,orz999d.map,693,630,273248,433,171,259,458,211921,336,388,356,241,97,217,314,14010,5229
96,orz999d.map,693,630,311002,493,217,199,412,219069,347,170,345,459,146,-47,193,198,1176
97,orz999d.map,693,630,135272,214,177,478,452,204998,325,381,367,248,-111,204,315,19030,11252
98,orz999d.map,693,630,394458,626,551,66,78,412591,654,58,38,571,-28,-493,521,8228,9401
99,orz999d.map,693,630,306008,485,171,207,458,235294,373,325,319,304,112,154,266,8426,2227
0,ost000a.map,955,433,235756,544,228,410,204,188141,434,213,520,219,110,-15,125,126,207
1,ost000a.map,955,433,122808,283,163,671,269,133118,307,245,647,187,-24,82,106,143,153
2,ost000a.map,955,433,314513,726,277,228,155,302803,699,296,255,136,27,19,46,334,181
3,ost000a.map,955,433,66584,153,97,801,335,257507,594,127,360,305,-441,30,471,46062,21155
4,ost000a.map,955,433,284577,657,336,297,96,406918,939,101,15,331,-282,-235,517,5886,24298
5,ost000a.map,955,433,321534,742,184,212,248,325111,750,71,204,361,-8,-113,121,9382,6620
6,ost000a.map,955,433,167256,386,314,568,118,144818,334,236,620,196,52,-78,130,8332,9973
7,ost000a.map,955,433,278288,642,130,312,302,377838,872,170,82,262,-230,40,270,4167,8436
8,ost000a.map,955,433,208728,482,410,472,22,131730,304,334,650,98,178,-76,254,8012,5830
9,ost000a.map,955,433,270132,623,59,331,373,49732,114,62,840,370,509,3,512,25979,40025
10,ost000a.map,955,433,296957,685,80,269,352,95734,221,391,733,41,464,311,775,16834,22283
11,ost000a.map,955,433,57883,133,138,821,294,133645,308,151,646,281,-175,13,188,1167,191
12,ost000a.map,955,433,144300,333,321,621,111,274903,634,51,320,381,-301,-270,571,34597,27650
13,ost000a.map,955,433,203547,470,395,484,37,116212,268,264,686,168,202,-131,333,14965,15113
14,ost000a.map,955,433,52285,120,107,834,325,336711,777,162,177,270,-657,55,712,27907,27129
15,ost000a.map,955,433,175812,406,418,548,14,93341,215,186,739,246,191,-232,423,50535,20447
16,ost000a.map,955,433,370906,856,174,98,258,330259,762,119,192,313,94,-55,149,261,407
17,ost000a.map,955,433,257452,594,182,360,250,259301,598,65,356,367,-4,-117,121,3052,9668
18,ost000a.map,955,433,120208,277,165,677,267,300895,694,39,260,393,-417,-126,543,14858,20687
19,ost000a.map,955,433,137451,317,242,637,190,139303,321,122,633,310,-4,-120,124,2334,3153
20,ost000a.map,955,433,301256,695,111,259,321,221887,512,241,442,191,183,130,313,77831,30671
21,ost000a.map,955,433,163450,377,223,577,209,245131,566,379,388,53,-189,156,345,20347,8760
22,ost000a.map,955,433,64440,148,76,806,356,331929,766,181,188,251,-618,105,723,37269,29287
23,ost000a.map,955,433,300210,693,291,261,141,53107,122,151,832,281,571,-140,711,27027,14504
24,ost000a.map,955,433,159979,369,230,585,202,302012,697,221,257,211,-328,-9,337,5593,5874
25,ost000a.map,955,433,280513,647,70,307,362,211329,488,407,466,25,159,337,496,63412,39080
26,ost000a.map,955,433,98610,227,113,727,319,315428,728,228,226,204,-501,115,616,16700,18545
27,ost000a.map,955,433,191562,442,256,512,176,113268,261,177,693,255,181,-79,260,13585,30019
28,ost000a.map,955,433,117712,271,63,683,369,91874,212,354,742,78,59,291,350,7093,8810
29,ost000a.map,955,433,92442,213,219,741,213,239214,552,234,402,198,-339,15,354,3629,3399
30,ost000a.map,955,433,113186,261,259,693,173,266829,616,331,338,101,-355,72,427,30700,12073
31,ost000a.map,955,433,93585,216,375,738,57,220554,509,275,445,157,-293,-100,393,11270,10150
32,ost000a.map,955,433,356653,823,138,131,294,151134,349,415,605,17,474,277,751,51670,32532
33,ost000a.map,955,433,108035,249,214,705,218,145573,336,347,618,85,-87,133,220,418,1278
34,ost000a.map,955,433,324929,750,253,204,179,35281,81,224,873,208,669,-29,698,7550,9299
35,ost000a.map,955,433,113168,261,277,693,155,62621,144,163,810,269,117,-114,231,14153,6996
36,ost000a.map,955,433,170610,394,424,560,8,113103,261,342,693,90,133,-82,215,3280,8002
37,ost000a.map,955,433,208378,481,327,473,105,118334,273,307,681,125,208,-20,228,9807,11627
38,ost000a.map,955,433,336280,776,160,178,272,330074,762,304,192,128,14,144,158,787,160
39,ost000a.map,955,433,260136,600,96,354,336,54946,126,44,828,388,474,-52,526,23178,41667
40,ost000a.map,955,433,145696,336,224,618,208,282561,652,187,302,245,-316,-37,353,2325,2838
41,ost000a.map,955,433,49744,114,50,840,382,78243,180,129,774,303,-66,79,145,253,873
42,ost000a.map,955,433,105789,244,295,710,137,78423,181,382,773,50,63,87,150,189,157
43,ost000a.map,955,433,397400,917,93,37,339,126335,291,100,663,332,626,7,633,38727,20397
44,ost000a.map,955,433,131478,303,153,651,279,361806,835,181,119,251,-532,28,560,32520,32398
45,ost000a.map,955,433,186337,430,285,524,147,360555,832,133,122,299,-402,-152,554,32141,71362
46,ost000a.map,955,433,287734,664,210,290,222,211039,487,264,467,168,177,54,231,71750,36458
47,ost000a.map,955,433,334168,771,107,183,325,151640,350,342,604,90,421,235,656,41111,22746
48,ost000a.map,955,433,69665,160,47,794,385,258394,596,106,358,326,-436,59,495,42560,23213
49,ost000a.map,955,433,306728,708,268,246,164,408645,943,106,11,326,-235,-162,397,9566,3191
50,ost000a.map,955,433,119617,276,323,678,109,221846,512,282,442,150,-236,-41,277,12474,10285
51,ost000a.map,955,433,148522,343,429,611,3,269670,622,88,332,344,-279,-341,620,59483,64213
52,ost000a.map,955,433,186411,430,211,524,221,207075,478,331,476,101,-48,120,168,24572,25315
53,ost000a.map,955,433,79309,183,362,771,70,143757,332,431,622,1,-149,69,218,16969,4910
54,ost000a.map,955,433,128884,297,149,657,283,106798,246,152,708,280,51,3,54,2704,756
55,ost000a.map,955,433,206249,476,291,478,141,202310,467,333,487,99,9,42,51,267,144
56,ost000a.map,955,433,177193,409,336,545,96,131035,302,163,652,269,107,-173,280,8794,11815
57,ost000a.map,955,433,168506,389,363,565,69,123979,286,291,668,141,103,-72,175,948,384
58,ost000a.map,955,433,199755,461,290,493,142,179035,413,226,541,206,48,-64,112,23959,19218
59,ost000a.map,955,433,302176,697,57,257,375,386099,891,136,63,296,-194,79,273,9917,14131
60,ost000a.map,955,433,312912,722,146,232,286,263089,607,174,347,258,115,28,143,2688,1466
61,ost000a.map,955,433,146112,337,241,617,191,85050,196,250,758,182,141,9,150,2533,1030
62,ost000a.map,955,433,323792,747,91,207,341,323262,746,188,208,244,1,97,98,6139,9669
63,ost000a.map,955,433,90533,209,396,745,36,97719,225,138,729,294,-16,-258,274,13230,8846
64,ost000a.map,955,433,379995,877,178,77,254,120975,279,264,675,168,598,86,684,19061,29796
65,ost000a.map,955,433,132563,306,367,648,65,297140,686,330,268,102,-380,-37,417,37490,16008
66,ost000a.map,955,433,153920,355,227,599,205,113139,261,306,693,126,94,79,173,6492,403
67,ost000a.map,955,433,113646,262,232,692,200,117262,270,80,684,352,-8,-152,160,1983,3037
68,ost000a.map,955,433,102499,236,121,718,311,192261,444,423,510,9,-208,302,510,19890,19085
69,ost000a.map,955,433,271688,627,235,327,197,272148,628,208,326,224,-1,-27,28,43,88
70,ost000a.map,955,433,287448,663,63,291,369,89953,207,110,747,322,456,47,503,24460,23883
71,ost000a.map,955,433,284758,657,155,297,277,135006,311,89,643,343,346,-66,412,26934,13813
72,ost000a.map,955,433,299496,691,139,263,293,190677,440,275,514,157,251,136,387,70505,30217
73,ost000a.map,955,433,60110,138,76,816,356,339222,783,249,171,183,-645,173,818,14661,22405
74,ost000a.map,955,433,207441,479,398,475,34,393873,909,156,45,276,-430,-242,672,39790,70371
75,ost000a.map,955,433,187260,432,228,522,204,340629,786,141,168,291,-354,-87,441,3392,9608
76,ost000a.map,955,433,184188,425,269,529,163,265773,613,88,341,344,-188,-181,369,61837,68617
77,ost000a.map,955,433,180739,417,254,537,178,264486,610,76,344,356,-193,-178,371,57598,70888
78,ost000a.map,955,433,96665,223,326,731,106,287298,663,213,291,219,-440,-113,553,21126,13128
79,ost000a.map,955,433,76490,176,150,778,282,186652,431,403,523,29,-255,253,508,24883,33296
80,ost000a.map,955,433,303724,701,241,253,191,5396,12,232,942,200,689,-9,698,6941,12620
81,ost000a.map,955,433,131379,303,252,651,180,330700,763,111,191,321,-460,-141,601,7031,12529
82,ost000a.map,955,433,256533,592,235,362,197,256975,593,226,361,206,-1,-9,10,11,11
83,ost000a.map,955,433,52686,121,139,833,293,137806,318,320,636,112,-197,181,378,3070,12770
84,ost000a.map,955,433,396912,916,148,38,284,318511,735,176,219,256,181,28,209,248,210
85,ost000a.map,955,433,186208,430,414,524,18,100104,231,351,723,81,199,-63,262,5984,7357
86,ost000a.map,955,433,270988,625,69,329,363,288221,665,156,289,276,-40,87,127,354,966
87,ost000a.map,955,433,133100,307,263,647,169,107060,247,323,707,109,60,60,120,799,446
88,ost000a.map,955,433,136069,314,325,640,107,134350,310,312,644,120,4,-13,17,18,18
89,ost000a.map,955,433,173321,400,311,554,121,153293,354,421,600,11,46,110,156,3409,1705
90,ost000a.map,955,433,138690,320,302,634,130,282531,652,217,302,215,-332,-85,417,14563,12729
91,ost000a.map,955,433,113137,261,308,693,124,279956,646,194,308,238,-385,-114,499,11404,15413
92,ost000a.map,955,433,191930,443,321,511,111,362711,837,142,117,290,-394,-179,573,31494,70388
93,ost000a.map,955,433,214097,494,237,460,195,151559,350,423,604,9,144,186,330,9510,28570
94,ost000a.map,955,433,106845,246,105,708,327,96437,222,121,732,311,24,16,40,294,1861
95,ost000a.map,955,433,324464,749,285,205,147,76162,175,45,779,387,574,-240,814,35128,14388
96,ost000a.map,955,433,202395,467,248,487,184,141159,326,431,628,1,141,183,324,5719,567
97,ost000a.map,955,433,315964,729,125,225,307,332341,767,202,187,230,-38,77,115,155,246
98,ost000a.map,955,433,322456,744,128,210,304,306321,707,242,247,190,37,114,151,3806,3990
99,ost000a.map,955,433,307704,710,158,244,274,336615,777,258,177,174,-67,100,167,246,2174
0,ost000t.map,957,395,305704,773,25,183,369,162006,410,338,546,56,363,313,676,65905,31469
1,ost000t.map,957,395,167995,425,274,531,120,107571,272,263,684,131,153,-11,164,5705,10596
2,ost000t.map,957,395,237193,600,201,356,193,282302,714,122,242,272,-114,-79,193,874,5423
3,ost000t.map,957,395,286745,725,24,231,370,269562,682,222,274,172,43,198,241,3097,8202
4,ost000t.map,957,395,262864,665,205,291,189,168358,426,306,530,88,239,101,340,56375,35048
5,ost000t.map,957,395,229552,581,337,375,57,116193,294,331,662,63,287,-6,293,14076,57252
6,ost000t.map,957,395,350312,886,52,70,342,216562,548,292,408,102,338,240,578,5057,4937
7,ost000t.map,957,395,255763,647,196,309,198,111957,283,222,673,172,364,26,390,4870,9037
8,ost000t.map,957,395,116736,295,183,661,211,354650,897,59,59,335,-602,-124,726,8183,14039
9,ost000t.map,957,395,138352,350,292,606,102,223254,565,315,391,79,-215,23,238,53604,22598
10,ost000t.map,957,395,152985,387,274,569,120,262949,665,120,291,274,-278,-154,432,25200,51016
11,ost000t.map,957,395,96968,245,201,711,193,122941,311,298,645,96,-66,97,163,164,164
12,ost000t.map,957,395,331288,838,116,118,278,288217,729,132,227,262,109,16,125,461,1304
13,ost000t.map,957,395,294072,744,202,212,192,174269,441,320,515,74,303,118,421,62533,36084
14,ost000t.map,957,395,234433,593,196,363,198,198108,501,181,455,213,92,-15,107,5204,819
15,ost000t.map,957,395,194012,491,327,465,67,166868,422,216,534,178,69,-111,180,2353,329
16,ost000t.map,957,395,254052,643,327,313,67,190454,482,330,474,64,161,3,164,68194,40747
17,ost000t.map,957,395,125344,317,265,639,129,85402,216,312,740,82,101,47,148,201,909
18,ost000t.map,957,395,82992,210,352,746,42,115874,293,255,663,139,-83,-97,180,4948,262
19,ost000t.map,957,395,300861,761,128,195,266,260565,659,134,297,260,102,6,108,707,743
20,ost000t.map,957,395,42077,106,187,850,207,124991,316,223,640,171,-210,36,246,1343,250
21,ost000t.map,957,395,268405,679,194,277,200,255343,646,221,310,173,33,27,60,61,61
22,ost000t.map,957,395,165218,418,286,538,108,353469,894,55,62,339,-476,-231,707,32925,68343
23,ost000t.map,957,395,283421,717,188,239,206,143453,363,326,593,68,354,138,492,32382,29186
24,ost000t.map,957,395,133945,339,354,617,40,351485,889,64,67,330,-550,-290,840,23596,45217
25,ost000t.map,957,395,262210,663,69,293,325,307542,778,162,178,232,-115,93,208,1611,218
26,ost000t.map,957,395,135904,344,370,612,24,258135,653,194,303,200,-309,-176,485,36191,23780
27,ost000t.map,957,395,168289,426,375,530,19,98950,250,194,706,200,176,-181,357,4545,18532
28,ost000t.map,957,395,264915,670,129,286,265,290967,736,147,220,247,-66,18,84,980,538
29,ost000t.map,957,395,179114,453,215,503,179,246580,624,294,332,100,-171,79,250,44380,61716
30,ost000t.map,957,395,154585,391,254,565,140,55908,141,181,815,213,250,-73,323,5603,21523
31,ost000t.map,957,395,53138,134,186,822,208,280789,710,55,246,339,-576,-131,707,13954,4167
32,ost000t.map,957,395,46419,117,190,839,204,156459,396,355,560,39,-279,165,444,25384,6426
33,ost000t.map,957,395,330096,835,123,121,271,265297,671,142,285,252,164,19,183,580,2912
34,ost000t.map,957,395,186908,473,321,483,73,264110,668,144,288,250,-195,-177,372,29048,65697
35,ost000t.map,957,395,106008,268,246,688,148,232724,589,325,367,69,-321,79,400,61407,12800
36,ost000t.map,957,395,201625,510,219,446,175,342358,866,106,90,288,-356,-113,469,29005,72438
37,ost000t.map,957,395,257792,652,142,304,252,323786,819,113,137,281,-167,-29,196,2166,207
38,ost000t.map,957,395,243674,616,40,340,354,273698,692,36,264,358,-76,-4,80,382,584
39,ost000t.map,957,395,136294,345,375,611,19,262983,665,86,291,308,-320,-289,609,29855,28856
40,ost000t.map,957,395,236136,597,73,359,321,115151,291,188,665,206,306,115,421,2333,17863
41,ost000t.map,957,395,239541,606,223,350,171,344742,872,92,84,302,-266,-131,397,2680,1099
42,ost000t.map,957,395,124948,316,266,640,128,228006,577,303,379,91,-261,37,298,49292,17395
43,ost000t.map,957,395,235930,597,279,359,115,34971,88,183,868,211,509,-96,605,2609,29346
44,ost000t.map,957,395,347082,878,122,78,272,314174,795,245,161,149,83,123,206,3320,3331
45,ost000t.map,957,395,259472,656,42,300,352,165690,419,209,537,185,237,167,404,67706,35257
46,ost000t.map,957,395,167528,424,346,532,48,136395,345,274,611,120,79,-72,151,9302,7338
47,ost000t.map,957,395,153338,388,316,568,78,189310,479,289,477,105,-91,-27,118,1810,6210
48,ost000t.map,957,395,346289,876,125,80,269,205882,521,307,435,87,355,182,537,6675,20129
49,ost000t.map,957,395,130952,331,187,625,207,177570,449,179,507,215,-118,-8,126,377,132
50,ost000t.map,957,395,272314,689,235,267,159,301972,764,202,192,192,-75,-33,108,518,204
51,ost000t.map,957,395,269480,682,304,274,90,136751,346,313,610,81,336,9,345,22543,38275
52,ost000t.map,957,395,277632,702,52,254,342,139237,352,197,604,197,350,145,495,1006,8774
53,ost000t.map,957,395,75491,191,348,765,46,274111,693,18,263,376,-502,-330,832,5474,4274
54,ost000t.map,957,395,262640,664,34,292,360,294805,746,259,210,135,-82,225,307,2430,6992
55,ost000t.map,957,395,279849,708,205,248,189,195994,496,320,460,74,212,115,327,66233,35293
56,ost000t.map,957,395,275929,698,175,258,219,177765,450,379,506,15,248,204,452,53124,37000
57,ost000t.map,957,395,141865,359,334,597,60,375581,950,63,6,331,-591,-271,862,25070,49955
58,ost000t.map,957,395,121777,308,277,648,117,190588,482,196,474,198,-174,-81,255,2678,939
59,ost000t.map,957,395,96546,244,228,712,166,328526,831,113,125,281,-587,-115,702,13247,863
60,ost000t.map,957,395,162106,410,238,546,156,187779,475,240,481,154,-65,2,67,68,68
61,ost000t.map,957,395,343537,869,112,87,282,178340,451,199,505,195,418,87,505,519,2384
62,ost000t.map,957,395,155363,393,266,563,128,90628,229,221,727,173,164,-45,209,4752,16473
63,ost000t.map,957,395,146241,370,303,586,91,178655,452,279,504,115,-82,-24,106,1873,4876
64,ost000t.map,957,395,279560,707,99,249,295,137271,347,188,609,206,360,89,449,664,3128
65,ost000t.map,957,395,293081,741,8,215,386,248234,628,220,328,174,113,212,325,1846,394
66,ost000t.map,957,395,315772,799,227,157,167,126172,319,227,637,167,480,0,480,14705,5035
67,ost000t.map,957,395,162441,411,298,545,96,128571,325,198,631,196,86,-100,186,5651,7367
68,ost000t.map,957,395,96155,243,224,713,170,167639,424,235,532,159,-181,11,192,20487,8146
69,ost000t.map,957,395,305224,772,110,184,284,126995,321,194,635,200,451,84,535,549,3624
70,ost000t.map,957,395,276696,700,198,256,196,80266,203,313,753,81,497,115,612,15747,30966
71,ost000t.map,957,395,177838,450,306,506,88,73910,187,349,769,45,263,43,306,14862,13361
72,ost000t.map,957,395,310372,785,97,171,297,280815,710,29,246,365,75,-68,143,8259,9115
73,ost000t.map,957,395,251603,636,11,320,383,297404,752,30,204,364,-116,19,135,2165,2546
74,ost000t.map,957,395,177851,450,293,506,101,162940,412,194,544,200,38,-99,137,26331,18876
75,ost000t.map,957,395,70756,179,343,777,51,95326,241,263,715,131,-62,-80,142,148,179
76,ost000t.map,957,395,289392,732,142,224,252,204015,516,199,440,195,216,57,273,73360,41294
77,ost000t.map,957,395,305568,773,161,183,233,311075,787,184,169,210,-14,23,37,40,80
78,ost000t.map,957,395,254508,644,266,312,128,267693,677,116,279,278,-33,-150,183,192,728
79,ost000t.map,957,395,187782,475,237,481,157,177502,449,247,507,147,26,10,36,37,37
80,ost000t.map,957,395,347857,880,137,76,257,211525,535,194,421,200,345,57,402,1880,15903
81,ost000t.map,957,395,256075,648,279,308,115,286150,724,224,232,170,-76,-55,131,132,132
82,ost000t.map,957,395,307449,778,255,178,139,188447,477,362,479,32,301,107,408,61510,37700
83,ost000t.map,957,395,240722,609,227,347,167,146635,371,304,585,90,238,77,315,21310,27930
84,ost000t.map,957,395,350260,886,104,70,290,334062,845,107,111,287,41,3,44,45,45
85,ost000t.map,957,395,98938,250,206,706,188,259413,656,101,300,293,-406,-105,511,8979,773
86,ost000t.map,957,395,268136,678,68,278,326,172299,436,315,520,79,242,247,489,66103,34941
87,ost000t.map,957,395,251599,636,15,320,379,298007,754,217,202,177,-118,202,320,456,2547
88,ost000t.map,957,395,311412,788,242,168,152,147751,374,373,582,21,414,131,545,43790,36467
89,ost000t.map,957,395,285568,722,16,234,378,212972,539,327,417,67,183,311,494,7319,714
90,ost000t.map,957,395,83817,212,317,744,77,147387,373,342,583,52,-161,25,186,2482,2186
91,ost000t.map,957,395,236382,598,222,358,172,254126,643,253,313,141,-45,31,76,292,109
92,ost000t.map,957,395,248147,628,307,328,87,122278,309,171,647,223,319,-136,455,13752,14891
93,ost000t.map,957,395,185470,469,179,487,215,263255,666,209,290,185,-197,30,227,2068,3541
94,ost000t.map,957,395,244755,619,144,337,250,372030,941,59,15,335,-322,-85,407,4659,11469
95,ost000t.map,957,395,159242,403,337,553,57,301615,763,164,193,230,-360,-173,533,50370,66150
96,ost000t.map,957,395,242492,613,37,343,357,195550,495,369,461,25,118,332,450,62718,48993
97,ost000t.map,957,395,182172,461,317,495,77,113061,286,303,670,91,175,-14,189,8812,9986
98,ost000t.map,957,395,326986,827,73,129,321,335631,849,118,107,276,-22,45,67,69,235
99,ost000t.map,957,395,156914,397,295,559,99,308703,781,186,175,208,-384,-109,493,36783,47647
0,ost001d.map,155,164,4068,24,31,130,132,15966,97,105,57,58,-73,74,147,3509,4317
1,ost001d.map,155,164,13986,85,117,69,46,17035,103,20,51,143,-18,-97,115,3187,1247
2,ost001d.map,155,164,20288,123,47,31,116,9894,60,109,94,54,63,62,125,345,1793
3,ost001d.map,155,164,11408,69,71,85,92,19370,118,145,36,18,-49,74,123,2668,1686
4,ost001d.map,155,164,9048,55,135,99,28,20519,125,144,29,19,-70,9,79,1012,1566
5,ost001d.map,155,164,16536,100,27,54,136,626,3,29,151,134,97,2,99,2039,1398
6,ost001d.map,155,164,14659,89,100,65,63,14757,89,2,65,161,0,-98,98,2616,1350
7,ost001d.map,155,164,13363,81,84,73,79,15798,96,109,58,54,-15,25,40,485,420
8,ost001d.map,155,164,12745,77,46,77,117,9980,60,23,94,140,17,-23,40,41,41
9,ost001d.map,155,164,8976,54,43,100,120,9581,58,94,96,69,-4,51,55,763,1957
10,ost001d.map,155,164,18273,111,94,43,69,20615,125,48,29,115,-14,-46,60,2171,3683
11,ost001d.map,155,164,15816,96,91,58,72,21047,128,108,26,55,-32,17,49,50,52
12,ost001d.map,155,164,21682,132,129,22,34,17979,109,60,45,103,23,-69,92,3853,4150
13,ost001d.map,155,164,17037,103,18,51,145,4542,27,49,127,114,76,31,107,403,693
14,ost001d.map,155,164,14315,87,116,67,47,20943,127,48,27,115,-40,-68,108,1446,413
15,ost001d.map,155,164,15498,94,81,60,82,13595,82,16,72,147,12,-65,77,2099,1258
16,ost001d.map,155,164,14083,85,20,69,143,16845,102,46,52,117,-17,26,43,1267,949
17,ost001d.map,155,164,15179,92,72,62,91,13894,84,45,70,118,8,-27,35,36,36
18,ost001d.map,155,164,17136,104,83,50,80,11019,67,132,87,31,37,49,86,111,748
19,ost001d.map,155,164,21713,132,98,22,65,9626,58,49,96,114,74,-49,123,3031,2912
20,ost001d.map,155,164,8577,52,114,102,49,16222,98,13,56,150,-46,-101,147,4999,2597
21,ost001d.map,155,164,7684,46,23,108,140,16990,103,65,51,98,-57,42,99,170,398
22,ost001d.map,155,164,13606,82,5,72,158,8079,49,120,105,43,33,115,148,2165,4463
23,ost001d.map,155,164,9882,60,121,94,42,11554,70,89,84,74,-10,-32,42,43,43
24,ost001d.map,155,164,14845,90,78,64,85,9093,55,90,99,73,35,12,47,48,53
25,ost001d.map,155,164,10900,66,87,88,76,14533,88,62,66,101,-22,-25,47,48,48
26,ost001d.map,155,164,18381,112,150,42,13,13718,83,57,71,106,29,-93,122,1796,2940
27,ost001d.map,155,164,15928,97,143,57,20,13498,82,113,72,50,15,-30,45,930,1577
28,ost001d.map,155,164,10200,62,131,92,32,13550,82,61,72,102,-20,-70,90,91,101
29,ost001d.map,155,164,6464,39,95,115,68,9722,59,117,95,46,-20,22,42,43,53
30,ost001d.map,155,164,4388,26,39,128,124,15950,97,121,57,42,-71,82,153,774,4811
31,ost001d.map,155,164,20790,126,37,28,126,12358,75,105,79,58,51,68,119,746,836
32,ost001d.map,155,164,18336,111,31,43,132,8253,50,110,104,53,61,79,140,637,3952
33,ost001d.map,155,164,22425,136,42,18,121,15636,95,107,59,56,41,65,106,2478,2068
34,ost001d.map,155,164,14049,85,54,69,109,6373,38,22,116,141,47,-32,79,134,150
35,ost001d.map,155,164,17840,108,35,46,128,19003,115,20,39,143,-7,-15,22,23,23
36,ost001d.map,155,164,15681,95,62,59,101,14854,90,69,64,94,5,7,12,13,13
37,ost001d.map,155,164,13390,81,57,73,106,9246,56,101,98,62,25,44,69,110,120
38,ost001d.map,155,164,17113,104,106,50,57,13789,84,150,70,13,20,44,64,918,576
39,ost001d.map,155,164,20520,125,143,29,20,16215,98,20,56,143,27,-123,150,5385,3810
40,ost001d.map,155,164,15952,97,119,57,44,10540,64,119,90,44,33,0,33,34,34
41,ost001d.map,155,164,13509,82,102,72,61,14030,85,73,69,90,-3,-29,32,33,87
42,ost001d.map,155,164,17948,109,91,45,72,13703,83,72,71,91,26,-19,45,943,1919
43,ost001d.map,155,164,21499,131,148,23,15,13333,81,114,73,49,50,-34,84,1227,564
44,ost001d.map,155,164,19169,116,18,38,145,17574,107,137,47,26,9,119,128,4450,3698
45,ost001d.map,155,164,9984,60,19,94,144,14227,86,40,68,123,-26,21,47,234,54
46,ost001d.map,155,164,16185,98,50,56,113,6339,38,56,116,107,60,6,66,3256,696
47,ost001d.map,155,164,10417,63,78,91,85,21053,128,102,26,61,-65,24,89,2060,1185
48,ost001d.map,155,164,16008,97,63,57,100,8268,50,95,104,68,47,32,79,112,94
49,ost001d.map,155,164,9430,57,81,97,82,19175,116,12,38,151,-59,-69,128,1568,1776
50,ost001d.map,155,164,21044,128,111,26,52,6790,41,97,113,66,87,-14,101,989,1381
51,ost001d.map,155,164,18448,112,83,42,80,19723,120,120,34,43,-8,37,45,46,56
52,ost001d.map,155,164,13209,80,74,74,89,20130,122,41,32,122,-42,-33,75,580,290
53,ost001d.map,155,164,22481,137,150,17,13,22317,136,150,18,13,1,0,1,2,2
54,ost001d.map,155,164,8280,50,83,104,80,9644,58,31,96,132,-8,-52,60,1595,1184
55,ost001d.map,155,164,15434,94,145,60,18,19868,121,139,33,24,-27,-6,33,179,102
56,ost001d.map,155,164,21676,132,135,22,28,12005,73,130,81,33,59,-5,64,1408,1329
57,ost001d.map,155,164,17129,104,90,50,73,9239,56,108,98,55,48,18,66,577,1368
58,ost001d.map,155,164,8114,49,85,105,78,20239,123,96,31,67,-74,11,85,2569,1164
59,ost001d.map,155,164,19490,118,25,36,138,11858,72,113,82,50,46,88,134,984,1125
60,ost001d.map,155,164,8177,49,22,105,141,19662,119,17,35,146,-70,-5,75,208,368
61,ost001d.map,155,164,24394,148,41,6,122,10763,65,60,89,103,83,19,102,691,471
62,ost001d.map,155,164,13236,80,47,74,116,12255,74,44,80,119,6,-3,9,10,10
63,ost001d.map,155,164,286,1,41,153,122,9391,57,120,97,43,-56,79,135,2078,4506
64,ost001d.map,155,164,14594,88,1,66,162,19668,119,11,35,152,-31,10,41,42,42
65,ost001d.map,155,164,10782,65,41,89,122,18399,112,132,42,31,-47,91,138,2510,2546
66,ost001d.map,155,164,5704,34,35,120,128,19694,120,149,34,14,-86,114,200,3429,6343
67,ost001d.map,155,164,12090,73,45,81,118,14900,90,23,64,140,-17,-22,39,1061,817
68,ost001d.map,155,164,12177,74,122,80,41,11277,68,38,86,125,6,-84,90,1888,790
69,ost001d.map,155,164,10602,64,57,90,106,16213,98,22,56,141,-34,-35,69,1851,2450
70,ost001d.map,155,164,12341,75,122,79,41,14621,89,138,65,25,-14,16,30,1968,811
71,ost001d.map,155,164,13241,80,42,74,121,9891,60,112,94,51,20,70,90,452,1443
72,ost001d.map,155,164,12049,73,86,81,77,6462,39,97,115,66,34,11,45,50,46
73,ost001d.map,155,164,22584,137,47,17,116,21042,128,113,26,50,9,66,75,2721,2687
74,ost001d.map,155,164,18340,111,27,43,136,7932,48,103,106,60,63,76,139,829,3075
75,ost001d.map,155,164,18284,111,83,43,80,5198,31,49,123,114,80,-34,114,6335,5911
76,ost001d.map,155,164,7922,48,113,106,50,23462,143,153,11,10,-95,40,135,1339,1557
77,ost001d.map,155,164,8008,48,27,106,136,19173,116,14,38,149,-68,-13,81,84,82
78,ost001d.map,155,164,12174,74,125,80,38,7686,46,21,108,142,28,-104,132,2895,1448
79,ost001d.map,155,164,20210,123,125,31,38,20884,127,107,27,56,-4,-18,22,23,23
80,ost001d.map,155,164,21384,130,99,24,64,15599,95,144,59,19,35,45,80,488,81
81,ost001d.map,155,164,8971,54,48,100,115,11743,71,64,83,99,-17,16,33,414,523
82,ost001d.map,155,164,13860,84,79,70,84,14023,85,80,69,83,-1,1,2,3,3
83,ost001d.map,155,164,15225,92,26,62,137,19398,118,117,36,46,-26,91,117,3716,5806
84,ost001d.map,155,164,21715,132,96,22,67,15556,94,23,60,140,38,-73,111,5105,4814
85,ost001d.map,155,164,1433,8,42,146,121,5870,35,33,119,130,-27,-9,36,38,37
86,ost001d.map,155,164,11908,72,63,82,100,17005,103,50,51,113,-31,-13,44,66,46
87,ost001d.map,155,164,16611,101,116,53,47,14357,87,74,67,89,14,-42,56,332,270
88,ost001d.map,155,164,21050,128,105,26,58,7431,45,112,109,51,83,7,90,603,804
89,ost001d.map,155,164,13632,83,143,71,20,19981,121,26,33,137,-38,-117,155,3344,6768
90,ost001d.map,155,164,13836,84,103,70,60,10381,63,114,91,49,21,11,32,33,33
91,ost001d.map,155,164,22097,134,42,20,121,5878,35,25,119,138,99,-17,116,1453,1338
92,ost001d.map,155,164,22580,137,51,17,112,1591,9,48,145,115,128,-3,131,2794,1796
93,ost001d.map,155,164,18968,115,55,39,108,6134,37,97,117,66,78,42,120,355,2124
94,ost001d.map,155,164,14061,85,42,69,121,18175,110,28,44,135,-25,-14,39,689,1018
95,ost001d.map,155,164,3418,20,25,134,138,23092,140,31,14,132,-120,6,126,1217,1166
96,ost001d.map,155,164,5700,34,39,120,124,20965,127,26,27,137,-93,-13,106,798,1178
97,ost001d.map,155,164,8745,53,110,101,53,21946,133,29,21,134,-80,-81,161,2228,829
98,ost001d.map,155,164,10386,63,109,91,54,3733,22,38,132,125,41,-71,112,4050,2024
99,ost001d.map,155,164,11289,68,26,86,137,10479,63,16,91,147,5,-10,15,16,16
0,ost002d.map,138,175,22341,127,58,10,116,1758,10,166,127,8,117,108,225,440,1126
1,ost002d.map,138,175,24082,137,67,0,107,22507,128,67,9,107,9,0,9,10,10
2,ost002d.map,138,175,17648,100,26,37,148,7093,40,81,97,93,60,55,115,3017,5634
3,ost002d.map,138,175,17360,99,139,38,35,17380,99,119,38,55,0,-20,20,21,21
4,ost002d.map,138,175,7953,45,96,92,78,17988,102,36,35,138,-57,-60,117,5316,2965
5,ost002d.map,138,175,19858,113,91,24,83,17995,102,29,35,145,11,-62,73,255,76
6,ost002d.map,138,175,9388,53,61,84,113,18790,107,109,30,65,-54,48,102,1812,1078
7,ost002d.map,138,175,13697,78,127,59,47,6207,35,92,102,82,43,-35,78,168,272
8,ost002d.map,138,175,16032,91,67,46,107,3250,18,74,119,100,73,7,80,652,3238
9,ost002d.map,138,175,17202,98,122,39,52,4087,23,112,114,62,75,-10,85,1085,401
10,ost002d.map,138,175,5676,32,98,105,76,4108,23,91,114,83,9,-7,16,17,17
11,ost002d.map,138,175,20550,117,99,20,75,7239,41,110,96,64,76,11,87,1194,1615
12,ost002d.map,138,175,7725,44,149,93,25,18751,107,148,30,26,-63,-1,64,1783,156
13,ost002d.map,138,175,20042,114,82,23,92,4143,23,56,114,118,91,-26,117,2753,4396
14,ost002d.map,138,175,17889,102,135,35,39,20423,116,51,21,123,-14,-84,98,100,277
15,ost002d.map,138,175,20626,117,23,20,151,5150,29,99,108,75,88,76,164,2921,5282
16,ost002d.map,138,175,14024,80,150,57,24,12484,71,115,66,59,9,-35,44,133,45
17,ost002d.map,138,175,14730,84,144,53,30,5378,30,46,107,128,54,-98,152,1078,298
18,ost002d.map,138,175,10508,60,166,77,8,3750,21,99,116,75,39,-67,106,2452,2035
19,ost002d.map,138,175,3097,17,52,120,122,8157,46,67,91,107,-29,15,44,45,69
20,ost002d.map,138,175,21641,123,58,14,116,5174,29,75,108,99,94,17,111,2941,4600
21,ost002d.map,138,175,12307,70,117,67,57,5158,29,91,108,83,41,-26,67,72,291
22,ost002d.map,138,175,18084,103,115,34,59,5815,33,134,104,40,70,19,89,90,246
23,ost002d.map,138,175,4392,25,157,112,17,16535,94,89,43,85,-69,-68,137,330,532
24,ost002d.map,138,175,12336,70,88,67,86,18968,108,106,29,68,-38,18,56,884,759
25,ost002d.map,138,175,17110,97,39,40,135,10775,61,74,76,100,36,35,71,3003,5888
26,ost002d.map,138,175,21600,123,99,14,75,13206,75,93,62,81,48,-6,54,1924,1021
27,ost002d.map,138,175,8120,46,104,91,70,18783,107,116,30,58,-61,12,73,779,322
28,ost002d.map,138,175,17721,101,128,36,46,16484,94,140,43,34,7,12,19,20,20
29,ost002d.map,138,175,2826,16,148,121,26,10173,58,151,79,23,-42,3,45,46,46
30,ost002d.map,138,175,6931,39,68,98,106,15260,87,139,50,35,-48,71,119,268,346
31,ost002d.map,138,175,19387,110,37,27,137,22829,130,95,7,79,-20,58,78,79,156
32,ost002d.map,138,175,10338,59,161,78,13,9501,54,123,83,51,5,-38,43,1060,423
33,ost002d.map,138,175,3704,21,145,116,29,16200,92,74,45,100,-71,-71,142,338,580
34,ost002d.map,138,175,3680,21,169,116,5,6551,37,98,100,76,-16,-71,87,2328,2274
35,ost002d.map,138,175,18019,102,5,35,169,14941,85,108,52,66,17,103,120,2515,2120
36,ost002d.map,138,175,19328,110,96,27,78,23171,132,103,5,71,-22,7,29,30,30
37,ost002d.map,138,175,14378,82,146,55,28,14749,84,125,53,49,-2,-21,23,24,24
38,ost002d.map,138,175,20600,117,49,20,125,1255,7,144,130,30,110,95,205,458,1134
39,ost002d.map,138,175,16788,95,11,42,163,13431,76,43,61,131,19,32,51,307,288
40,ost002d.map,138,175,4076,23,123,114,51,14372,82,152,55,22,-59,29,88,89,120
41,ost002d.map,138,175,9628,55,171,82,3,7453,42,71,95,103,13,-100,113,2077,3040
42,ost002d.map,138,175,4611,26,113,111,61,11267,64,107,73,67,-38,-6,44,47,49
43,ost002d.map,138,175,3340,19,159,118,15,20598,117,51,20,123,-98,-108,206,1114,435
44,ost002d.map,138,175,13531,77,118,60,56,21637,123,62,14,112,-46,-56,102,780,1283
45,ost002d.map,138,175,805,4,69,133,105,2574,14,50,123,124,-10,-19,29,254,102
46,ost002d.map,138,175,18065,103,134,34,40,2661,15,138,122,36,88,4,92,1978,768
47,ost002d.map,138,175,7802,44,72,93,102,21085,120,89,17,85,-76,17,93,3451,2101
48,ost002d.map,138,175,12985,74,139,63,35,19039,108,35,29,139,-34,-104,138,2177,632
49,ost002d.map,138,175,21446,122,78,15,96,20054,114,70,23,104,8,-8,16,17,26
50,ost002d.map,138,175,21427,122,97,15,77,1669,9,80,128,94,113,-17,130,1740,3789
51,ost002d.map,138,175,10948,62,76,75,98,17173,98,151,39,23,-36,75,111,165,279
52,ost002d.map,138,175,3338,19,161,118,13,14411,82,113,55,61,-63,-48,111,203,165
53,ost002d.map,138,175,22504,128,70,9,104,12664,72,110,65,64,56,40,96,1621,1203
54,ost002d.map,138,175,4972,28,102,109,72,5502,31,97,106,77,-3,-5,8,9,9
55,ost002d.map,138,175,13508,77,141,60,33,20894,119,105,18,69,-42,-36,78,257,79
56,ost002d.map,138,175,7419,42,105,95,69,12831,73,118,64,56,-31,13,44,199,49
57,ost002d.map,138,175,8597,49,152,88,22,1335,7,64,130,110,42,-88,130,2473,4025
58,ost002d.map,138,175,6714,38,110,99,64,3703,21,146,116,28,17,36,53,1653,2099
59,ost002d.map,138,175,5296,30,128,107,46,3854,22,170,115,4,8,42,50,69,51
60,ost002d.map,138,175,21641,123,58,14,116,13357,76,117,61,57,47,59,106,1431,873
61,ost002d.map,138,175,21074,120,100,17,74,8063,46,161,91,13,74,61,135,368,392
62,ost002d.map,138,175,5498,31,101,106,73,11205,64,169,73,5,-33,68,101,1556,2047
63,ost002d.map,138,175,5313,30,111,107,63,3443,19,56,118,118,11,-55,66,266,541
64,ost002d.map,138,175,18538,105,11,32,163,21246,121,103,16,71,-16,92,108,110,381
65,ost002d.map,138,175,8675,49,74,88,100,12987,74,137,63,37,-25,63,88,1140,188
66,ost002d.map,138,175,20525,117,124,20,50,22311,127,88,10,86,-10,-36,46,47,47
67,ost002d.map,138,175,18873,107,26,30,148,11270,64,104,73,70,43,78,121,2737,3166
68,ost002d.map,138,175,14227,81,122,56,52,7725,44,149,93,25,37,27,64,301,113
69,ost002d.map,138,175,5362,30,62,107,112,19669,112,105,25,69,-82,43,125,3418,1593
70,ost002d.map,138,175,17316,98,8,39,166,21476,122,48,15,126,-24,40,64,66,144
71,ost002d.map,138,175,12269,70,155,67,19,5358,30,66,107,108,40,-89,129,1385,2609
72,ost002d.map,138,175,22680,129,69,8,105,6224,35,75,102,99,94,6,100,2651,4520
73,ost002d.map,138,175,20400,116,74,21,100,16006,91,93,46,81,25,19,44,2184,848
74,ost002d.map,138,175,15129,86,95,51,79,8620,49,129,88,45,37,34,71,240,172
75,ost002d.map,138,175,16851,96,123,41,51,7125,40,49,97,125,56,-74,130,433,258
76,ost002d.map,138,175,18266,104,108,33,66,20383,116,91,21,83,-12,-17,29,30,30
77,ost002d.map,138,175,17345,99,154,38,20,5553,31,46,106,128,68,-108,176,1256,398
78,ost002d.map,138,175,4384,25,165,112,9,20425,116,49,21,125,-91,-116,207,1115,409
79,ost002d.map,138,175,10929,62,95,75,79,20055,114,69,23,105,-52,-26,78,2330,1810
80,ost002d.map,138,175,3929,22,95,115,79,9465,54,159,83,15,-32,64,96,2644,2487
81,ost002d.map,138,175,19485,111,114,26,60,5991,34,133,103,41,77,19,96,97,266
82,ost002d.map,138,175,16202,92,72,45,102,10691,61,158,76,16,31,86,117,407,125
83,ost002d.map,138,175,9657,55,142,82,32,4818,27,81,110,93,28,-61,89,1843,3630
84,ost002d.map,138,175,17483,99,16,38,158,5467,31,132,106,42,68,116,184,1195,3280
85,ost002d.map,138,175,4659,26,65,111,109,3356,19,143,118,31,7,78,85,3619,2056
86,ost002d.map,138,175,2297,13,152,124,22,12510,71,89,66,85,-58,-63,121,223,1184
87,ost002d.map,138,175,8809,50,115,87,59,9197,52,77,85,97,-2,-38,40,41,41
88,ost002d.map,138,175,6916,39,83,98,91,9357,53,92,84,82,-14,9,23,24,24
89,ost002d.map,138,175,6408,36,66,101,108,8774,50,150,87,24,-14,84,98,3721,2077
90,ost002d.map,138,175,14489,82,35,55,139,17994,102,30,35,144,-20,-5,25,26,26
91,ost002d.map,138,175,18657,106,67,31,107,9655,55,144,82,30,51,77,128,1617,2527
92,ost002d.map,138,175,15250,87,149,50,25,20403,116,71,21,103,-29,-78,107,111,184
93,ost002d.map,138,175,19200,109,49,28,125,19324,110,100,27,74,-1,51,52,173,163
94,ost002d.map,138,175,9356,53,93,84,81,4799,27,100,110,74,26,7,33,34,34
95,ost002d.map,138,175,5888,33,61,104,113,14636,83,63,54,111,-50,2,52,3483,650
96,ost002d.map,138,175,6560,37,89,100,85,19166,109,83,28,91,-72,-6,78,3599,1405
97,ost002d.map,138,175,3955,22,69,115,105,20349,116,125,21,49,-94,56,150,440,240
98,ost002d.map,138,175,18414,105,135,32,39,7798,44,76,93,98,61,-59,120,212,258
99,ost002d.map,138,175,4954,28,120,109,54,3955,22,69,115,105,6,-51,57,1296,3857
0,ost003d.map,173,167,22966,137,79,35,87,10991,65,30,107,136,72,-49,121,1408,206
1,ost003d.map,173,167,20745,124,129,48,37,10828,64,26,108,140,60,-103,163,7031,6071
2,ost003d.map,173,167,27960,167,95,5,71,10325,61,28,111,138,106,-67,173,191,304
3,ost003d.map,173,167,28095,168,127,4,39,16263,97,102,75,64,71,-25,96,2127,1350
4,ost003d.map,173,167,7752,46,96,126,70,1634,9,35,163,131,37,-61,98,6998,8214
5,ost003d.map,173,167,17840,106,28,66,138,20608,123,99,49,67,-17,71,88,968,1502
6,ost003d.map,173,167,12597,75,94,97,72,7575,45,106,127,60,30,12,42,157,223
7,ost003d.map,173,167,794,4,40,168,126,9959,59,60,113,106,-55,20,75,8614,6864
8,ost003d.map,173,167,19530,116,8,56,158,11515,68,7,104,159,48,-1,49,1168,1006
9,ost003d.map,173,167,20952,125,89,47,77,13682,81,11,91,155,44,-78,122,332,123
10,ost003d.map,173,167,23073,138,139,34,27,21675,129,34,43,132,9,-105,114,2692,2345
11,ost003d.map,173,167,17435,104,99,68,67,26315,157,70,15,96,-53,-29,82,2916,4488
12,ost003d.map,173,167,13950,83,77,89,89,21071,126,137,46,29,-43,60,103,152,422
13,ost003d.map,173,167,22731,136,147,36,19,9756,58,96,114,70,78,-51,129,1613,270
14,ost003d.map,173,167,28129,168,93,4,73,28618,171,105,1,61,-3,12,15,16,16
15,ost003d.map,173,167,13595,81,98,91,68,787,4,47,168,119,77,-51,128,6505,8219
16,ost003d.map,173,167,14174,84,20,88,146,287,1,46,171,120,83,26,109,701,1721
17,ost003d.map,173,167,21296,127,79,45,87,18691,111,12,61,154,16,-67,83,1646,555
18,ost003d.map,173,167,27330,163,57,9,109,6749,40,97,132,69,123,40,163,6038,4442
19,ost003d.map,173,167,28272,169,117,3,49,13735,82,125,90,41,87,8,95,1948,1343
20,ost003d.map,173,167,27595,165,126,7,40,12429,74,95,98,71,91,-31,122,2643,1991
21,ost003d.map,173,167,11761,70,95,102,71,28156,168,66,4,100,-98,-29,127,4386,5478
22,ost003d.map,173,167,22427,134,117,38,49,12630,75,61,97,105,59,-56,115,5565,4667
23,ost003d.map,173,167,22640,135,71,37,95,9102,54,82,118,84,81,11,92,7823,5173
24,ost003d.map,173,167,8482,50,34,122,132,14412,86,116,86,50,-36,82,118,7975,5171
25,ost003d.map,173,167,27276,163,111,9,55,16444,98,88,74,78,65,-23,88,3636,2244
26,ost003d.map,173,167,27284,163,103,9,63,13309,79,50,93,116,84,-53,137,178,138
27,ost003d.map,173,167,22562,135,149,37,17,4452,26,56,146,110,109,-93,202,7397,3123
28,ost003d.map,173,167,9893,59,126,113,40,18447,110,89,62,77,-51,-37,88,216,192
29,ost003d.map,173,167,25457,152,93,20,73,24654,147,61,25,105,5,-32,37,38,38
30,ost003d.map,173,167,15315,91,48,81,118,10998,65,23,107,143,26,-25,51,508,142
31,ost003d.map,173,167,12144,72,46,100,120,18646,111,57,61,109,-39,11,50,56,51
32,ost003d.map,173,167,17345,103,22,69,144,4454,26,54,146,112,77,32,109,186,466
33,ost003d.map,173,167,19976,119,63,53,103,16912,101,121,71,45,18,58,76,4528,4312
34,ost003d.map,173,167,17945,107,90,65,76,19804,118,68,54,98,-11,-22,33,4679,6542
35,ost003d.map,173,167,27306,163,81,9,85,9654,57,31,115,135,106,-50,156,189,280
36,ost003d.map,173,167,26928,161,125,11,41,7160,42,20,130,146,119,-105,224,429,277
37,ost003d.map,173,167,19890,119,149,53,17,8658,51,25,121,141,68,-124,192,5316,4420
38,ost003d.map,173,167,8086,48,96,124,70,10903,65,118,107,48,-17,22,39,40,40
39,ost003d.map,173,167,11792,70,64,102,102,20947,125,94,47,72,-55,30,85,4840,7605
40,ost003d.map,173,167,20002,119,37,53,129,9670,57,15,115,151,62,-22,84,542,1711
41,ost003d.map,173,167,10249,61,104,111,62,4634,27,41,145,125,34,-63,97,6818,8191
42,ost003d.map,173,167,24148,144,66,28,100,17574,105,127,67,39,39,61,100,2921,2052
43,ost003d.map,173,167,9608,57,77,115,89,16862,100,4,72,162,-43,-73,116,7434,8222
44,ost003d.map,173,167,19962,119,77,53,89,11091,66,97,106,69,53,20,73,7066,4985
45,ost003d.map,173,167,21891,131,152,41,14,19494,116,44,56,122,15,-108,123,1864,2172
46,ost003d.map,173,167,22444,134,100,38,66,14743,88,119,84,47,46,19,65,2249,3069
47,ost003d.map,173,167,25978,155,73,17,93,5142,30,34,142,132,125,-39,164,1540,576
48,ost003d.map,173,167,15464,92,66,80,100,10005,59,14,113,152,33,-52,85,5133,8289
49,ost003d.map,173,167,22333,133,44,39,122,19758,118,114,54,52,15,70,85,701,952
50,ost003d.map,173,167,16355,97,10,75,156,21062,126,146,46,20,-29,136,165,3336,5218
51,ost003d.map,173,167,16587,99,112,73,54,9774,58,78,114,88,41,-34,75,86,93
52,ost003d.map,173,167,26434,158,118,14,48,25467,152,83,20,83,6,-35,41,42,42
53,ost003d.map,173,167,21681,129,28,43,138,14667,87,28,85,138,42,0,42,729,1154
54,ost003d.map,173,167,11835,70,21,102,145,27494,164,60,8,106,-94,39,133,2044,2420
55,ost003d.map,173,167,7497,44,17,128,149,9163,54,21,118,145,-10,4,14,15,15
56,ost003d.map,173,167,21421,128,121,44,45,11167,66,21,106,145,62,-100,162,1943,311
57,ost003d.map,173,167,21843,130,33,42,133,16862,100,4,72,162,30,-29,59,1088,1162
58,ost003d.map,173,167,18769,112,101,60,65,22011,131,32,41,134,-19,-69,88,6926,6941
59,ost003d.map,173,167,23558,141,155,31,11,20471,122,69,50,97,19,-86,105,820,1240
60,ost003d.map,173,167,21616,129,93,43,73,27130,162,90,10,76,-33,-3,36,68,127
61,ost003d.map,173,167,17525,104,9,68,157,18613,111,90,61,76,-7,81,88,8587,7951
62,ost003d.map,173,167,12624,75,67,97,99,21656,129,53,43,113,-54,-14,68,7102,8774
63,ost003d.map,173,167,21461,128,81,44,85,10646,63,41,109,125,65,-40,105,112,141
64,ost003d.map,173,167,19646,117,59,55,107,20591,123,116,49,50,-6,57,63,260,174
65,ost003d.map,173,167,10502,62,18,110,148,21103,126,105,46,61,-64,87,151,189,202
66,ost003d.map,173,167,12962,77,63,95,103,22186,132,24,40,142,-55,-39,94,7391,8710
67,ost003d.map,173,167,3820,22,20,150,146,22300,133,77,39,89,-111,57,168,654,1794
68,ost003d.map,173,167,22756,136,122,36,44,12949,77,76,95,90,59,-46,105,3881,4218
69,ost003d.map,173,167,18084,108,118,64,48,10575,63,112,109,54,45,-6,51,52,52
70,ost003d.map,173,167,16625,99,74,73,92,7171,42,9,130,157,57,-65,122,5215,8183
71,ost003d.map,173,167,9148,54,36,118,130,5133,30,43,142,123,24,7,31,362,486
72,ost003d.map,173,167,27434,164,120,8,46,28451,170,105,2,61,-6,-15,21,118,49
73,ost003d.map,173,167,20768,124,106,48,60,21285,127,90,45,76,-3,-16,19,20,24
74,ost003d.map,173,167,25274,151,109,21,57,24303,145,78,27,88,6,-31,37,65,38
75,ost003d.map,173,167,15632,93,65,79,101,8666,51,17,121,149,42,-48,90,5186,8267
76,ost003d.map,173,167,19161,114,43,58,123,8267,49,82,123,84,65,39,104,8225,5143
77,ost003d.map,173,167,16999,101,34,71,132,16935,101,98,71,68,0,64,64,7871,7633
78,ost003d.map,173,167,16600,99,99,73,67,13781,82,79,90,87,17,-20,37,40,38
79,ost003d.map,173,167,21768,130,108,42,58,27599,165,122,7,44,-35,14,49,50,50
80,ost003d.map,173,167,15080,90,116,82,50,17578,105,123,67,43,-15,7,22,23,23
81,ost003d.map,173,167,10101,60,85,112,81,17790,106,78,66,88,-46,-7,53,204,256
82,ost003d.map,173,167,22805,136,73,36,93,20566,123,141,49,25,13,68,81,1580,974
83,ost003d.map,173,167,23645,141,68,31,98,9750,58,102,114,64,83,34,117,5489,4861
84,ost003d.map,173,167,20961,125,80,47,86,20350,121,23,51,143,4,-57,61,161,255
85,ost003d.map,173,167,19306,115,65,57,101,11475,68,47,104,119,47,-18,65,66,84
86,ost003d.map,173,167,1304,7,31,165,135,15771,94,93,78,73,-87,62,149,8216,7114
87,ost003d.map,173,167,6928,41,85,131,81,26593,159,126,13,40,-118,41,159,3826,3157
88,ost003d.map,173,167,17796,106,72,66,94,6140,36,38,136,128,70,-34,104,7043,8515
89,ost003d.map,173,167,20246,121,127,51,39,7119,42,61,130,105,79,-66,145,7734,6271
90,ost003d.map,173,167,24312,145,69,27,97,27778,166,110,6,56,-21,41,62,63,92
91,ost003d.map,173,167,7994,47,21,125,145,14292,85,69,87,97,-38,48,86,8462,5187
92,ost003d.map,173,167,27424,164,130,8,36,4783,28,59,144,107,136,-71,207,3802,617
93,ost003d.map,173,167,18680,111,23,61,143,9396,56,122,116,44,55,99,154,8468,8747
94,ost003d.map,173,167,17477,104,57,68,109,10174,60,12,112,154,44,-45,89,90,129
95,ost003d.map,173,167,9328,55,23,117,143,20877,125,164,47,2,-70,141,211,3988,5351
96,ost003d.map,173,167,27316,163,71,9,95,20180,120,26,52,140,43,-45,88,619,873
97,ost003d.map,173,167,20125,120,81,52,85,27303,163,84,9,82,-43,3,46,246,56
98,ost003d.map,173,167,14064,84,130,88,36,23592,141,121,31,45,-57,-9,66,1485,1710
99,ost003d.map,173,167,24841,148,41,24,125,9931,59,88,113,78,89,47,136,8506,8444
0,ost004d.map,77,80,3140,39,59,37,20,2254,28,65,48,14,11,6,17,18,18
1,ost004d.map,77,80,1337,16,22,60,57,1343,16,16,60,63,0,-6,6,7,7
2,ost004d.map,77,80,2473,30,6,46,73,1013,12,26,64,53,18,20,38,39,123
3,ost004d.map,77,80,3129,39,70,37,9,3639,45,40,31,39,-6,-30,36,37,37
4,ost004d.map,77,80,3888,48,31,28,48,3721,46,38,30,41,2,7,9,10,10
5,ost004d.map,77,80,3500,43,19,33,60,2214,27,25,49,54,16,6,22,23,34
6,ost004d.map,77,80,2633,32,6,44,73,1561,19,38,57,41,13,32,45,46,91
7,ost004d.map,77,80,928,11,31,65,48,3742,46,17,30,62,-35,-14,49,75,50
8,ost004d.map,77,80,2531,31,28,45,51,2428,30,51,46,28,1,23,24,25,25
9,ost004d.map,77,80,5563,69,36,7,43,1110,13,9,63,70,56,-27,83,84,84
10,ost004d.map,77,80,3800,47,39,29,40,4269,53,50,23,29,-6,11,17,18,18
11,ost004d.map,77,80,4682,58,37,18,42,1172,14,27,62,52,44,-10,54,55,55
12,ost004d.map,77,80,3040,38,79,38,0,2536,31,23,45,56,7,-56,63,64,64
13,ost004d.map,77,80,4248,53,71,23,8,5799,72,40,4,39,-19,-31,50,51,51
14,ost004d.map,77,80,1337,16,22,60,57,3260,40,19,36,60,-24,-3,27,50,28
15,ost004d.map,77,80,2849,35,30,41,49,4754,59,45,17,34,-24,15,39,40,40
16,ost004d.map,77,80,4061,50,18,26,61,1590,19,9,57,70,31,-9,40,41,41
17,ost004d.map,77,80,130,1,29,75,50,3934,49,65,27,14,-48,36,84,154,118
18,ost004d.map,77,80,1560,19,39,57,40,2444,30,35,46,44,-11,-4,15,16,16
19,ost004d.map,77,80,188,2,51,74,28,4815,60,64,16,15,-58,13,71,172,72
20,ost004d.map,77,80,3803,47,36,29,43,1958,24,41,52,38,23,5,28,29,29
21,ost004d.map,77,80,4387,54,12,22,67,3723,46,36,30,43,8,24,32,33,33
22,ost004d.map,77,80,3432,42,7,34,72,2196,27,43,49,36,15,36,51,52,104
23,ost004d.map,77,80,2808,35,71,41,8,5578,69,21,7,58,-34,-50,84,85,85
24,ost004d.map,77,80,2296,28,23,48,56,4917,61,42,15,37,-33,19,52,53,53
25,ost004d.map,77,80,1323,16,36,60,43,5467,68,52,8,27,-52,16,68,965,76
26,ost004d.map,77,80,1714,21,45,55,34,4214,52,25,24,54,-31,-20,51,52,52
27,ost004d.map,77,80,3298,41,61,35,18,5466,68,53,8,26,-27,-8,35,56,36
28,ost004d.map,77,80,5160,64,39,12,40,921,11,38,65,41,53,-1,54,55,55
29,ost004d.map,77,80,1672,20,7,56,72,3748,46,11,30,68,-26,4,30,105,111
30,ost004d.map,77,80,4600,57,39,19,40,784,9,15,67,64,48,-24,72,73,73
31,ost004d.map,77,80,3043,38,76,38,3,532,6,27,70,52,32,-49,81,112,151
32,ost004d.map,77,80,2235,27,4,49,75,2518,31,41,45,38,-4,37,41,58,415
33,ost004d.map,77,80,1433,17,6,59,73,2909,36,50,40,29,-19,44,63,64,64
34,ost004d.map,77,80,4998,62,41,14,38,3414,42,25,34,54,20,-16,36,37,37
35,ost004d.map,77,80,4694,58,25,18,54,1830,22,9,54,70,36,-16,52,53,53
36,ost004d.map,77,80,2608,32,31,44,48,999,12,40,64,39,20,9,29,30,30
37,ost004d.map,77,80,417,5,62,71,17,1806,22,33,54,46,-17,-29,46,47,56
38,ost004d.map,77,80,3942,49,57,27,22,2774,34,25,42,54,15,-32,47,48,48
39,ost004d.map,77,80,2428,30,51,46,28,1013,12,26,64,53,18,-25,43,44,44
40,ost004d.map,77,80,3402,42,37,34,42,5867,73,52,3,27,-31,15,46,505,59
41,ost004d.map,77,80,2762,34,37,42,42,2620,32,19,44,60,2,-18,20,21,21
42,ost004d.map,77,80,3899,48,20,28,59,4519,56,40,20,39,-8,20,28,29,29
43,ost004d.map,77,80,2820,35,59,41,20,2293,28,26,48,53,7,-33,40,41,41
44,ost004d.map,77,80,2936,36,23,40,56,4628,57,11,19,68,-21,-12,33,34,40
45,ost004d.map,77,80,5729,71,30,5,49,2326,29,73,47,6,42,43,85,87,167
46,ost004d.map,77,80,4552,56,7,20,72,1805,22,34,54,45,34,27,61,62,138
47,ost004d.map,77,80,5953,74,46,2,33,2814,35,65,41,14,39,19,58,78,914
48,ost004d.map,77,80,1744,21,15,55,64,3382,42,57,34,22,-21,42,63,64,64
49,ost004d.map,77,80,5809,72,30,4,49,4652,58,67,18,12,14,37,51,53,75
50,ost004d.map,77,80,3292,41,67,35,12,2598,32,41,44,38,9,-26,35,36,36
51,ost004d.map,77,80,1888,23,31,53,48,3054,38,65,38,14,-15,34,49,50,50
52,ost004d.map,77,80,3475,43,44,33,35,3044,38,75,38,4,5,31,36,37,37
53,ost004d.map,77,80,2713,33,6,43,73,1970,24,29,52,50,9,23,32,33,33
54,ost004d.map,77,80,1752,21,7,55,72,5725,71,34,5,45,-50,27,77,78,78
55,ost004d.map,77,80,1105,13,14,63,65,3692,46,67,30,12,-33,53,86,88,88
56,ost004d.map,77,80,1645,20,34,56,45,2015,25,64,51,15,-5,30,35,36,36
57,ost004d.map,77,80,3888,48,31,28,48,2187,27,52,49,27,21,21,42,43,43
58,ost004d.map,77,80,1976,24,23,52,56,1724,21,35,55,44,3,12,15,16,16
59,ost004d.map,77,80,2124,26,35,50,44,3533,44,66,32,13,-18,31,49,50,50
60,ost004d.map,77,80,1449,18,70,58,9,2343,29,56,47,23,-11,-14,25,26,26
61,ost004d.map,77,80,4651,58,68,18,11,381,4,18,72,61,54,-50,104,129,174
62,ost004d.map,77,80,5462,68,57,8,22,1558,19,41,57,38,49,-16,65,66,66
63,ost004d.map,77,80,3216,40,63,36,16,3263,40,16,36,63,0,-47,47,48,48
64,ost004d.map,77,80,2633,32,6,44,73,3114,38,5,38,74,-6,-1,7,8,8
65,ost004d.map,77,80,2505,31,54,45,25,3221,40,58,36,21,-9,4,13,14,14
66,ost004d.map,77,80,2793,34,6,42,73,3334,41,25,35,54,-7,19,26,67,221
67,ost004d.map,77,80,4699,58,20,18,59,3341,41,18,35,61,17,-2,19,20,20
68,ost004d.map,77,80,3907,48,12,28,67,3853,48,66,28,13,0,54,54,55,55
69,ost004d.map,77,80,740,9,59,67,20,3805,47,34,29,45,-38,-25,63,64,64
70,ost004d.map,77,80,5540,69,59,7,20,4751,59,48,17,31,10,-11,21,83,24
71,ost004d.map,77,80,1526,19,73,57,6,5543,69,56,7,23,-50,-17,67,68,68
72,ost004d.map,77,80,5626,70,53,6,26,5575,69,24,7,55,1,-29,30,145,474
73,ost004d.map,77,80,1344,16,15,60,64,3070,38,49,38,30,-22,34,56,57,57
74,ost004d.map,77,80,1501,18,18,58,61,3157,39,42,37,37,-21,24,45,46,46
75,ost004d.map,77,80,4729,59,70,17,9,782,9,17,67,62,50,-53,103,120,138
76,ost004d.map,77,80,1872,23,47,53,32,4574,57,65,19,14,-34,18,52,53,53
77,ost004d.map,77,80,5814,72,25,4,54,1951,24,48,52,31,48,23,71,72,72
78,ost004d.map,77,80,4328,54,71,22,8,2083,26,76,50,3,28,5,33,34,34
79,ost004d.map,77,80,5571,69,28,7,51,5893,73,26,3,53,-4,-2,6,7,7
80,ost004d.map,77,80,4130,51,29,25,50,2227,27,12,49,67,24,-17,41,42,42
81,ost004d.map,77,80,512,6,47,70,32,3695,46,64,30,15,-40,17,57,125,58
82,ost004d.map,77,80,342,4,57,72,22,5566,69,33,7,46,-65,-24,89,90,101
83,ost004d.map,77,80,3812,47,27,29,52,1349,16,10,60,69,31,-17,48,49,49
84,ost004d.map,77,80,3379,42,60,34,19,4943,61,16,15,63,-19,-44,63,64,64
85,ost004d.map,77,80,2209,27,30,49,49,1130,14,69,62,10,13,39,52,175,53
86,ost004d.map,77,80,2260,28,59,48,20,4005,50,74,26,5,-22,15,37,38,38
87,ost004d.map,77,80,1653,20,26,56,53,2679,33,40,43,39,-13,14,27,28,28
88,ost004d.map,77,80,4748,59,51,17,28,3012,37,27,39,52,22,-24,46,47,47
89,ost004d.map,77,80,369,4,30,72,49,2549,31,10,45,69,-27,-20,47,88,48
90,ost004d.map,77,80,3910,48,9,28,70,5415,67,24,9,55,-19,15,34,35,35
91,ost004d.map,77,80,2928,36,31,40,48,1245,15,34,61,45,21,3,24,25,25
92,ost004d.map,77,80,2417,30,62,46,17,2731,34,68,42,11,-4,6,10,11,11
93,ost004d.map,77,80,2809,35,70,41,9,1251,15,28,61,51,20,-42,62,76,63
94,ost004d.map,77,80,1406,17,33,59,46,3367,42,72,34,7,-25,39,64,65,76
95,ost004d.map,77,80,1482,18,37,58,42,2181,27,58,49,21,-9,21,30,31,31
96,ost004d.map,77,80,4930,61,29,15,50,2219,27,20,49,59,34,-9,43,44,44
97,ost004d.map,77,80,4350,54,49,22,30,2839,35,40,41,39,19,-9,28,29,29
98,ost004d.map,77,80,5092,63,27,13,52,4518,56,41,20,38,7,14,21,22,22
99,ost004d.map,77,80,4192,52,47,24,32,4731,59,68,17,11,-7,21,28,29,29
0,ost100d.map,771,777,304224,391,359,379,417,156037,200,139,570,637,191,-220,411,29396,37810
1,ost100d.map,771,777,192176,247,519,523,257,91556,117,129,653,647,130,-390,520,14092,10137
2,ost100d.map,771,777,86075,110,171,660,605,267380,344,684,426,92,-234,513,747,761,3518
3,ost100d.map,771,777,371464,478,718,292,58,210923,271,420,499,356,207,-298,505,6391,1048
4,ost100d.map,771,777,338843,436,705,334,71,348940,449,709,321,67,-13,4,17,22,18
5,ost100d.map,771,777,305817,393,320,377,456,506980,652,400,118,376,-259,80,339,17321,7977
6,ost100d.map,771,777,37070,47,225,723,551,360015,463,512,307,264,-416,287,703,24442,3762
7,ost100d.map,771,777,338214,435,557,335,219,96967,124,157,646,619,311,-400,711,25835,36438
8,ost100d.map,771,777,255936,329,473,441,303,261531,336,317,434,459,-7,-156,163,2621,4355
9,ost100d.map,771,777,256360,329,49,441,727,332681,428,651,342,125,-99,602,701,64023,84879
10,ost100d.map,771,777,503819,648,453,122,323,524780,675,471,95,305,-27,18,45,46,46
11,ost100d.map,771,777,164530,211,193,559,583,218687,281,426,489,350,-70,233,303,10913,26338
12,ost100d.map,771,777,410266,528,766,242,10,192277,247,418,523,358,281,-348,629,1753,2931
13,ost100d.map,771,777,414357,533,560,237,216,165495,212,5,558,771,321,-555,876,62187,42990
14,ost100d.map,771,777,258859,333,658,437,118,396525,510,521,260,255,-177,-137,314,15289,16405
15,ost100d.map,771,777,284674,366,484,404,292,317876,409,693,361,83,-43,209,252,291,1884
16,ost100d.map,771,777,287604,370,662,400,114,289471,372,349,398,427,-2,-313,315,14291,7829
17,ost100d.map,771,777,363170,467,465,303,311,407212,524,712,246,64,-57,247,304,1017,3607
18,ost100d.map,771,777,166546,214,508,556,268,423620,545,621,225,155,-331,113,444,19717,17802
19,ost100d.map,771,777,272121,350,605,420,171,197325,253,32,517,744,97,-573,670,64178,66480
20,ost100d.map,771,777,217109,279,450,491,326,250902,322,68,448,708,-43,-382,425,49821,33785
21,ost100d.map,771,777,377913,486,485,284,291,305773,393,364,377,412,93,-121,214,953,1097
22,ost100d.map,771,777,247761,318,101,452,675,227796,293,641,477,135,25,540,565,33472,80945
23,ost100d.map,771,777,318192,409,377,361,399,184043,236,105,534,671,173,-272,445,39866,45249
24,ost100d.map,771,777,315852,406,386,364,390,485108,624,516,146,260,-218,130,348,1183,812
25,ost100d.map,771,777,154912,199,487,571,289,144905,186,393,584,383,13,-94,107,1456,1270
26,ost100d.map,771,777,418235,538,567,232,209,320502,412,398,358,378,126,-169,295,959,1025
27,ost100d.map,771,777,207401,266,57,504,719,239180,307,135,463,641,-41,78,119,162,577
28,ost100d.map,771,777,297780,383,587,387,189,263254,338,148,432,628,45,-439,484,106309,38183
29,ost100d.map,771,777,234291,301,362,469,414,274932,353,125,417,651,-52,-237,289,60920,38733
30,ost100d.map,771,777,317860,409,709,361,67,234783,302,647,468,129,107,-62,169,2791,1488
31,ost100d.map,771,777,414421,533,496,237,280,329111,423,336,347,440,110,-160,270,457,283
32,ost100d.map,771,777,407972,525,729,245,47,277854,357,311,413,465,168,-418,586,15966,2189
33,ost100d.map,771,777,83033,106,105,664,671,254978,328,654,442,122,-222,549,771,784,3545
34,ost100d.map,771,777,341560,439,319,331,457,359068,462,682,308,94,-23,363,386,17666,6348
35,ost100d.map,771,777,363733,468,679,302,97,132733,170,133,600,643,298,-546,844,66038,14398
36,ost100d.map,771,777,76017,97,128,673,648,257498,331,465,439,311,-234,337,571,824,2474
37,ost100d.map,771,777,224913,289,416,481,360,338382,435,389,335,387,-146,-27,173,5015,6853
38,ost100d.map,771,777,195228,251,575,519,201,182036,234,558,536,218,17,-17,34,35,35
39,ost100d.map,771,777,380020,489,709,281,67,528646,680,490,90,286,-191,-219,410,8909,4233
40,ost100d.map,771,777,368593,474,481,296,295,189759,244,605,526,171,230,124,354,16393,6448
41,ost100d.map,771,777,176262,226,116,544,660,116463,149,86,621,690,77,-30,107,1472,632
42,ost100d.map,771,777,294912,379,347,391,429,93931,120,85,650,691,259,-262,521,12367,35035
43,ost100d.map,771,777,219032,281,81,489,695,504592,649,457,121,319,-368,376,744,72666,82528
44,ost100d.map,771,777,82873,106,265,664,511,422067,543,620,227,156,-437,355,792,13435,43600
45,ost100d.map,771,777,180988,232,52,538,724,356118,458,524,312,252,-226,472,698,37829,61466
46,ost100d.map,771,777,178577,229,132,541,644,394770,508,722,262,54,-279,590,869,31559,86519
47,ost100d.map,771,777,398032,512,568,258,208,199205,256,483,514,293,256,-85,341,10531,14905
48,ost100d.map,771,777,536416,690,490,80,286,76769,98,153,672,623,592,-337,929,10600,50775
49,ost100d.map,771,777,95434,122,136,648,640,323636,416,372,354,404,-294,236,530,23368,16516
50,ost100d.map,771,777,185610,238,92,532,684,534846,688,506,82,270,-450,414,864,57866,76695
51,ost100d.map,771,777,287592,370,674,400,102,405724,522,646,248,130,-152,-28,180,2253,1425
52,ost100d.map,771,777,279061,359,658,411,118,116975,150,351,620,425,209,-307,516,2478,1303
53,ost100d.map,771,777,213601,274,73,496,703,261745,336,103,434,673,-62,30,92,217,116
54,ost100d.map,771,777,165342,212,158,558,618,54927,70,239,700,537,142,81,223,350,939
55,ost100d.map,771,777,256715,330,471,440,305,346636,446,682,324,94,-116,211,327,392,8779
56,ost100d.map,771,777,517826,666,432,104,344,16900,21,193,749,583,645,-239,884,9539,52618
57,ost100d.map,771,777,411996,530,590,240,186,222157,285,64,485,712,245,-526,771,91938,45567
58,ost100d.map,771,777,229632,295,359,475,417,88406,113,171,657,605,182,-188,370,1885,13863
59,ost100d.map,771,777,522413,672,507,98,269,383871,494,743,276,33,178,236,414,3939,8401
60,ost100d.map,771,777,101592,130,194,640,582,165836,213,441,557,335,-83,247,330,12649,10624
61,ost100d.map,771,777,122565,157,200,613,576,229863,295,128,475,648,-138,-72,210,12222,3036
62,ost100d.map,771,777,283713,365,668,405,108,196484,252,96,518,680,113,-572,685,68454,33721
63,ost100d.map,771,777,173648,223,399,547,377,189785,244,579,526,197,-21,180,201,204,393
64,ost100d.map,771,777,161420,207,195,563,581,176750,227,405,543,371,-20,210,230,10188,19186
65,ost100d.map,771,777,264309,340,647,430,129,523927,674,547,96,229,-334,-100,434,23218,10421
66,ost100d.map,771,777,328196,422,474,348,302,298550,384,594,386,182,38,120,158,159,159
67,ost100d.map,771,777,324082,417,703,353,73,117235,150,91,620,685,267,-612,879,44936,29786
68,ost100d.map,771,777,128008,164,196,606,580,91602,117,83,653,693,47,-113,160,360,311
69,ost100d.map,771,777,242873,312,327,458,449,304818,392,542,378,234,-80,215,295,9158,6368
70,ost100d.map,771,777,338344,435,427,335,349,134361,172,59,598,717,263,-368,631,39293,53093
71,ost100d.map,771,777,376314,484,530,286,246,120260,154,174,616,602,330,-356,686,47044,14126
72,ost100d.map,771,777,178644,229,65,541,711,522479,672,441,98,335,-443,376,819,76073,70613
73,ost100d.map,771,777,286624,368,88,402,688,174754,224,70,546,706,144,-18,162,1413,9020
74,ost100d.map,771,777,98976,127,479,643,297,165098,212,402,558,374,-85,-77,162,1304,600
75,ost100d.map,771,777,326635,420,481,350,295,133591,171,52,599,724,249,-429,678,42347,35854
76,ost100d.map,771,777,79026,101,227,669,549,45615,58,227,712,549,43,0,43,44,44
77,ost100d.map,771,777,292808,376,120,394,656,352794,454,740,316,36,-78,620,698,69122,113246
78,ost100d.map,771,777,186757,240,499,530,277,154287,198,335,572,441,42,-164,206,1515,207
79,ost100d.map,771,777,377096,485,525,285,251,103263,132,77,638,699,353,-448,801,42900,29667
80,ost100d.map,771,777,422707,544,757,226,19,342269,440,387,330,389,104,-370,474,7567,1193
81,ost100d.map,771,777,510712,657,553,113,223,161419,207,196,563,580,450,-357,807,69200,20474
82,ost100d.map,771,777,231993,298,329,472,447,151351,194,163,576,613,104,-166,270,21167,31381
83,ost100d.map,771,777,416592,536,656,234,120,531721,684,523,86,253,-148,-133,281,4974,3542
84,ost100d.map,771,777,304933,392,427,378,349,240518,309,351,461,425,83,-76,159,1583,1671
85,ost100d.map,771,777,420370,541,763,229,13,157643,202,87,568,689,339,-676,1015,95303,36904
86,ost100d.map,771,777,238441,306,97,464,679,230660,296,108,474,668,10,11,21,22,22
87,ost100d.map,771,777,155339,199,60,571,716,211277,271,66,499,710,-72,6,78,79,79
88,ost100d.map,771,777,237425,305,336,465,440,177802,228,130,542,646,77,-206,283,28685,39345
89,ost100d.map,771,777,237912,306,626,464,150,277059,356,329,414,447,-50,-297,347,13523,16215
90,ost100d.map,771,777,304289,391,294,379,482,426580,549,769,221,7,-158,475,633,2229,11534
91,ost100d.map,771,777,237128,305,633,465,143,30097,38,205,732,571,267,-428,695,3393,785
92,ost100d.map,771,777,317397,408,395,362,381,235773,303,434,467,342,105,39,144,10078,8749
93,ost100d.map,771,777,179421,230,65,540,711,163573,210,373,560,403,20,308,328,27865,16157
94,ost100d.map,771,777,211272,271,71,499,705,360839,464,465,306,311,-193,394,587,54248,60327
95,ost100d.map,771,777,226760,291,123,479,653,414405,533,512,237,264,-242,389,631,37306,109376
96,ost100d.map,771,777,189938,244,426,526,350,84604,108,88,662,688,136,-338,474,1152,476
97,ost100d.map,771,777,277498,357,667,413,109,72924,93,113,677,663,264,-554,818,3516,887
98,ost100d.map,771,777,202704,260,92,510,684,347548,447,547,323,229,-187,455,642,65430,67165
99,ost100d.map,771,777,106110,136,338,634,438,256295,329,114,441,662,-193,-224,417,30829,27046
0,ost101d.map,97,111,4704,42,68,54,42,5573,50,87,46,23,-8,19,27,28,28
1,ost101d.map,97,111,897,8,101,88,9,5702,51,69,45,41,-43,-32,75,76,76
2,ost101d.map,97,111,2461,22,91,74,19,2574,23,89,73,21,-1,-2,3,4,4
3,ost101d.map,97,111,2915,26,81,70,29,8171,73,42,23,68,-47,-39,86,87,231
4,ost101d.map,97,111,4304,38,24,58,86,4750,42,22,54,88,-4,-2,6,7,7
5,ost101d.map,97,111,3977,35,18,61,92,6188,55,27,41,83,-20,9,29,30,30
6,ost101d.map,97,111,5092,45,13,51,97,3446,31,105,65,5,14,92,106,963,943
7,ost101d.map,97,111,3249,29,80,67,30,3210,28,8,68,102,1,-72,73,762,1116
8,ost101d.map,97,111,6839,61,42,35,68,4951,44,43,52,67,17,1,18,19,19
9,ost101d.map,97,111,7405,66,31,30,79,6383,57,54,39,56,9,23,32,33,33
10,ost101d.map,97,111,9938,89,51,7,59,4796,43,87,53,23,46,36,82,209,716
11,ost101d.map,97,111,2979,26,17,70,93,4012,36,94,60,16,-10,77,87,1074,1051
12,ost101d.map,97,111,4588,41,73,55,37,6909,62,83,34,27,-21,10,31,32,32
13,ost101d.map,97,111,7169,64,45,32,65,3462,31,89,65,21,33,44,77,155,78
14,ost101d.map,97,111,5936,53,57,43,53,5153,46,63,50,47,7,6,13,14,14
15,ost101d.map,97,111,10384,93,49,3,61,5716,51,55,45,55,42,6,48,169,135
16,ost101d.map,97,111,5054,45,51,51,59,6631,59,28,37,82,-14,-23,37,38,128
17,ost101d.map,97,111,6082,54,22,42,88,6853,61,28,35,82,-7,6,13,14,14
18,ost101d.map,97,111,9609,86,47,10,63,4875,43,8,53,102,43,-39,82,83,86
19,ost101d.map,97,111,4693,42,79,54,31,6710,60,60,36,50,-18,-19,37,38,38
20,ost101d.map,97,111,5841,52,41,44,69,5826,52,56,44,54,0,15,15,16,16
21,ost101d.map,97,111,5374,48,64,48,46,4871,43,12,53,98,5,-52,57,160,293
22,ost101d.map,97,111,6721,60,49,36,61,4571,41,90,55,20,19,41,60,61,61
23,ost101d.map,97,111,3243,29,86,67,24,5845,52,37,44,73,-23,-49,72,73,316
24,ost101d.map,97,111,3648,32,14,64,96,3676,33,97,63,13,-1,83,84,1126,1055
25,ost101d.map,97,111,4089,36,17,60,93,2798,25,87,71,23,11,70,81,1078,883
26,ost101d.map,97,111,6050,54,54,42,56,4820,43,63,53,47,11,9,20,21,21
27,ost101d.map,97,111,8401,75,34,21,76,6412,57,25,39,85,18,-9,27,28,28
28,ost101d.map,97,111,3962,35,33,61,77,1462,13,91,83,19,22,58,80,735,1041
29,ost101d.map,97,111,4800,43,83,53,27,4748,42,24,54,86,1,-59,60,472,434
30,ost101d.map,97,111,4795,43,88,53,22,3846,34,38,62,72,9,-50,59,669,366
31,ost101d.map,97,111,3505,31,46,65,64,9717,87,50,9,60,-56,4,60,133,132
32,ost101d.map,97,111,6954,62,38,34,72,4895,44,99,52,11,18,61,79,129,80
33,ost101d.map,97,111,9830,88,48,8,62,4278,38,50,58,60,50,2,52,231,91
34,ost101d.map,97,111,3457,31,94,65,16,4931,44,63,52,47,-13,-31,44,45,50
35,ost101d.map,97,111,2576,23,87,73,23,3890,35,105,61,5,-12,18,30,31,31
36,ost101d.map,97,111,6848,61,33,35,77,4061,36,45,60,65,25,12,37,38,38
37,ost101d.map,97,111,3840,34,44,62,66,4709,42,63,54,47,-8,19,27,226,208
38,ost101d.map,97,111,8395,75,40,21,70,1684,15,91,81,19,60,51,111,307,112
39,ost101d.map,97,111,4764,42,8,54,102,8060,72,42,24,68,-30,34,64,65,65
40,ost101d.map,97,111,4816,43,67,53,43,10502,94,42,2,68,-51,-25,76,77,108
41,ost101d.map,97,111,6736,60,34,36,76,3987,35,8,61,102,25,-26,51,52,52
42,ost101d.map,97,111,10274,92,48,4,62,4726,42,46,54,64,50,-2,52,108,71
43,ost101d.map,97,111,7508,67,39,29,71,4318,38,10,58,100,29,-29,58,59,59
44,ost101d.map,97,111,6408,57,29,39,81,6725,60,45,36,65,-3,16,19,20,20
45,ost101d.map,97,111,5376,48,62,48,48,8729,78,39,18,71,-30,-23,53,54,68
46,ost101d.map,97,111,1684,15,91,81,19,4455,40,95,56,15,-25,4,29,35,30
47,ost101d.map,97,111,5234,47,93,49,17,5604,50,56,46,54,-3,-37,40,41,41
48,ost101d.map,97,111,4640,41,21,55,89,6508,58,40,38,70,-17,19,36,37,37
49,ost101d.map,97,111,7400,66,36,30,74,3948,35,47,61,63,31,11,42,43,43
50,ost101d.map,97,111,2464,22,88,74,22,6621,59,38,37,72,-37,-50,87,88,335
51,ost101d.map,97,111,8288,74,36,22,74,4088,36,18,60,92,38,-18,56,57,57
52,ost101d.map,97,111,5956,53,37,43,73,4806,43,77,53,33,10,40,50,117,51
53,ost101d.map,97,111,4307,38,21,58,89,6501,58,47,38,63,-20,26,46,60,47
54,ost101d.map,97,111,4450,40,100,56,10,4972,44,22,52,88,-4,-78,82,699,518
55,ost101d.map,97,111,4256,38,72,58,38,6081,54,23,42,87,-16,-49,65,66,369
56,ost101d.map,97,111,4104,36,2,60,108,4965,44,29,52,81,-8,27,35,36,36
57,ost101d.map,97,111,5584,50,76,46,34,4978,44,16,52,94,6,-60,66,225,68
58,ost101d.map,97,111,2754,24,20,72,90,3863,34,21,62,89,-10,1,11,12,12
59,ost101d.map,97,111,3468,31,83,65,27,7724,69,45,27,65,-38,-38,76,77,154
60,ost101d.map,97,111,5360,48,78,48,32,2127,19,92,77,18,29,14,43,44,44
61,ost101d.map,97,111,5795,52,87,44,23,6398,57,39,39,71,-5,-48,53,56,176
62,ost101d.map,97,111,4347,39,92,57,18,9044,81,57,15,53,-42,-35,77,1055,178
63,ost101d.map,97,111,8504,76,42,20,68,3988,35,7,61,103,41,-35,76,77,77
64,ost101d.map,97,111,2239,20,91,76,19,9055,81,46,15,64,-61,-45,106,107,111
65,ost101d.map,97,111,5482,49,67,47,43,4132,37,85,59,25,12,18,30,31,31
66,ost101d.map,97,111,10280,92,42,4,68,6517,58,31,38,79,34,-11,45,46,46
67,ost101d.map,97,111,8288,74,36,22,74,10270,92,52,4,58,-18,16,34,35,35
68,ost101d.map,97,111,4096,36,10,60,100,4799,43,84,53,26,-7,74,81,851,581
69,ost101d.map,97,111,2915,26,81,70,29,3119,28,99,68,11,-2,18,20,21,21
70,ost101d.map,97,111,3428,30,12,66,98,5468,49,81,47,29,-19,69,88,759,446
71,ost101d.map,97,111,6467,58,81,38,29,5308,47,19,49,91,11,-62,73,170,74
72,ost101d.map,97,111,3857,34,27,62,83,4868,43,15,53,95,-9,-12,21,22,22
73,ost101d.map,97,111,3194,28,24,68,86,6500,58,48,38,62,-30,24,54,93,55
74,ost101d.map,97,111,3779,34,105,62,5,4935,44,59,52,51,-10,-46,56,57,60
75,ost101d.map,97,111,7179,64,35,32,75,7279,65,46,31,64,-1,11,12,13,13
76,ost101d.map,97,111,1240,11,91,85,19,3838,34,46,62,64,-23,-45,68,1127,442
77,ost101d.map,97,111,5147,46,69,50,41,8510,76,36,20,74,-30,-33,63,64,104
78,ost101d.map,97,111,4125,37,92,59,18,5470,49,79,47,31,-12,-13,25,26,26
79,ost101d.map,97,111,3313,29,16,67,94,5614,50,46,46,64,-21,30,51,67,52
80,ost101d.map,97,111,3450,31,101,65,9,4502,40,48,56,62,-9,-53,62,1119,334
81,ost101d.map,97,111,7730,69,39,27,71,3119,28,99,68,11,41,60,101,309,102
82,ost101d.map,97,111,3196,28,22,68,88,5407,48,31,48,79,-20,9,29,30,30
83,ost101d.map,97,111,9045,81,56,15,54,4117,37,100,59,10,44,44,88,192,1158
84,ost101d.map,97,111,7835,70,45,26,65,4743,42,29,54,81,28,-16,44,45,45
85,ost101d.map,97,111,4683,42,89,54,21,4278,38,50,58,60,4,-39,43,957,207
86,ost101d.map,97,111,4525,40,25,56,85,3023,27,84,69,26,13,59,72,842,711
87,ost101d.map,97,111,4963,44,31,52,79,4559,41,102,55,8,3,71,74,359,666
88,ost101d.map,97,111,5259,47,68,49,42,3127,28,91,68,19,19,23,42,43,43
89,ost101d.map,97,111,675,6,101,90,9,7510,67,37,29,73,-61,-64,125,126,398
90,ost101d.map,97,111,4682,42,90,54,20,10271,92,51,4,59,-50,-39,89,786,223
91,ost101d.map,97,111,5508,49,41,47,69,3670,33,103,63,7,16,62,78,233,725
92,ost101d.map,97,111,4065,36,41,60,69,5361,48,77,48,33,-12,36,48,161,352
93,ost101d.map,97,111,6618,59,41,37,69,5734,51,37,45,73,8,-4,12,13,13
94,ost101d.map,97,111,4184,37,33,59,77,10499,94,45,2,65,-57,12,69,123,70
95,ost101d.map,97,111,5818,52,64,44,46,5191,46,25,50,85,6,-39,45,105,46
96,ost101d.map,97,111,7736,69,33,27,77,4513,40,37,56,73,29,4,33,34,34
97,ost101d.map,97,111,3565,32,97,64,13,5134,46,82,50,28,-14,-15,29,30,30
98,ost101d.map,97,111,3858,34,26,62,84,1575,14,89,82,21,20,63,83,914,998
99,ost101d.map,97,111,7404,66,32,30,78,5397,48,41,48,69,18,9,27,28,28
0,ost102d.map,17,23,244,10,8,6,14,207,9,22,7,0,1,14,15,16,16
1,ost102d.map,17,23,268,11,7,5,15,103,4,11,12,11,7,4,11,12,12
2,ost102d.map,17,23,241,10,11,6,11,12,0,10,16,12,10,-1,11,12,12
3,ost102d.map,17,23,265,11,10,5,12,121,5,16,11,6,6,6,12,13,13
4,ost102d.map,17,23,257,11,18,5,4,154,6,6,10,16,5,-12,17,18,18
5,ost102d.map,17,23,269,11,6,5,16,79,3,12,13,10,8,6,14,16,15
6,ost102d.map,17,23,381,16,9,0,13,382,16,8,0,14,0,-1,1,2,2
7,ost102d.map,17,23,297,12,1,4,21,323,14,21,2,1,-2,20,22,64,42
8,ost102d.map,17,23,98,4,16,12,6,325,14,19,2,3,-10,3,13,14,14
9,ost102d.map,17,23,179,7,4,9,18,204,8,2,8,20,-1,-2,3,4,4
10,ost102d.map,17,23,192,8,14,8,8,303,13,18,3,4,-5,4,9,10,10
11,ost102d.map,17,23,153,6,7,10,15,77,3,14,13,8,3,7,10,11,11
12,ost102d.map,17,23,155,6,5,10,17,156,6,4,10,18,0,-1,1,2,2
13,ost102d.map,17,23,296,12,2,4,20,242,10,10,6,12,2,8,10,11,11
14,ost102d.map,17,23,270,11,5,5,17,238,10,14,6,8,1,9,10,11,11
15,ost102d.map,17,23,123,5,14,11,8,151,6,9,10,13,-1,-5,6,7,7
16,ost102d.map,17,23,326,14,18,2,4,255,11,20,5,2,3,2,5,6,6
17,ost102d.map,17,23,33,1,12,15,10,382,16,8,0,14,-15,-4,19,22,20
18,ost102d.map,17,23,177,7,6,9,16,203,8,3,8,19,-1,-3,4,5,5
19,ost102d.map,17,23,188,8,18,8,4,69,3,22,13,0,5,4,9,10,10
20,ost102d.map,17,23,130,5,7,11,15,226,9,3,7,19,-4,-4,8,9,9
21,ost102d.map,17,23,232,10,20,6,2,214,9,15,7,7,1,-5,6,7,7
22,ost102d.map,17,23,349,15,18,1,4,127,5,10,11,12,10,-8,18,19,19
23,ost102d.map,17,23,339,14,5,2,17,269,11,6,5,16,3,1,4,5,5
24,ost102d.map,17,23,168,7,15,9,7,162,7,21,9,1,0,6,6,7,7
25,ost102d.map,17,23,267,11,8,5,14,35,1,10,15,12,10,2,12,13,15
26,ost102d.map,17,23,209,9,20,7,2,273,11,2,5,20,-2,-18,20,21,21
27,ost102d.map,17,23,382,16,8,0,14,255,11,20,5,2,5,12,17,30,39
28,ost102d.map,17,23,37,1,8,15,14,174,7,9,9,13,-6,1,7,11,14
29,ost102d.map,17,23,200,8,6,8,16,319,13,2,3,20,-5,-4,9,10,10
30,ost102d.map,17,23,92,4,22,12,0,238,10,14,6,8,-6,-8,14,15,15
31,ost102d.map,17,23,98,4,16,12,6,220,9,9,7,13,-5,-7,12,13,13
32,ost102d.map,17,23,380,16,10,0,12,55,2,13,14,9,14,3,17,18,18
33,ost102d.map,17,23,176,7,7,9,15,197,8,9,8,13,-1,2,3,4,4
34,ost102d.map,17,23,209,9,20,7,2,157,6,3,10,19,3,-17,20,21,21
35,ost102d.map,17,23,225,9,4,7,18,36,1,9,15,13,8,5,13,39,18
36,ost102d.map,17,23,268,11,7,5,15,173,7,10,9,12,4,3,7,8,8
37,ost102d.map,17,23,350,15,17,1,5,222,9,7,7,15,6,-10,16,19,50
38,ost102d.map,17,23,300,13,21,3,1,237,10,15,6,7,3,-6,9,10,10
39,ost102d.map,17,23,234,10,18,6,4,10,0,12,16,10,10,-6,16,17,17
40,ost102d.map,17,23,122,5,15,11,7,71,3,20,13,2,2,5,7,8,8
41,ost102d.map,17,23,313,13,8,3,14,162,7,21,9,1,6,13,19,20,20
42,ost102d.map,17,23,349,15,18,1,4,127,5,10,11,12,10,-8,18,19,19
43,ost102d.map,17,23,115,5,22,11,0,343,14,1,2,21,-9,-21,30,31,31
44,ost102d.map,17,23,300,13,21,3,1,117,5,20,11,2,8,-1,9,10,10
45,ost102d.map,17,23,58,2,10,14,12,346,15,21,1,1,-13,11,24,25,25
46,ost102d.map,17,23,370,16,20,0,2,226,9,3,7,19,7,-17,24,25,25
47,ost102d.map,17,23,76,3,15,13,7,199,8,7,8,15,-5,-8,13,14,14
48,ost102d.map,17,23,122,5,15,11,7,324,14,20,2,2,-9,5,14,15,15
49,ost102d.map,17,23,162,7,21,9,1,371,16,19,0,3,-9,-2,11,12,12
50,ost102d.map,17,23,32,1,13,15,9,245,10,7,6,15,-9,-6,15,18,16
51,ost102d.map,17,23,347,15,20,1,2,165,7,18,9,4,8,-2,10,11,11
52,ost102d.map,17,23,292,12,6,4,16,150,6,10,10,12,6,4,10,11,11
53,ost102d.map,17,23,290,12,8,4,14,179,7,4,9,18,5,-4,9,10,10
54,ost102d.map,17,23,193,8,13,8,9,227,9,2,7,20,-1,-11,12,13,13
55,ost102d.map,17,23,194,8,12,8,10,359,15,8,1,14,-7,-4,11,12,12
56,ost102d.map,17,23,348,15,19,1,3,101,4,13,12,9,11,-6,17,18,18
57,ost102d.map,17,23,154,6,6,10,16,103,4,11,12,11,2,5,7,9,8
58,ost102d.map,17,23,293,12,5,4,17,222,9,7,7,15,3,2,5,6,6
59,ost102d.map,17,23,78,3,13,13,9,127,5,10,11,12,-2,-3,5,6,6
60,ost102d.map,17,23,97,4,17,12,5,199,8,7,8,15,-4,-10,14,15,15
61,ost102d.map,17,23,349,15,18,1,4,191,8,15,8,7,7,-3,10,11,11
62,ost102d.map,17,23,242,10,10,6,12,215,9,14,7,8,1,4,5,6,6
63,ost102d.map,17,23,72,3,19,13,3,381,16,9,0,13,-13,-10,23,24,24
64,ost102d.map,17,23,244,10,8,6,14,174,7,9,9,13,3,1,4,5,5
65,ost102d.map,17,23,73,3,18,13,4,57,2,11,14,11,1,-7,8,9,9
66,ost102d.map,17,23,184,8,22,8,0,200,8,6,8,16,0,-16,16,17,17
67,ost102d.map,17,23,56,2,12,14,10,311,13,10,3,12,-11,-2,13,14,14
68,ost102d.map,17,23,225,9,4,7,18,348,15,19,1,3,-6,15,21,22,22
69,ost102d.map,17,23,188,8,18,8,4,101,4,13,12,9,4,-5,9,10,10
70,ost102d.map,17,23,185,8,21,8,1,179,7,4,9,18,1,-17,18,19,19
71,ost102d.map,17,23,211,9,18,7,4,131,5,6,11,16,4,-12,16,17,17
72,ost102d.map,17,23,129,5,8,11,14,146,6,14,10,8,-1,6,7,8,8
73,ost102d.map,17,23,294,12,4,4,18,278,12,20,4,2,0,16,16,35,27
74,ost102d.map,17,23,166,7,17,9,5,191,8,15,8,7,-1,-2,3,4,4
75,ost102d.map,17,23,318,13,3,3,19,79,3,12,13,10,10,9,19,23,20
76,ost102d.map,17,23,208,9,21,7,1,70,3,21,13,1,6,0,6,7,7
77,ost102d.map,17,23,140,6,20,10,2,357,15,10,1,12,-9,-10,19,20,20
78,ost102d.map,17,23,202,8,4,8,18,99,4,15,12,7,4,11,15,19,16
79,ost102d.map,17,23,187,8,19,8,3,213,9,16,7,6,-1,-3,4,5,5
80,ost102d.map,17,23,196,8,10,8,12,190,8,16,8,6,0,6,6,7,7
81,ost102d.map,17,23,173,7,10,9,12,157,6,3,10,19,1,-7,8,9,9
82,ost102d.map,17,23,224,9,5,7,17,292,12,6,4,16,-3,1,4,5,5
83,ost102d.map,17,23,139,6,21,10,1,223,9,6,7,16,-3,-15,18,19,19
84,ost102d.map,17,23,100,4,14,12,8,213,9,16,7,6,-5,2,7,8,8
85,ost102d.map,17,23,314,13,7,3,15,34,1,11,15,11,12,4,16,17,19
86,ost102d.map,17,23,148,6,12,10,10,350,15,17,1,5,-9,5,14,38,17
87,ost102d.map,17,23,120,5,17,11,5,240,10,12,6,10,-5,-5,10,11,11
88,ost102d.map,17,23,236,10,16,6,6,277,12,21,4,1,-2,5,7,8,8
89,ost102d.map,17,23,144,6,16,10,6,81,3,10,13,12,3,-6,9,10,10
90,ost102d.map,17,23,170,7,13,9,9,100,4,14,12,8,3,1,4,5,5
91,ost102d.map,17,23,144,6,16,10,6,245,10,7,6,15,-4,-9,13,14,14
92,ost102d.map,17,23,221,9,8,7,14,254,11,21,5,1,-2,13,15,16,16
93,ost102d.map,17,23,145,6,15,10,7,222,9,7,7,15,-3,-8,11,12,12
94,ost102d.map,17,23,348,15,19,1,3,70,3,21,13,1,12,2,14,15,15
95,ost102d.map,17,23,139,6,21,10,1,198,8,8,8,14,-2,-13,15,16,16
96,ost102d.map,17,23,187,8,19,8,3,101,4,13,12,9,4,-6,10,11,11
97,ost102d.map,17,23,145,6,15,10,7,239,10,13,6,9,-4,-2,6,7,7
98,ost102d.map,17,23,58,2,10,14,12,268,11,7,5,15,-9,-3,12,13,13
99,ost102d.map,17,23,195,8,11,8,11,269,11,6,5,16,-3,-5,8,9,9
0,oth000d.map,319,299,21326,71,201,247,97,19263,64,171,254,127,7,-30,37,638,107
1,oth000d.map,319,299,38489,128,81,190,217,33418,111,69,207,229,17,-12,29,30,39
2,oth000d.map,319,299,63100,211,287,107,11,62663,209,126,109,172,2,-161,163,13026,9460
3,oth000d.map,319,299,20120,67,211,251,87,62078,207,113,111,185,-140,-98,238,13148,6692
4,oth000d.map,319,299,75809,253,136,65,162,24714,82,102,236,196,171,-34,205,5263,8644
5,oth000d.map,319,299,65940,220,138,98,160,6358,21,219,297,79,199,81,280,4351,12264
6,oth000d.map,319,299,82144,274,80,44,218,38203,127,68,191,230,147,-12,159,5836,7728
7,oth000d.map,319,299,64493,215,90,103,208,15350,51,197,267,101,164,107,271,6207,10848
8,oth000d.map,319,299,17212,57,129,261,169,19247,64,187,254,111,-7,58,65,946,405
9,oth000d.map,319,299,34928,116,54,202,244,16227,54,217,264,81,62,163,225,2531,1946
10,oth000d.map,319,299,80947,270,81,48,217,22838,76,184,242,114,194,103,297,8162,15475
11,oth000d.map,319,299,44203,147,48,171,250,9975,33,190,285,108,114,142,256,285,263
12,oth000d.map,319,299,80905,270,123,48,175,45970,153,75,165,223,117,-48,165,5937,6703
13,oth000d.map,319,299,61875,206,17,112,281,65719,219,60,99,238,-13,43,56,57,57
14,oth000d.map,319,299,13888,46,164,272,134,17132,57,209,261,89,-11,45,56,57,57
15,oth000d.map,319,299,78213,261,124,57,174,22519,75,204,243,94,186,80,266,8126,14609
16,oth000d.map,319,299,17434,58,206,260,92,44836,149,13,169,285,-91,-193,284,1636,3591
17,oth000d.map,319,299,91111,304,83,14,215,19591,65,142,253,156,239,59,298,5364,12979
18,oth000d.map,319,299,55324,185,289,133,9,71621,239,138,79,160,-54,-151,205,12283,9436
19,oth000d.map,319,299,20814,69,115,249,183,39718,132,48,186,250,-63,-67,130,131,131
20,oth000d.map,319,299,3704,12,182,306,116,3670,12,216,306,82,0,34,34,63,72
21,oth000d.map,319,299,38300,128,270,190,28,41191,137,70,181,228,-9,-200,209,3321,3584
22,oth000d.map,319,299,25825,86,187,232,111,13875,46,177,272,121,40,-10,50,51,51
23,oth000d.map,319,299,40096,134,268,184,30,65722,219,57,99,241,-85,-211,296,11130,7453
24,oth000d.map,319,299,14481,48,169,270,129,87241,291,66,27,232,-243,-103,346,14697,5408
25,oth000d.map,319,299,41872,140,286,178,12,15376,51,171,267,127,89,-115,204,205,222
26,oth000d.map,319,299,86003,287,108,31,190,45693,152,53,166,245,135,-55,190,5914,6309
27,oth000d.map,319,299,3696,12,190,306,108,61004,204,290,114,8,-192,100,292,899,298
28,oth000d.map,319,299,57416,192,290,126,8,89291,298,109,20,189,-106,-181,287,14661,9444
29,oth000d.map,319,299,43004,143,51,175,247,48133,160,5,158,293,-17,-46,63,807,708
30,oth000d.map,319,299,85149,284,65,34,233,75510,252,136,66,162,32,71,103,490,644
31,oth000d.map,319,299,2804,9,185,309,113,42479,142,277,176,21,-133,92,225,832,231
32,oth000d.map,319,299,3373,11,214,307,84,20735,69,194,249,104,-58,-20,78,79,101
33,oth000d.map,319,299,48137,160,1,158,297,17780,59,159,259,139,101,158,259,260,267
34,oth000d.map,319,299,64197,214,87,104,211,10885,36,177,282,121,178,90,268,3026,10027
35,oth000d.map,319,299,22209,74,215,244,83,7543,25,230,293,68,49,15,64,941,531
36,oth000d.map,319,299,23432,78,188,240,110,5754,19,225,299,73,59,37,96,97,97
37,oth000d.map,319,299,37893,126,79,192,219,82143,274,81,44,217,-148,2,150,8000,5798
38,oth000d.map,319,299,88091,294,113,24,185,88126,294,78,24,220,0,-35,35,36,36
39,oth000d.map,319,299,25313,84,101,234,197,94374,315,109,3,189,-231,8,239,9204,5304
40,oth000d.map,319,299,94401,315,82,3,216,78813,263,122,55,176,52,40,92,272,100
41,oth000d.map,319,299,25825,86,187,232,111,37940,126,32,192,266,-40,-155,195,792,2864
42,oth000d.map,319,299,23516,78,104,240,194,61559,205,34,113,264,-127,-70,197,3698,1979
43,oth000d.map,319,299,88408,295,95,23,203,16227,54,217,264,81,241,122,363,8938,14679
44,oth000d.map,319,299,50228,167,3,151,295,4005,13,180,305,118,154,177,331,4610,432
45,oth000d.map,319,299,41544,138,16,180,282,36147,120,31,198,267,18,15,33,34,39
46,oth000d.map,319,299,48733,162,3,156,295,18087,60,151,258,147,102,148,250,251,258
47,oth000d.map,319,299,41190,137,71,181,227,42759,143,296,175,2,-6,225,231,3647,3963
48,oth000d.map,319,299,32233,107,58,211,240,19003,63,132,255,166,44,74,118,119,119
49,oth000d.map,319,299,18336,61,201,257,97,58555,195,48,123,250,-134,-153,287,9674,6107
50,oth000d.map,319,299,93220,311,67,7,231,9997,33,168,285,130,278,101,379,5450,14706
51,oth000d.map,319,299,3368,11,219,307,79,29533,98,67,220,231,-87,-152,239,273,314
52,oth000d.map,319,299,19223,64,211,254,87,78511,262,125,56,173,-198,-86,284,14609,8768
53,oth000d.map,319,299,38011,127,260,191,38,62390,208,100,110,198,-81,-160,241,13070,8755
54,oth000d.map,319,299,58618,196,284,122,14,22231,74,193,244,105,122,-91,213,214,231
55,oth000d.map,319,299,13600,45,153,273,145,61847,206,45,112,253,-161,-108,269,6190,2567
56,oth000d.map,319,299,16832,56,210,262,88,43873,146,79,172,219,-90,-131,221,3601,2507
57,oth000d.map,319,299,42386,141,71,177,227,18708,62,128,256,170,79,57,136,137,137
58,oth000d.map,319,299,19900,66,132,252,166,24879,83,236,235,62,-17,104,121,131,576
59,oth000d.map,319,299,33160,110,28,208,270,86356,288,54,30,244,-178,26,204,6228,5205
60,oth000d.map,319,299,23108,77,213,241,85,41502,138,58,180,240,-61,-155,216,1100,2477
61,oth000d.map,319,299,14481,48,169,270,129,44498,148,52,170,246,-100,-117,217,218,218
62,oth000d.map,319,299,92912,310,76,8,222,60084,200,14,118,284,110,-62,172,3371,2633
63,oth000d.map,319,299,47174,157,67,161,231,19311,64,123,254,175,93,56,149,150,150
64,oth000d.map,319,299,31328,104,66,214,232,64831,216,51,102,247,-112,-15,127,3288,1704
65,oth000d.map,319,299,62800,210,288,108,10,83934,280,84,38,214,-70,-204,274,15457,9460
66,oth000d.map,319,299,37714,126,258,192,40,16023,53,122,265,176,73,-136,209,1361,254
67,oth000d.map,319,299,4264,14,220,304,78,42482,142,274,176,24,-128,54,182,834,2336
68,oth000d.map,319,299,94986,317,95,1,203,46340,154,4,164,294,163,-91,254,3488,4905
69,oth000d.map,319,299,20736,69,193,249,105,19279,64,155,254,143,5,-38,43,295,275
70,oth000d.map,319,299,89914,300,84,18,214,65130,217,51,101,247,83,-33,116,3124,2100
71,oth000d.map,319,299,30240,101,257,217,41,63098,211,289,107,9,-110,32,142,160,143
72,oth000d.map,319,299,65144,217,37,101,261,8789,29,180,289,118,188,143,331,2648,7693
73,oth000d.map,319,299,43604,145,49,173,249,62727,209,62,109,236,-64,13,77,3063,2579
74,oth000d.map,319,299,60681,202,15,116,283,32252,107,39,211,259,95,24,119,483,763
75,oth000d.map,319,299,43381,145,272,173,26,66541,222,135,96,163,-77,-137,214,12263,9362
76,oth000d.map,319,299,61273,204,21,114,277,13294,44,160,274,138,160,139,299,1991,5228
77,oth000d.map,319,299,15648,52,198,266,100,84251,281,66,37,232,-229,-132,361,15460,8695
78,oth000d.map,319,299,24116,80,102,238,196,3406,11,181,307,117,69,79,148,2172,254
79,oth000d.map,319,299,8494,28,176,290,122,8767,29,202,289,96,-1,26,27,28,28
80,oth000d.map,319,299,63329,211,58,107,240,85419,285,94,33,204,-74,36,110,2642,2980
81,oth000d.map,319,299,49642,166,290,152,8,32227,107,64,211,234,59,-226,285,3743,3559
82,oth000d.map,319,299,83000,277,121,41,177,16852,56,190,262,108,221,69,290,9095,14628
83,oth000d.map,319,299,35246,117,35,201,263,81510,272,116,46,182,-155,81,236,6101,5205
84,oth000d.map,319,299,62804,210,284,108,14,10303,34,161,284,137,176,-123,299,305,320
85,oth000d.map,319,299,18617,62,219,256,79,18015,60,223,258,75,2,4,6,7,7
86,oth000d.map,319,299,41576,139,283,179,15,20465,68,165,250,133,71,-118,189,578,209
87,oth000d.map,319,299,9986,33,179,285,119,94999,317,82,1,216,-284,-97,381,14714,5461
88,oth000d.map,319,299,18628,62,208,256,90,35231,117,50,201,248,-55,-158,213,1453,2515
89,oth000d.map,319,299,42761,143,294,175,4,8738,29,231,289,67,114,-63,177,2746,678
90,oth000d.map,319,299,16896,56,146,262,152,36809,123,266,195,32,-67,120,187,232,1197
91,oth000d.map,319,299,3401,11,186,307,112,60652,202,44,116,254,-191,-142,333,8844,2586
92,oth000d.map,319,299,17789,59,150,259,148,64302,215,281,103,17,-156,131,287,2535,1515
93,oth000d.map,319,299,10301,34,163,284,135,9086,30,182,288,116,4,19,23,24,24
94,oth000d.map,319,299,43877,146,75,172,223,14477,48,173,270,125,98,98,196,197,197
95,oth000d.map,319,299,63256,211,131,107,167,11157,37,204,281,94,174,73,247,3691,12868
96,oth000d.map,319,299,19313,64,121,254,177,25764,86,248,232,50,-22,127,149,169,757
97,oth000d.map,319,299,38544,128,26,190,272,46574,155,69,163,229,-27,43,70,183,1057
98,oth000d.map,319,299,32858,109,31,209,267,77606,259,133,59,165,-150,102,252,5589,3019
99,oth000d.map,319,299,3669,12,217,306,81,8446,28,224,290,74,-16,7,23,25,24
0,oth001d.map,318,322,90772,281,31,36,290,50702,157,173,160,148,124,142,266,2636,4593
1,oth001d.map,318,322,77721,241,202,76,119,42370,131,133,186,188,110,-69,179,2421,4593
2,oth001d.map,318,322,80200,249,299,68,22,71291,221,192,96,129,28,-107,135,1581,2421
3,oth001d.map,318,322,85594,265,57,52,264,50703,157,172,160,149,108,115,223,2636,4593
4,oth001d.map,318,322,59744,185,147,132,174,44606,138,151,179,170,47,4,51,52,98
5,oth001d.map,318,322,84386,262,299,55,22,15163,47,292,270,29,215,-7,222,1581,1111
6,oth001d.map,318,322,94690,294,299,23,22,62310,193,157,124,164,101,-142,243,1581,4593
7,oth001d.map,318,322,51385,159,134,158,187,62317,193,150,124,171,-34,16,50,51,51
8,oth001d.map,318,322,72411,224,38,93,283,51692,160,149,157,172,64,111,175,2636,4593
9,oth001d.map,318,322,46840,145,171,172,150,74538,231,165,86,156,-86,-6,92,4593,2421
10,oth001d.map,318,322,43682,135,109,182,212,45582,141,141,176,180,-6,32,38,82,125
11,oth001d.map,318,322,21158,65,93,252,228,99582,309,237,8,84,-244,144,388,2058,1581
12,oth001d.map,318,322,85273,264,56,53,265,73354,227,61,90,260,37,5,42,43,69
13,oth001d.map,318,322,39809,123,118,194,203,101820,316,253,1,68,-193,135,328,4593,1581
14,oth001d.map,318,322,54226,168,191,149,130,82412,255,19,62,302,-87,-172,259,4593,2636
15,oth001d.map,318,322,66753,207,222,110,99,51002,158,195,159,126,49,-27,76,2421,4593
16,oth001d.map,318,322,38837,120,124,197,197,71614,222,191,95,130,-102,67,169,4593,2421
17,oth001d.map,318,322,30771,95,140,222,181,16303,50,118,267,203,45,-22,67,4593,2058
18,oth001d.map,318,322,25650,79,109,238,212,75607,234,62,83,259,-155,-47,202,2058,2636
19,oth001d.map,318,322,74330,230,51,87,270,72092,223,35,94,286,7,-16,23,25,24
20,oth001d.map,318,322,45588,141,135,176,186,44598,138,159,179,162,3,24,27,28,28
21,oth001d.map,318,322,23710,73,117,244,204,12439,38,118,279,203,35,1,36,37,37
22,oth001d.map,318,322,100204,311,259,6,62,63599,197,156,120,165,114,-103,217,1581,4593
23,oth001d.map,318,322,19529,60,112,257,209,80483,249,16,68,305,-189,-96,285,2058,2636
24,oth001d.map,318,322,50088,155,143,162,178,77907,241,16,76,305,-86,-127,213,4593,2636
25,oth001d.map,318,322,81408,252,57,65,264,1340,4,269,313,52,248,212,460,2636,1111
26,oth001d.map,318,322,18564,57,111,260,210,98581,306,272,11,49,-249,161,410,2058,1581
27,oth001d.map,318,322,45930,142,115,175,206,37878,117,117,200,204,25,2,27,56,82
28,oth001d.map,318,322,73697,228,40,89,281,53285,165,166,152,155,63,126,189,2636,4593
29,oth001d.map,318,322,19547,60,94,257,227,7099,22,306,295,15,38,212,250,2058,1111
30,oth001d.map,318,322,31106,96,127,221,194,82356,255,75,62,246,-159,-52,211,4593,2636
31,oth001d.map,318,322,53259,165,192,152,129,61339,190,162,127,159,-25,-30,55,107,70
32,oth001d.map,318,322,51712,160,129,157,192,17266,53,121,264,200,107,-8,115,4593,2058
33,oth001d.map,318,322,88510,274,39,43,282,73686,228,51,89,270,46,12,58,365,310
34,oth001d.map,318,322,52332,162,153,155,168,69206,214,23,103,298,-52,-130,182,4593,2636
35,oth001d.map,318,322,77593,240,8,77,313,23706,73,121,244,200,167,113,280,2636,2058
36,oth001d.map,318,322,23057,71,126,246,195,57141,177,174,140,147,-106,48,154,2058,4593
37,oth001d.map,318,322,73680,228,57,89,264,65492,203,195,114,126,25,138,163,2636,2421
38,oth001d.map,318,322,12404,38,153,279,168,47540,147,115,170,206,-109,-38,147,2058,4593
39,oth001d.map,318,322,19203,59,116,258,205,53311,165,140,152,181,-106,24,130,2058,4593
40,oth001d.map,318,322,75144,233,203,84,118,40790,126,103,191,218,107,-100,207,2421,4593
41,oth001d.map,318,322,22779,70,82,247,239,38533,119,106,198,215,-49,24,73,2058,4593
42,oth001d.map,318,322,64235,199,164,118,157,8388,26,305,291,16,173,141,314,4593,1111
43,oth001d.map,318,322,19841,61,122,256,199,86954,270,307,47,14,-209,185,394,2058,1581
44,oth001d.map,318,322,48482,150,139,167,182,51669,160,172,157,149,-10,33,43,51,84
45,oth001d.map,318,322,66140,205,191,112,130,71446,221,37,96,284,-16,-154,170,2421,2636
46,oth001d.map,318,322,69352,215,199,102,122,23737,73,90,244,231,142,-109,251,2421,2058
47,oth001d.map,318,322,32700,101,143,216,178,5175,16,298,301,23,85,155,240,4593,1111
48,oth001d.map,318,322,17914,55,117,262,204,97643,303,244,14,77,-248,127,375,2058,1581
49,oth001d.map,318,322,58473,181,130,136,191,51001,158,196,159,125,23,66,89,482,91
50,oth001d.map,318,322,51987,161,176,156,145,18555,57,120,260,201,104,-56,160,4593,2058
51,oth001d.map,318,322,56212,174,137,143,184,43957,136,156,181,165,38,19,57,58,84
52,oth001d.map,318,322,12410,38,147,279,174,11287,35,304,282,17,3,157,160,2058,1111
53,oth001d.map,318,322,100220,311,243,6,78,84295,261,68,56,253,50,-175,225,1581,2636
54,oth001d.map,318,322,52026,161,137,156,184,59998,186,215,131,106,-25,78,103,4593,2421
55,oth001d.map,318,322,69214,214,15,103,306,53303,165,148,152,173,49,133,182,2636,4593
56,oth001d.map,318,322,98898,307,277,10,44,45559,141,164,176,157,166,-113,279,1581,4593
57,oth001d.map,318,322,84698,263,309,54,12,18579,57,96,260,225,206,-213,419,1581,2058
58,oth001d.map,318,322,46249,143,118,174,203,32709,101,134,216,187,42,16,58,65,207
59,oth001d.map,318,322,75787,235,204,82,117,61927,192,218,125,103,43,14,57,80,58
60,oth001d.map,318,322,47783,148,194,169,127,26287,81,116,236,205,67,-78,145,4593,2058
61,oth001d.map,318,322,72249,224,200,93,121,86591,268,26,49,295,-44,-174,218,2421,2636
62,oth001d.map,318,322,47838,148,139,169,182,83415,259,304,58,17,-111,165,276,4593,1581
63,oth001d.map,318,322,100256,311,207,6,114,76943,238,14,79,307,73,-193,266,1581,2636
64,oth001d.map,318,322,74186,230,195,87,126,78685,244,204,73,117,-14,9,23,24,24
65,oth001d.map,318,322,97645,303,242,14,79,55255,171,128,146,193,132,-114,246,1581,4593
66,oth001d.map,318,322,98569,306,284,11,37,91078,282,47,35,274,24,-237,261,1581,2636
67,oth001d.map,318,322,27265,84,104,233,217,8076,25,295,292,26,59,191,250,2058,1111
68,oth001d.map,318,322,42995,133,152,184,169,69686,216,187,101,134,-83,35,118,4593,2421
69,oth001d.map,318,322,74824,232,201,85,120,83329,258,68,59,253,-26,-133,159,2421,2636
70,oth001d.map,318,322,70976,220,185,97,136,96628,300,293,17,28,-80,108,188,2421,1581
71,oth001d.map,318,322,62264,193,203,124,118,67254,208,43,109,278,-15,-160,175,2421,2636
72,oth001d.map,318,322,85945,266,28,51,293,53951,167,144,150,177,99,116,215,2636,4593
73,oth001d.map,318,322,74001,229,58,88,263,68893,213,14,104,307,16,-44,60,132,61
74,oth001d.map,318,322,71762,222,43,95,278,48450,150,171,167,150,72,128,200,2636,4593
75,oth001d.map,318,322,71936,223,191,94,130,69528,215,23,102,298,8,-168,176,2421,2636
76,oth001d.map,318,322,38193,118,124,199,197,53284,165,167,152,154,-47,43,90,352,107
77,oth001d.map,318,322,97606,303,281,14,40,71431,221,52,96,269,82,-229,311,1581,2636
78,oth001d.map,318,322,2952,9,267,308,54,68886,213,21,104,300,-204,-246,450,1111,2636
79,oth001d.map,318,322,44921,139,158,178,163,67750,210,191,107,130,-71,33,104,4593,2421
80,oth001d.map,318,322,95332,296,301,21,20,98942,307,233,10,88,-11,-68,79,80,131
81,oth001d.map,318,322,41435,128,102,189,219,42023,130,158,187,163,-2,56,58,137,189
82,oth001d.map,318,322,21140,65,111,252,210,79790,247,65,70,256,-182,-46,228,2058,2636
83,oth001d.map,318,322,10163,31,140,286,181,55877,173,150,144,171,-142,10,152,2058,4593
84,oth001d.map,318,322,92752,288,305,29,16,79837,247,18,70,303,41,-287,328,1581,2636
85,oth001d.map,318,322,8568,26,125,291,196,8058,25,313,292,8,1,188,189,2058,1111
86,oth001d.map,318,322,22409,69,130,248,191,68074,211,189,106,132,-142,59,201,2058,2421
87,oth001d.map,318,322,51995,161,168,156,153,1966,6,287,311,34,155,119,274,4593,1111
88,oth001d.map,318,322,18585,57,90,260,231,47188,146,145,171,176,-89,55,144,2058,4593
89,oth001d.map,318,322,73724,228,13,89,308,88183,273,44,44,277,-45,31,76,116,80
90,oth001d.map,318,322,69332,215,219,102,102,94045,292,300,25,21,-77,81,158,2421,1581
91,oth001d.map,318,322,47192,146,141,171,180,4518,14,311,303,10,132,170,302,4593,1111
92,oth001d.map,318,322,32704,101,139,216,182,55543,172,162,145,159,-71,23,94,381,1073
93,oth001d.map,318,322,53296,165,155,152,166,2596,8,301,309,20,157,146,303,4593,1111
94,oth001d.map,318,322,72725,225,46,92,275,38535,119,104,198,217,106,58,164,2636,4593
95,oth001d.map,318,322,77082,239,197,78,124,84059,261,304,56,17,-22,107,129,2421,1581
96,oth001d.map,318,322,73894,229,165,88,156,13727,42,118,275,203,187,-47,234,2421,2058
97,oth001d.map,318,322,56520,175,151,142,170,55885,173,142,144,179,2,-9,11,12,12
98,oth001d.map,318,322,79152,245,59,72,262,79011,245,200,72,121,0,141,141,2636,2421
99,oth001d.map,318,322,48488,150,133,167,188,12091,37,144,280,177,113,11,124,4593,2058
0,oth999d.map,32,49,738,15,45,16,3,555,11,32,20,16,4,-13,17,18,18
1,oth999d.map,32,49,1289,26,33,5,15,1158,23,17,8,31,3,-16,19,20,20
2,oth999d.map,32,49,643,13,42,18,6,527,10,11,21,37,3,-31,34,35,35
3,oth999d.map,32,49,1420,28,0,3,48,733,14,1,17,47,14,1,15,16,16
4,oth999d.map,32,49,686,14,48,17,0,1055,21,22,10,26,-7,-26,33,34,34
5,oth999d.map,32,49,216,4,28,27,20,1567,31,0,0,48,-27,-28,55,56,56
6,oth999d.map,32,49,554,11,33,20,15,267,5,26,26,22,6,-7,13,14,14
7,oth999d.map,32,49,1394,28,26,3,22,683,13,2,18,46,15,-24,39,40,40
8,oth999d.map,32,49,920,18,10,13,38,412,8,28,23,20,10,18,28,29,29
9,oth999d.map,32,49,650,13,35,18,13,109,2,37,29,11,11,2,13,14,14
10,oth999d.map,32,49,465,9,24,22,24,859,17,22,14,26,-8,-2,10,11,11
11,oth999d.map,32,49,461,9,28,22,20,477,9,12,22,36,0,-16,16,17,17
12,oth999d.map,32,49,843,17,38,14,10,551,11,36,20,12,6,-2,8,9,9
13,oth999d.map,32,49,357,7,34,24,14,87,1,10,30,38,6,-24,30,31,31
14,oth999d.map,32,49,1250,25,23,6,25,858,17,23,14,25,8,0,8,9,9
15,oth999d.map,32,49,1105,22,21,9,27,532,10,6,21,42,12,-15,27,28,28
16,oth999d.map,32,49,1294,26,28,5,20,263,5,30,26,18,21,2,23,24,24
17,oth999d.map,32,49,1203,24,21,7,27,599,12,37,19,11,12,16,28,29,29
18,oth999d.map,32,49,661,13,24,18,24,1438,29,31,2,17,-16,7,23,24,24
19,oth999d.map,32,49,1104,22,22,9,26,278,5,15,26,33,17,-7,24,25,25
20,oth999d.map,32,49,790,16,42,15,6,407,8,33,23,15,8,-9,17,18,18
21,oth999d.map,32,49,1081,22,45,9,3,1059,21,18,10,30,1,-27,28,29,29
22,oth999d.map,32,49,366,7,25,24,23,534,10,4,21,44,-3,-21,24,25,25
23,oth999d.map,32,49,1292,26,30,5,18,1535,31,32,0,16,-5,2,7,8,8
24,oth999d.map,32,49,1050,21,27,10,21,1062,21,15,10,33,0,-12,12,13,13
25,oth999d.map,32,49,1561,31,6,0,42,874,17,7,14,41,14,1,15,16,16
26,oth999d.map,32,49,290,5,3,26,45,478,9,11,22,37,-4,8,12,13,13
27,oth999d.map,32,49,809,16,23,15,25,514,10,24,21,24,6,1,7,8,8
28,oth999d.map,32,49,1092,22,34,9,14,293,5,0,26,48,17,-34,51,52,52
29,oth999d.map,32,49,1245,25,28,6,20,1254,25,19,6,29,0,-9,9,10,10
30,oth999d.map,32,49,883,18,47,13,1,1491,30,27,1,21,-12,-20,32,33,33
31,oth999d.map,32,49,1210,24,14,7,34,1102,22,24,9,24,2,10,12,13,13
32,oth999d.map,32,49,706,14,28,17,20,1052,21,25,10,23,-7,-3,10,11,11
33,oth999d.map,32,49,764,15,19,16,29,886,18,44,13,4,-3,25,28,29,29
34,oth999d.map,32,49,1427,29,42,2,6,1461,29,8,2,40,0,-34,34,35,35
35,oth999d.map,32,49,562,11,25,20,23,1467,29,2,2,46,-18,-23,41,42,42
36,oth999d.map,32,49,656,13,29,18,19,150,3,45,28,3,10,16,26,27,27
37,oth999d.map,32,49,1170,23,5,8,43,1427,29,42,2,6,-6,37,43,44,44
38,oth999d.map,32,49,417,8,23,23,25,1310,26,12,5,36,-18,-11,29,30,30
39,oth999d.map,32,49,956,19,23,12,25,1142,23,33,8,15,-4,10,14,15,15
40,oth999d.map,32,49,321,6,21,25,27,823,16,9,15,39,-10,-12,22,23,23
41,oth999d.map,32,49,784,16,48,15,0,1212,24,12,7,36,-8,-36,44,45,45
42,oth999d.map,32,49,1365,27,6,4,42,30,0,18,31,30,27,12,39,40,40
43,oth999d.map,32,49,1096,22,30,9,18,1018,20,10,11,38,2,-20,22,23,23
44,oth999d.map,32,49,42,0,6,31,42,877,17,4,14,44,-17,-2,19,20,20
45,oth999d.map,32,49,1236,25,37,6,11,1460,29,9,2,39,-4,-28,32,33,33
46,oth999d.map,32,49,1150,23,25,8,23,1303,26,19,5,29,-3,-6,9,10,10
47,oth999d.map,32,49,80,1,17,30,31,440,8,0,23,48,-7,-17,24,25,25
48,oth999d.map,32,49,989,20,39,11,9,525,10,13,21,35,10,-26,36,37,37
49,oth999d.map,32,49,1267,25,6,6,42,830,16,2,15,46,9,-4,13,14,14
50,oth999d.map,32,49,889,18,41,13,7,1357,27,14,4,34,-9,-27,36,37,37
51,oth999d.map,32,49,411,8,29,23,19,982,20,46,11,2,-12,17,29,30,30
52,oth999d.map,32,49,435,8,5,23,43,199,4,45,27,3,4,40,44,45,45
53,oth999d.map,32,49,642,13,43,18,5,551,11,36,20,12,2,-7,9,10,10
54,oth999d.map,32,49,1394,28,26,3,22,1235,25,38,6,10,3,12,15,16,16
55,oth999d.map,32,49,131,2,15,29,33,1431,29,38,2,10,-27,23,50,51,51
56,oth999d.map,32,49,530,10,8,21,40,263,5,30,26,18,5,22,27,28,28
57,oth999d.map,32,49,64,1,33,30,15,1541,31,26,0,22,-30,-7,37,38,38
58,oth999d.map,32,49,1403,28,17,3,31,628,12,8,19,40,16,-9,25,26,26
59,oth999d.map,32,49,737,15,46,16,2,471,9,18,22,30,6,-28,34,35,35
60,oth999d.map,32,49,63,1,34,30,14,807,16,25,15,23,-15,-9,24,25,25
61,oth999d.map,32,49,1003,20,25,11,23,934,19,45,12,3,1,20,21,22,22
62,oth999d.map,32,49,1472,30,46,1,2,375,7,16,24,32,23,-30,53,54,54
63,oth999d.map,32,49,465,9,24,22,24,182,3,13,28,35,6,-11,17,18,18
64,oth999d.map,32,49,1374,28,46,3,2,495,10,43,21,5,18,-3,21,22,22
65,oth999d.map,32,49,1296,26,26,5,22,303,6,39,25,9,20,13,33,34,34
66,oth999d.map,32,49,1353,27,18,4,30,629,12,7,19,41,15,-11,26,27,27
67,oth999d.map,32,49,370,7,21,24,27,255,5,38,26,10,2,17,19,20,20
68,oth999d.map,32,49,674,13,11,18,37,1131,23,44,8,4,-10,33,43,44,44
69,oth999d.map,32,49,1309,26,13,5,35,631,12,5,19,43,14,-8,22,23,23
70,oth999d.map,32,49,1079,22,47,9,1,639,13,46,18,2,9,-1,10,11,11
71,oth999d.map,32,49,387,7,4,24,44,1492,30,26,1,22,-23,22,45,46,46
72,oth999d.map,32,49,1318,26,4,5,44,183,3,12,28,36,23,8,31,32,32
73,oth999d.map,32,49,1049,21,28,10,20,438,8,2,23,46,13,-26,39,40,40
74,oth999d.map,32,49,1385,28,35,3,13,990,20,38,11,10,8,3,11,12,12
75,oth999d.map,32,49,842,17,39,14,9,382,7,9,24,39,10,-30,40,41,41
76,oth999d.map,32,49,1065,21,12,10,36,1095,22,31,9,17,-1,19,20,21,21
77,oth999d.map,32,49,827,16,5,15,43,44,0,4,31,44,16,-1,17,18,18
78,oth999d.map,32,49,208,4,36,27,12,1327,27,44,4,4,-23,8,31,32,32
79,oth999d.map,32,49,35,0,13,31,35,223,4,21,27,27,-4,8,12,13,13
80,oth999d.map,32,49,1044,21,33,10,15,814,16,18,15,30,5,-15,20,21,21
81,oth999d.map,32,49,803,16,29,15,19,1196,24,28,7,20,-8,-1,9,10,10
82,oth999d.map,32,49,1034,21,43,10,5,764,15,19,16,29,6,-24,30,31,31
83,oth999d.map,32,49,670,13,15,18,33,462,9,27,22,21,4,12,16,17,17
84,oth999d.map,32,49,331,6,11,25,37,420,8,20,23,28,-2,9,11,12,12
85,oth999d.map,32,49,509,10,29,21,19,437,8,3,23,45,2,-26,28,29,29
86,oth999d.map,32,49,265,5,28,26,20,22,0,26,31,22,5,-2,7,8,8
87,oth999d.map,32,49,1224,24,0,7,48,1445,29,24,2,24,-5,24,29,30,30
88,oth999d.map,32,49,1282,26,40,5,8,1373,28,47,3,1,-2,7,9,10,10
89,oth999d.map,32,49,960,19,19,12,29,258,5,35,26,13,14,16,30,31,31
90,oth999d.map,32,49,1497,30,21,1,27,990,20,38,11,10,10,17,27,28,28
91,oth999d.map,32,49,323,6,19,25,29,716,14,18,17,30,-8,-1,9,10,10
92,oth999d.map,32,49,456,9,33,22,15,1075,21,2,10,46,-12,-31,43,44,44
93,oth999d.map,32,49,495,10,43,21,5,855,17,26,14,22,-7,-17,24,25,25
94,oth999d.map,32,49,221,4,23,27,25,1294,26,28,5,20,-22,5,27,28,28
95,oth999d.map,32,49,1162,23,13,8,35,1555,31,12,0,36,-8,-1,9,10,10
96,oth999d.map,32,49,544,11,43,20,5,467,9,22,22,26,2,-21,23,24,24
97,oth999d.map,32,49,882,18,48,13,0,499,10,39,21,9,8,-9,17,18,18
98,oth999d.map,32,49,1101,22,25,9,23,254,5,39,26,9,17,14,31,32,32
99,oth999d.map,32,49,762,15,21,16,27,1139,23,36,8,12,-8,15,23,24,24
0,rmtst.map,46,179,1510,8,100,37,78,4175,23,120,22,58,-15,20,35,36,46
1,rmtst.map,46,179,7639,42,57,3,121,4823,26,9,19,169,16,-48,64,65,82
2,rmtst.map,46,179,7640,42,56,3,122,3747,20,11,25,167,22,-45,67,68,99
3,rmtst.map,46,179,7074,39,85,6,93,2221,12,105,33,73,27,20,47,48,48
4,rmtst.map,46,179,1150,6,102,39,76,3487,19,92,26,86,-13,-10,23,26,27
5,rmtst.map,46,179,4729,26,103,19,75,6923,38,57,7,121,-12,-46,58,736,138
6,rmtst.map,46,179,7498,41,19,4,159,7301,40,37,5,141,1,18,19,20,20
7,rmtst.map,46,179,3440,19,139,26,39,3906,21,31,24,147,-2,-108,110,111,292
8,rmtst.map,46,179,4584,25,69,20,109,5630,31,97,14,81,-6,28,34,35,35
9,rmtst.map,46,179,6691,37,110,8,68,563,3,152,42,26,34,42,76,536,77
10,rmtst.map,46,179,386,2,150,43,28,1890,10,78,35,100,-8,-72,80,634,784
11,rmtst.map,46,179,1379,7,52,38,126,52,0,126,45,52,7,74,81,1150,862
12,rmtst.map,46,179,4730,26,102,19,76,5293,29,76,16,102,-3,-26,29,30,30
13,rmtst.map,46,179,4272,23,23,22,155,687,3,28,42,150,20,5,25,27,26
14,rmtst.map,46,179,5771,32,135,13,43,6573,36,49,9,129,-4,-86,90,250,800
15,rmtst.map,46,179,3466,19,113,26,65,6604,36,18,9,160,-17,-95,112,113,160
16,rmtst.map,46,179,5254,29,115,16,63,1878,10,90,35,88,19,-25,44,45,45
17,rmtst.map,46,179,1734,9,55,36,123,7279,40,59,5,119,-31,4,35,146,75
18,rmtst.map,46,179,7312,40,26,5,152,2329,13,176,32,2,27,150,177,961,178
19,rmtst.map,46,179,3842,21,95,24,83,7326,40,12,5,166,-19,-83,102,103,103
20,rmtst.map,46,179,7608,42,88,3,90,5631,31,96,14,82,11,8,19,20,20
21,rmtst.map,46,179,3368,18,32,27,146,6933,38,47,7,131,-20,15,35,122,43
22,rmtst.map,46,179,225,1,132,44,46,6742,37,59,8,119,-36,-73,109,1791,1005
23,rmtst.map,46,179,3849,21,88,24,90,4586,25,67,20,111,-4,-21,25,26,26
24,rmtst.map,46,179,3928,21,9,24,169,1615,9,174,36,4,12,165,177,1547,178
25,rmtst.map,46,179,3520,19,59,26,119,4143,23,152,22,26,-4,93,97,98,207
26,rmtst.map,46,179,3361,18,39,27,139,6394,35,49,10,129,-17,10,27,28,28
27,rmtst.map,46,179,5928,33,157,12,21,3470,19,109,26,69,14,-48,62,127,63
28,rmtst.map,46,179,2810,15,53,30,125,4461,24,13,21,165,-9,-40,49,50,78
29,rmtst.map,46,179,2099,11,48,34,130,7830,43,45,2,133,-32,-3,35,83,36
30,rmtst.map,46,179,2184,12,142,33,36,3907,21,30,24,148,-9,-112,121,123,785
31,rmtst.map,46,179,42,0,136,45,42,5678,31,49,14,129,-31,-87,118,128,1069
32,rmtst.map,46,179,8200,45,33,0,145,3007,16,35,29,143,29,2,31,32,32
33,rmtst.map,46,179,2493,13,12,32,166,8022,44,32,1,146,-31,20,51,52,52
34,rmtst.map,46,179,3489,19,90,26,88,3314,18,86,27,92,1,-4,5,6,6
35,rmtst.map,46,179,2152,12,174,33,4,5705,31,22,14,156,-19,-152,171,172,1091
36,rmtst.map,46,179,1769,9,20,36,158,2515,14,169,31,9,-5,149,154,1257,1193
37,rmtst.map,46,179,7480,41,37,4,141,2603,14,81,31,97,27,44,71,195,72
38,rmtst.map,46,179,4806,26,26,19,152,1399,7,32,38,146,19,6,25,26,26
39,rmtst.map,46,179,675,3,40,42,138,853,4,41,41,137,-1,1,2,3,3
40,rmtst.map,46,179,91,0,87,45,91,4079,22,37,23,141,-22,-50,72,91,439
41,rmtst.map,46,179,2241,12,85,33,93,3369,18,31,27,147,-6,-54,60,147,254
42,rmtst.map,46,179,4674,26,158,19,20,398,2,138,43,40,24,-20,44,45,54
43,rmtst.map,46,179,4030,22,86,23,92,2231,12,95,33,83,10,9,19,20,20
44,rmtst.map,46,179,902,5,171,40,7,3678,20,80,25,98,-15,-91,106,267,1030
45,rmtst.map,46,179,3722,20,36,25,142,3599,20,159,25,19,0,123,123,127,127
46,rmtst.map,46,179,5363,29,6,16,172,2910,16,132,29,46,13,126,139,680,140
47,rmtst.map,46,179,1553,8,57,37,121,4035,22,81,23,97,-14,24,38,76,361
48,rmtst.map,46,179,3649,20,109,25,69,6218,34,46,11,132,-14,-63,77,99,78
49,rmtst.map,46,179,6169,34,95,11,83,7145,39,14,6,164,-5,-81,86,484,948
50,rmtst.map,46,179,2286,12,40,33,138,6759,37,42,8,136,-25,2,27,57,28
51,rmtst.map,46,179,3800,21,137,24,41,2126,11,21,34,157,10,-116,126,694,127
52,rmtst.map,46,179,7232,40,106,5,72,3925,21,12,24,166,19,-94,113,114,114
53,rmtst.map,46,179,3546,19,33,26,145,6893,38,87,7,91,-19,54,73,74,94
54,rmtst.map,46,179,872,4,22,41,156,3796,21,141,24,37,-17,119,136,186,1054
55,rmtst.map,46,179,4099,22,17,23,161,2300,12,26,33,152,10,9,19,20,20
56,rmtst.map,46,179,7840,43,35,2,143,1801,10,167,35,11,33,132,165,1131,166
57,rmtst.map,46,179,5739,32,167,13,11,3103,17,118,28,60,15,-49,64,223,71
58,rmtst.map,46,179,4584,25,69,20,109,3833,21,104,24,74,4,35,39,40,40
59,rmtst.map,46,179,1910,10,58,35,120,4199,23,96,22,82,-13,38,51,82,717
60,rmtst.map,46,179,3472,19,107,26,71,1124,6,128,39,50,13,21,34,246,78
61,rmtst.map,46,179,3808,21,129,24,49,3684,20,74,25,104,1,-55,56,61,57
62,rmtst.map,46,179,5635,31,92,14,86,5429,30,119,15,59,1,27,28,29,29
63,rmtst.map,46,179,3753,20,5,25,173,7467,41,50,4,128,-21,45,66,67,67
64,rmtst.map,46,179,4154,23,141,22,37,3092,17,129,28,49,6,-12,18,19,19
65,rmtst.map,46,179,1155,6,97,39,81,2911,16,131,29,47,-10,34,44,413,243
66,rmtst.map,46,179,3946,22,170,23,8,2397,13,108,32,70,9,-62,71,376,72
67,rmtst.map,46,179,4513,25,140,20,38,4719,26,113,19,65,-1,-27,28,80,59
68,rmtst.map,46,179,366,2,170,43,8,231,1,126,44,52,1,-44,45,48,46
69,rmtst.map,46,179,2472,13,33,32,145,3286,18,114,27,64,-5,81,86,216,389
70,rmtst.map,46,179,2117,11,30,34,148,1030,5,43,40,135,6,13,19,20,20
71,rmtst.map,46,179,2601,14,83,31,95,4071,22,45,23,133,-8,-38,46,47,130
72,rmtst.map,46,179,5336,29,33,16,145,2218,12,108,33,70,17,75,92,269,95
73,rmtst.map,46,179,5803,32,103,13,75,1220,6,32,39,146,26,-71,97,476,135
74,rmtst.map,46,179,4537,25,116,20,62,4131,23,164,22,14,2,48,50,51,51
75,rmtst.map,46,179,4526,25,127,20,51,7510,41,7,4,171,-16,-120,136,182,1141
76,rmtst.map,46,179,7328,40,10,5,168,1267,7,164,38,14,33,154,187,1760,188
77,rmtst.map,46,179,6387,35,56,10,122,2068,11,79,34,99,24,23,47,124,382
78,rmtst.map,46,179,4181,23,114,22,64,3374,18,26,27,152,5,-88,93,184,94
79,rmtst.map,46,179,339,1,18,44,160,683,3,32,42,146,-2,14,16,27,26
80,rmtst.map,46,179,3437,19,142,26,36,3495,19,84,26,94,0,-58,58,98,139
81,rmtst.map,46,179,4441,24,33,21,145,2605,14,79,31,99,10,46,56,204,57
82,rmtst.map,46,179,5057,28,133,17,45,1278,7,153,38,25,21,20,41,189,42
83,rmtst.map,46,179,4259,23,36,22,142,1046,5,27,40,151,18,-9,27,28,28
84,rmtst.map,46,179,2051,11,96,34,82,2933,16,109,29,69,-5,13,18,19,19
85,rmtst.map,46,179,1531,8,79,37,99,2775,15,88,30,90,-7,9,16,17,17
86,rmtst.map,46,179,6536,36,86,9,92,1862,10,106,35,72,26,20,46,47,47
87,rmtst.map,46,179,4233,23,62,22,116,2700,15,163,30,15,8,101,109,505,110
88,rmtst.map,46,179,42,0,136,45,42,7437,41,80,4,98,-41,-56,97,107,761
89,rmtst.map,46,179,1512,8,98,37,80,3542,19,37,26,141,-11,-61,72,276,305
90,rmtst.map,46,179,1225,6,27,39,151,5214,29,155,16,23,-23,128,151,189,1142
91,rmtst.map,46,179,452,2,84,43,94,7853,43,22,2,156,-41,-62,103,122,720
92,rmtst.map,46,179,1992,11,155,34,23,3741,20,17,25,161,-9,-138,147,243,1051
93,rmtst.map,46,179,4938,27,73,18,105,1083,6,169,39,9,21,96,117,1081,118
94,rmtst.map,46,179,8200,45,33,0,145,4173,23,122,22,56,22,89,111,112,112
95,rmtst.map,46,179,868,4,26,41,152,1453,8,157,37,21,-4,131,135,1601,1425
96,rmtst.map,46,179,7676,42,20,3,158,5461,30,87,15,91,12,67,79,790,338
97,rmtst.map,46,179,6931,38,49,7,129,3380,18,20,27,158,20,-29,49,50,50
98,rmtst.map,46,179,3236,18,164,27,14,5708,31,19,14,159,-13,-145,158,159,458
99,rmtst.map,46,179,1403,7,28,38,150,4982,27,29,18,149,-20,1,21,22,22
0,rmtst01.map,46,179,4853,27,158,18,20,4766,26,66,19,112,1,-92,93,235,306
1,rmtst01.map,46,179,3672,20,86,25,92,6766,37,35,8,143,-17,-51,68,69,69
2,rmtst01.map,46,179,3691,20,67,25,111,3637,20,121,25,57,0,54,54,55,55
3,rmtst01.map,46,179,2851,15,12,30,166,4990,27,21,18,157,-12,9,21,22,22
4,rmtst01.map,46,179,4597,25,56,20,122,6687,37,114,8,64,-12,58,70,71,71
5,rmtst01.map,46,179,5113,28,77,17,101,4158,23,137,22,41,5,60,65,66,66
6,rmtst01.map,46,179,1477,8,133,37,45,2094,11,53,34,125,-3,-80,83,759,853
7,rmtst01.map,46,179,3809,21,128,24,50,5046,28,144,17,34,-7,16,23,24,24
8,rmtst01.map,46,179,2963,16,79,29,99,3541,19,38,26,140,-3,-41,44,63,119
9,rmtst01.map,46,179,5569,31,158,14,20,5826,32,80,13,98,-1,-78,79,383,719
10,rmtst01.map,46,179,4074,22,42,23,136,3533,19,46,26,132,3,4,7,8,8
11,rmtst01.map,46,179,5161,28,29,17,149,1019,5,54,40,124,23,25,48,49,49
12,rmtst01.map,46,179,3658,20,100,25,78,3887,21,50,24,128,-1,-50,51,52,52
13,rmtst01.map,46,179,6138,34,126,11,52,1023,5,50,40,128,29,-76,105,782,1088
14,rmtst01.map,46,179,4488,25,165,20,13,7040,39,119,6,59,-14,-46,60,413,99
15,rmtst01.map,46,179,20,0,158,45,20,4525,25,128,20,50,-25,-30,55,56,72
16,rmtst01.map,46,179,1258,7,173,38,5,3847,21,90,24,88,-14,-83,97,98,816
17,rmtst01.map,46,179,3882,21,55,24,123,5150,28,40,17,138,-7,-15,22,23,23
18,rmtst01.map,46,179,1888,10,80,35,98,4161,23,134,22,44,-13,54,67,68,164
19,rmtst01.map,46,179,3787,21,150,24,28,3629,20,129,25,49,1,-21,22,23,23
20,rmtst01.map,46,179,6403,35,40,10,138,4902,27,109,18,69,8,69,77,232,430
21,rmtst01.map,46,179,25,0,153,45,25,2030,11,117,34,61,-11,-36,47,625,264
22,rmtst01.map,46,179,5512,30,36,15,142,3731,20,27,25,151,10,-9,19,20,20
23,rmtst01.map,46,179,5872,32,34,13,144,4738,26,94,19,84,6,60,66,169,184
24,rmtst01.map,46,179,6328,35,115,10,63,3421,19,158,26,20,16,43,59,76,60
25,rmtst01.map,46,179,5410,30,138,15,40,7116,39,43,6,135,-9,-95,104,317,812
26,rmtst01.map,46,179,4251,23,44,22,134,8022,44,32,1,146,-21,-12,33,34,34
27,rmtst01.map,46,179,7508,41,9,4,169,1222,6,30,39,148,35,21,56,57,57
28,rmtst01.map,46,179,5616,31,111,14,67,1886,10,82,35,96,21,-29,50,51,51
29,rmtst01.map,46,179,6130,34,134,11,44,3286,18,114,27,64,16,-20,36,64,37
30,rmtst01.map,46,179,2812,15,51,30,127,2359,13,146,32,32,2,95,97,563,585
31,rmtst01.map,46,179,1088,6,164,39,14,4562,25,91,20,87,-19,-73,92,93,844
32,rmtst01.map,46,179,3323,18,77,27,101,2367,13,138,32,40,5,61,66,477,194
33,rmtst01.map,46,179,3291,18,109,27,69,3211,17,10,28,168,1,-99,100,215,261
34,rmtst01.map,46,179,6067,33,18,12,160,4668,26,164,19,14,7,146,153,708,498
35,rmtst01.map,46,179,3923,21,14,24,164,2308,12,18,33,160,9,4,13,14,14
36,rmtst01.map,46,179,5315,29,54,16,124,3518,19,61,26,117,10,7,17,18,18
37,rmtst01.map,46,179,376,2,160,43,18,1702,9,87,36,91,-7,-73,80,800,768
38,rmtst01.map,46,179,5376,30,172,15,6,2939,16,103,29,75,14,-69,83,274,106
39,rmtst01.map,46,179,2994,16,48,29,130,6132,34,132,11,46,-18,84,102,103,335
40,rmtst01.map,46,179,3314,18,86,27,92,514,2,22,43,156,16,-64,80,344,638
41,rmtst01.map,46,179,869,4,25,41,153,3799,21,138,24,40,-17,113,130,180,1012
42,rmtst01.map,46,179,6688,37,113,8,65,909,5,164,40,14,32,51,83,569,84
43,rmtst01.map,46,179,7506,41,11,4,167,7478,41,39,4,139,0,28,28,29,29
44,rmtst01.map,46,179,491,2,45,43,133,6966,38,14,7,164,-36,-31,67,68,115
45,rmtst01.map,46,179,4445,24,29,21,149,4159,23,136,22,42,1,107,108,109,109
46,rmtst01.map,46,179,4424,24,50,21,128,2475,13,30,32,148,11,-20,31,41,32
47,rmtst01.map,46,179,4001,22,115,23,63,4987,27,24,18,154,-5,-91,96,97,97
48,rmtst01.map,46,179,5920,33,165,12,13,6516,36,106,9,72,-3,-59,62,465,443
49,rmtst01.map,46,179,6176,34,88,11,90,3555,19,24,26,154,15,-64,79,101,80
50,rmtst01.map,46,179,208,1,149,44,29,4370,24,104,21,74,-23,-45,68,78,369
51,rmtst01.map,46,179,6577,36,45,9,133,1402,7,29,38,149,29,-16,45,49,135
52,rmtst01.map,46,179,1227,6,25,39,153,3189,17,32,28,146,-11,7,18,19,19
53,rmtst01.map,46,179,4179,23,116,22,62,1581,8,29,37,149,15,-87,102,592,128
54,rmtst01.map,46,179,6760,37,41,8,137,1077,6,175,39,3,31,134,165,1319,231
55,rmtst01.map,46,179,5336,29,33,16,145,3609,20,149,25,29,9,116,125,216,126
56,rmtst01.map,46,179,1385,7,46,38,132,215,1,142,44,36,6,96,102,1182,1130
57,rmtst01.map,46,179,3712,20,46,25,132,3928,21,9,24,169,-1,-37,38,39,39
58,rmtst01.map,46,179,1589,8,21,37,157,2006,11,141,34,37,-3,120,123,1322,1047
59,rmtst01.map,46,179,6587,36,35,9,143,4181,23,114,22,64,13,79,92,93,93
60,rmtst01.map,46,179,1760,9,29,36,149,5983,33,102,12,76,-24,73,97,117,403
61,rmtst01.map,46,179,1401,7,30,38,148,2365,13,140,32,38,-6,110,116,1049,1058
62,rmtst01.map,46,179,2289,12,37,33,141,3197,17,24,28,154,-5,-13,18,19,19
63,rmtst01.map,46,179,4096,22,20,23,158,3851,21,86,24,92,1,66,67,68,68
64,rmtst01.map,46,179,2027,11,120,34,58,2150,12,176,33,2,-1,56,57,339,589
65,rmtst01.map,46,179,6171,34,93,11,85,918,5,155,40,23,29,62,91,754,92
66,rmtst01.map,46,179,1752,9,37,36,141,6033,33,52,12,126,-24,15,39,40,40
67,rmtst01.map,46,179,3594,20,164,25,14,1212,6,40,39,138,14,-124,138,1181,362
68,rmtst01.map,46,179,700,3,15,42,163,5007,27,4,18,174,-24,-11,35,46,36
69,rmtst01.map,46,179,2833,15,30,30,148,1790,10,178,35,0,5,148,153,1304,789
70,rmtst01.map,46,179,6881,38,99,7,79,323,1,34,44,144,37,-65,102,515,152
71,rmtst01.map,46,179,1133,6,119,39,59,1703,9,86,36,92,-3,-33,36,66,78
72,rmtst01.map,46,179,4377,24,97,21,81,2508,14,176,31,2,10,79,89,377,90
73,rmtst01.map,46,179,4256,23,39,22,139,5327,29,42,16,136,-6,3,9,10,10
74,rmtst01.map,46,179,4404,24,70,21,108,5751,32,155,13,23,-8,85,93,475,184
75,rmtst01.map,46,179,4896,27,115,18,63,3179,17,42,28,136,10,-73,83,218,84
76,rmtst01.map,46,179,6516,36,106,9,72,1957,10,11,35,167,26,-95,121,486,122
77,rmtst01.map,46,179,3496,19,83,26,95,3007,16,35,29,143,3,-48,51,85,132
78,rmtst01.map,46,179,928,5,145,40,33,3370,18,30,27,148,-13,-115,128,553,1270
79,rmtst01.map,46,179,4043,22,73,23,105,4396,24,78,21,100,-2,5,7,8,8
80,rmtst01.map,46,179,1745,9,44,36,134,4322,24,152,21,26,-15,108,123,143,911
81,rmtst01.map,46,179,1944,10,24,35,154,7462,41,55,4,123,-31,31,62,92,107
82,rmtst01.map,46,179,749,4,145,41,33,2734,15,129,30,49,-11,-16,27,28,28
83,rmtst01.map,46,179,4706,26,126,19,52,1782,9,7,36,171,17,-119,136,647,156
84,rmtst01.map,46,179,3684,20,74,25,104,4524,25,129,20,49,-5,55,60,61,65
85,rmtst01.map,46,179,5100,28,90,17,88,4101,22,15,23,163,6,-75,81,82,82
86,rmtst01.map,46,179,4218,23,77,22,101,5739,32,167,13,11,-9,90,99,104,100
87,rmtst01.map,46,179,4146,23,149,22,29,6718,37,83,8,95,-14,-66,80,81,81
88,rmtst01.map,46,179,1384,7,47,38,131,5179,28,11,17,167,-21,-36,57,58,58
89,rmtst01.map,46,179,4012,22,104,23,74,2189,12,137,33,41,10,33,43,201,45
90,rmtst01.map,46,179,3268,18,132,27,46,6429,35,14,10,164,-17,-118,135,136,450
91,rmtst01.map,46,179,1051,5,22,40,156,4879,27,132,18,46,-22,110,132,176,881
92,rmtst01.map,46,179,3864,21,73,24,105,2224,12,102,33,76,9,29,38,39,41
93,rmtst01.map,46,179,1953,10,15,35,163,4749,26,83,19,95,-16,68,84,85,219
94,rmtst01.map,46,179,5257,29,112,16,66,7057,39,102,6,76,-10,-10,20,21,21
95,rmtst01.map,46,179,2240,12,86,33,92,6410,35,33,10,145,-23,-53,76,79,253
96,rmtst01.map,46,179,4088,22,28,23,150,3497,19,82,26,96,3,54,57,95,58
97,rmtst01.map,46,179,3369,18,31,27,147,1626,9,163,36,15,9,132,141,1257,409
98,rmtst01.map,46,179,987,5,86,40,92,1630,9,159,36,19,-4,73,77,948,809
99,rmtst01.map,46,179,1419,7,12,38,166,5526,30,22,15,156,-23,10,33,34,34
0,rmtst03.map,46,179,4448,24,26,21,152,2014,11,133,34,45,13,107,120,897,123
1,rmtst03.map,46,179,2683,14,1,31,177,159,0,19,45,159,14,18,32,3,5619
2,rmtst03.map,46,179,4912,27,99,18,79,5577,31,150,14,28,-4,51,55,306,193
3,rmtst03.map,46,179,1914,10,54,35,124,2469,13,36,32,142,-3,-18,21,47,36
4,rmtst03.map,46,179,5193,29,176,16,2,6006,33,79,12,99,-4,-97,101,526,1025
5,rmtst03.map,46,179,4816,26,16,19,162,5716,31,11,14,167,-5,-5,10,11,11
6,rmtst03.map,46,179,2048,11,99,34,79,3517,19,62,26,116,-8,-37,45,50,49
7,rmtst03.map,46,179,1416,7,15,38,163,595,3,120,42,58,4,105,109,1056,754
8,rmtst03.map,46,179,5312,29,57,16,121,5705,31,22,14,156,-2,-35,37,38,38
9,rmtst03.map,46,179,2906,16,136,29,42,7459,41,58,4,120,-25,-78,103,1715,470
10,rmtst03.map,46,179,1937,10,31,35,147,6892,38,88,7,90,-28,57,85,86,251
11,rmtst03.map,46,179,5562,31,165,14,13,4918,27,93,18,85,4,-72,76,286,387
12,rmtst03.map,46,179,5362,29,7,16,171,6598,36,24,9,154,-7,17,24,25,25
13,rmtst03.map,46,179,4270,23,25,22,153,3358,18,42,27,136,5,17,22,23,23
14,rmtst03.map,46,179,2718,15,145,30,33,3062,17,159,28,19,-2,14,16,20,38
15,rmtst03.map,46,179,1328,7,103,38,75,1148,6,104,39,74,1,1,2,3,3
16,rmtst03.map,46,179,7609,42,87,3,91,5277,29,92,16,86,13,5,18,19,19
17,rmtst03.map,46,179,938,5,135,40,43,2172,12,154,33,24,-7,19,26,176,90
18,rmtst03.map,46,179,2093,11,54,34,124,6879,38,101,7,77,-27,47,74,88,869
19,rmtst03.map,46,179,4042,22,74,23,104,4458,24,16,21,162,-2,-58,60,61,61
20,rmtst03.map,46,179,3043,17,178,28,0,6455,36,167,9,11,-19,-11,30,35,33
21,rmtst03.map,46,179,2961,16,81,29,97,5637,31,90,14,88,-15,9,24,25,25
22,rmtst03.map,46,179,2564,14,120,31,58,7422,41,95,4,83,-27,-25,52,53,53
23,rmtst03.map,46,179,5749,32,157,13,21,5277,29,92,16,86,3,-65,68,316,488
24,rmtst03.map,46,179,6869,38,111,7,67,5437,30,111,15,67,8,0,8,9,9
25,rmtst03.map,46,179,6330,35,113,10,65,5443,30,105,15,73,5,-8,13,14,14
26,rmtst03.map,46,179,4137,23,158,22,20,2338,13,167,32,11,10,9,19,22,20
27,rmtst03.map,46,179,5529,30,19,15,159,3532,19,47,26,131,11,28,39,40,40
28,rmtst03.map,46,179,4816,26,16,19,162,4223,23,72,22,106,3,56,59,60,60
29,rmtst03.map,46,179,4386,24,88,21,90,7843,43,32,2,146,-19,-56,75,76,76
30,rmtst03.map,46,179,3012,16,30,29,148,3127,17,94,28,84,-1,64,65,154,130
31,rmtst03.map,46,179,1349,7,82,38,96,6743,37,58,8,120,-30,-24,54,633,164
32,rmtst03.map,46,179,222,1,135,44,43,2687,15,176,30,2,-14,41,55,56,64
33,rmtst03.map,46,179,3971,22,145,23,33,1566,8,44,37,134,14,-101,115,853,140
34,rmtst03.map,46,179,905,5,168,40,10,2215,12,111,33,67,-7,-57,64,852,696
35,rmtst03.map,46,179,2539,14,145,31,33,1982,11,165,34,13,3,20,23,123,103
36,rmtst03.map,46,179,6144,34,120,11,58,458,2,78,43,100,32,-42,74,219,75
37,rmtst03.map,46,179,1857,10,111,35,67,2130,11,17,34,161,-1,-94,95,653,752
38,rmtst03.map,46,179,2139,11,8,34,170,1227,6,25,39,153,5,17,22,23,23
39,rmtst03.map,46,179,6793,37,8,8,170,3187,17,34,28,144,20,26,46,47,47
40,rmtst03.map,46,179,4142,23,153,22,25,3439,19,140,26,38,4,-13,17,18,18
41,rmtst03.map,46,179,1752,9,37,36,141,5532,30,16,15,162,-21,-21,42,43,43
42,rmtst03.map,46,179,1123,6,129,39,49,1196,6,56,39,122,0,-73,73,1321,1010
43,rmtst03.map,46,179,5227,29,142,16,36,1646,9,143,36,35,20,1,21,22,22
44,rmtst03.map,46,179,560,3,155,42,23,4347,24,127,21,51,-21,-28,49,50,331
45,rmtst03.map,46,179,7644,42,52,3,126,1060,5,13,40,165,37,-39,76,77,77
46,rmtst03.map,46,179,577,3,138,42,40,4535,25,118,20,60,-22,-20,42,50,101
47,rmtst03.map,46,179,1058,5,15,40,163,1531,8,79,37,99,-3,64,67,879,257
48,rmtst03.map,46,179,4416,24,58,21,120,5060,28,130,17,48,-4,72,76,307,95
49,rmtst03.map,46,179,2169,12,157,33,21,5461,30,87,15,91,-18,-70,88,89,520
50,rmtst03.map,46,179,3002,16,40,29,138,1374,7,57,38,121,9,17,26,27,27
51,rmtst03.map,46,179,4827,26,5,19,173,3214,17,7,28,171,9,2,11,12,12
52,rmtst03.map,46,179,1928,10,40,35,138,1534,8,76,37,102,2,36,38,518,216
53,rmtst03.map,46,179,514,2,22,43,156,5373,30,175,15,3,-28,153,181,252,1505
54,rmtst03.map,46,179,5814,32,92,13,86,4374,24,100,21,78,8,8,16,17,17
55,rmtst03.map,46,179,1154,6,98,39,80,5884,32,22,13,156,-26,-76,102,111,595
56,rmtst03.map,46,179,3741,20,17,25,161,2782,15,81,30,97,5,64,69,240,70
57,rmtst03.map,46,179,2545,14,139,31,39,2654,14,30,31,148,0,-109,109,561,806
58,rmtst03.map,46,179,1632,9,157,36,21,5358,29,11,16,167,-20,-146,166,167,1445
59,rmtst03.map,46,179,1753,9,36,36,142,3389,18,11,27,167,-9,-25,34,35,35
60,rmtst03.map,46,179,7844,43,31,2,147,2726,15,137,30,41,28,106,134,619,135
61,rmtst03.map,46,179,6416,35,27,10,151,1824,10,144,35,34,25,117,142,978,146
62,rmtst03.map,46,179,2768,15,95,30,83,2597,14,87,31,91,1,-8,9,10,10
63,rmtst03.map,46,179,5396,30,152,15,26,5742,32,164,13,14,-2,12,14,89,49
64,rmtst03.map,46,179,1240,6,12,39,166,2051,11,96,34,82,-5,84,89,910,467
65,rmtst03.map,46,179,7472,41,45,4,133,4696,26,136,19,42,15,91,106,523,260
66,rmtst03.map,46,179,3994,22,122,23,56,36,0,142,45,36,22,20,42,49,52
67,rmtst03.map,46,179,3868,21,69,24,109,7118,39,41,6,137,-18,-28,46,111,47
68,rmtst03.map,46,179,7585,42,111,3,67,5343,29,26,16,152,13,-85,98,576,680
69,rmtst03.map,46,179,4186,23,109,22,69,452,2,84,43,94,21,-25,46,109,47
70,rmtst03.map,46,179,1793,10,175,35,3,2877,16,165,29,13,-6,-10,16,17,17
71,rmtst03.map,46,179,147,0,31,45,147,3971,22,145,23,33,-22,114,136,191,1232
72,rmtst03.map,46,179,3640,20,118,25,60,5532,30,16,15,162,-10,-102,112,113,113
73,rmtst03.map,46,179,1578,8,32,37,146,1766,9,23,36,155,-1,-9,10,11,11
74,rmtst03.map,46,179,4169,23,126,22,52,2090,11,57,34,121,12,-69,81,1127,110
75,rmtst03.map,46,179,2170,12,156,33,22,779,4,115,41,63,8,-41,49,643,380
76,rmtst03.map,46,179,5353,29,16,16,162,4794,26,38,19,140,3,22,25,26,26
77,rmtst03.map,46,179,3379,18,21,27,157,4230,23,65,22,113,-5,44,49,50,50
78,rmtst03.map,46,179,2069,11,78,34,100,3231,18,169,27,9,-7,91,98,582,503
79,rmtst03.map,46,179,4859,27,152,18,26,5358,29,11,16,167,-2,-141,143,330,733
80,rmtst03.map,46,179,502,2,34,43,144,2511,14,173,31,5,-12,139,151,1141,1640
81,rmtst03.map,46,179,5696,31,31,14,147,6602,36,20,9,158,-5,-11,16,17,17
82,rmtst03.map,46,179,2466,13,39,32,139,2551,14,133,31,45,-1,94,95,710,535
83,rmtst03.map,46,179,5258,29,111,16,67,6421,35,22,10,156,-6,-89,95,544,525
84,rmtst03.map,46,179,5630,31,97,14,81,4831,26,1,19,177,5,-96,101,211,351
85,rmtst03.map,46,179,4258,23,37,22,141,3658,20,100,25,78,3,63,66,67,67
86,rmtst03.map,46,179,920,5,153,40,25,6234,34,30,11,148,-29,-123,152,153,1518
87,rmtst03.map,46,179,1980,11,167,34,11,4310,24,164,21,14,-13,-3,16,17,17
88,rmtst03.map,46,179,4049,22,67,23,111,6948,38,32,7,146,-16,-35,51,52,52
89,rmtst03.map,46,179,7321,40,17,5,161,4733,26,99,19,79,14,82,96,633,420
90,rmtst03.map,46,179,3957,22,159,23,19,6053,33,32,12,146,-11,-127,138,139,139
91,rmtst03.map,46,179,5944,33,141,12,37,3501,19,78,26,100,14,-63,77,110,78
92,rmtst03.map,46,179,4458,24,16,21,162,562,3,153,42,25,21,137,158,1914,159
93,rmtst03.map,46,179,3377,18,23,27,155,2771,15,92,30,86,3,69,72,180,125
94,rmtst03.map,46,179,1856,10,112,35,66,2934,16,108,29,70,-6,-4,10,11,11
95,rmtst03.map,46,179,2185,12,141,33,37,7147,39,12,6,166,-27,-129,156,158,989
96,rmtst03.map,46,179,6185,34,79,11,99,7650,42,46,3,132,-8,-33,41,239,331
97,rmtst03.map,46,179,491,2,45,43,133,2771,15,92,30,86,-13,47,60,294,344
98,rmtst03.map,46,179,584,3,131,42,47,5957,33,128,12,50,-30,-3,33,34,34
99,rmtst03.map,46,179,4952,27,59,18,119,388,2,148,43,30,25,89,114,885,123